Id,Id2,Geography,Estimate; Total:,Margin of Error; Total:,Estimate; Total: - Owner occupied,Margin of Error; Total: - Owner occupied,Estimate; Total: - Renter occupied,Margin of Error; Total: - Renter occupied
1500000US130019501001,130019501001,"Block Group 1, Census Tract 9501, Appling County, Georgia",912,296,664,235,248,179
1500000US130019501002,130019501002,"Block Group 2, Census Tract 9501, Appling County, Georgia",2475,342,2086,350,389,294
1500000US130019502001,130019502001,"Block Group 1, Census Tract 9502, Appling County, Georgia",2036,438,1642,400,394,284
1500000US130019502002,130019502002,"Block Group 2, Census Tract 9502, Appling County, Georgia",1300,368,494,228,806,341
1500000US130019502003,130019502003,"Block Group 3, Census Tract 9502, Appling County, Georgia",1036,284,707,252,329,179
1500000US130019503001,130019503001,"Block Group 1, Census Tract 9503, Appling County, Georgia",708,284,172,175,536,269
1500000US130019503002,130019503002,"Block Group 2, Census Tract 9503, Appling County, Georgia",1585,407,581,243,1004,409
1500000US130019503003,130019503003,"Block Group 3, Census Tract 9503, Appling County, Georgia",983,316,474,225,509,235
1500000US130019503004,130019503004,"Block Group 4, Census Tract 9503, Appling County, Georgia",1460,366,1265,351,195,105
1500000US130019504001,130019504001,"Block Group 1, Census Tract 9504, Appling County, Georgia",755,199,600,167,155,127
1500000US130019504002,130019504002,"Block Group 2, Census Tract 9504, Appling County, Georgia",698,159,572,128,126,124
1500000US130019505001,130019505001,"Block Group 1, Census Tract 9505, Appling County, Georgia",695,176,500,149,195,141
1500000US130019505002,130019505002,"Block Group 2, Census Tract 9505, Appling County, Georgia",1627,328,1092,259,535,242
1500000US130019505003,130019505003,"Block Group 3, Census Tract 9505, Appling County, Georgia",1645,463,1203,436,442,366
1500000US130039601001,130039601001,"Block Group 1, Census Tract 9601, Atkinson County, Georgia",1031,215,773,210,258,106
1500000US130039601002,130039601002,"Block Group 2, Census Tract 9601, Atkinson County, Georgia",1054,235,773,232,281,132
1500000US130039602001,130039602001,"Block Group 1, Census Tract 9602, Atkinson County, Georgia",2046,390,1734,384,312,173
1500000US130039602002,130039602002,"Block Group 2, Census Tract 9602, Atkinson County, Georgia",1072,278,693,255,379,161
1500000US130039602003,130039602003,"Block Group 3, Census Tract 9602, Atkinson County, Georgia",1747,338,1006,304,741,222
1500000US130039603001,130039603001,"Block Group 1, Census Tract 9603, Atkinson County, Georgia",1307,205,1168,215,139,81
1500000US130059701001,130059701001,"Block Group 1, Census Tract 9701, Bacon County, Georgia",1527,291,1082,292,445,227
1500000US130059701002,130059701002,"Block Group 2, Census Tract 9701, Bacon County, Georgia",820,194,738,206,82,100
1500000US130059701003,130059701003,"Block Group 3, Census Tract 9701, Bacon County, Georgia",741,212,580,196,161,107
1500000US130059702011,130059702011,"Block Group 1, Census Tract 9702.01, Bacon County, Georgia",1557,247,1351,259,206,132
1500000US130059702012,130059702012,"Block Group 2, Census Tract 9702.01, Bacon County, Georgia",1161,298,738,286,423,259
1500000US130059702013,130059702013,"Block Group 3, Census Tract 9702.01, Bacon County, Georgia",1149,195,250,107,899,191
1500000US130059702021,130059702021,"Block Group 1, Census Tract 9702.02, Bacon County, Georgia",2324,348,1806,299,518,266
1500000US130059702022,130059702022,"Block Group 2, Census Tract 9702.02, Bacon County, Georgia",868,209,605,191,263,122
1500000US130059702023,130059702023,"Block Group 3, Census Tract 9702.02, Bacon County, Georgia",549,194,226,148,323,171
1500000US130079601001,130079601001,"Block Group 1, Census Tract 9601, Baker County, Georgia",815,210,509,166,306,154
1500000US130079601002,130079601002,"Block Group 2, Census Tract 9601, Baker County, Georgia",1394,222,956,211,438,189
1500000US130079602001,130079602001,"Block Group 1, Census Tract 9602, Baker County, Georgia",468,121,403,121,65,53
1500000US130079602002,130079602002,"Block Group 2, Census Tract 9602, Baker County, Georgia",615,145,525,137,90,82
1500000US130099701001,130099701001,"Block Group 1, Census Tract 9701, Baldwin County, Georgia",1461,290,1283,268,178,100
1500000US130099701002,130099701002,"Block Group 2, Census Tract 9701, Baldwin County, Georgia",1264,350,838,350,426,260
1500000US130099701003,130099701003,"Block Group 3, Census Tract 9701, Baldwin County, Georgia",2489,506,1967,482,522,383
1500000US130099702001,130099702001,"Block Group 1, Census Tract 9702, Baldwin County, Georgia",1025,399,493,207,532,418
1500000US130099702002,130099702002,"Block Group 2, Census Tract 9702, Baldwin County, Georgia",2291,388,1385,302,906,310
1500000US130099702003,130099702003,"Block Group 3, Census Tract 9702, Baldwin County, Georgia",2082,457,745,272,1337,402
1500000US130099702004,130099702004,"Block Group 4, Census Tract 9702, Baldwin County, Georgia",313,231,10,16,303,229
1500000US130099702005,130099702005,"Block Group 5, Census Tract 9702, Baldwin County, Georgia",784,378,114,86,670,361
1500000US130099703001,130099703001,"Block Group 1, Census Tract 9703, Baldwin County, Georgia",2826,433,2247,458,579,418
1500000US130099703002,130099703002,"Block Group 2, Census Tract 9703, Baldwin County, Georgia",3531,562,2260,465,1271,387
1500000US130099704001,130099704001,"Block Group 1, Census Tract 9704, Baldwin County, Georgia",1106,279,696,244,410,198
1500000US130099704002,130099704002,"Block Group 2, Census Tract 9704, Baldwin County, Georgia",1177,357,747,283,430,263
1500000US130099704003,130099704003,"Block Group 3, Census Tract 9704, Baldwin County, Georgia",998,319,413,208,585,259
1500000US130099704004,130099704004,"Block Group 4, Census Tract 9704, Baldwin County, Georgia",241,116,165,108,76,77
1500000US130099704005,130099704005,"Block Group 5, Census Tract 9704, Baldwin County, Georgia",1355,419,108,82,1247,423
1500000US130099705001,130099705001,"Block Group 1, Census Tract 9705, Baldwin County, Georgia",2960,709,314,335,2646,695
1500000US130099705002,130099705002,"Block Group 2, Census Tract 9705, Baldwin County, Georgia",396,219,138,146,258,197
1500000US130099705003,130099705003,"Block Group 3, Census Tract 9705, Baldwin County, Georgia",1739,373,1284,333,455,218
1500000US130099706001,130099706001,"Block Group 1, Census Tract 9706, Baldwin County, Georgia",1214,294,574,193,640,283
1500000US130099706002,130099706002,"Block Group 2, Census Tract 9706, Baldwin County, Georgia",857,230,229,90,628,246
1500000US130099706003,130099706003,"Block Group 3, Census Tract 9706, Baldwin County, Georgia",694,266,460,228,234,163
1500000US130099706004,130099706004,"Block Group 4, Census Tract 9706, Baldwin County, Georgia",732,243,359,161,373,187
1500000US130099707011,130099707011,"Block Group 1, Census Tract 9707.01, Baldwin County, Georgia",565,193,130,69,435,213
1500000US130099707012,130099707012,"Block Group 2, Census Tract 9707.01, Baldwin County, Georgia",440,141,143,88,297,130
1500000US130099707013,130099707013,"Block Group 3, Census Tract 9707.01, Baldwin County, Georgia",1320,225,248,163,1072,249
1500000US130099707021,130099707021,"Block Group 1, Census Tract 9707.02, Baldwin County, Georgia",1189,326,531,176,658,330
1500000US130099707022,130099707022,"Block Group 2, Census Tract 9707.02, Baldwin County, Georgia",563,168,223,113,340,142
1500000US130099708001,130099708001,"Block Group 1, Census Tract 9708, Baldwin County, Georgia",646,205,446,194,200,142
1500000US130099708002,130099708002,"Block Group 2, Census Tract 9708, Baldwin County, Georgia",3044,647,2574,632,470,327
1500000US130099708003,130099708003,"Block Group 3, Census Tract 9708, Baldwin County, Georgia",1251,456,1006,506,245,179
1500000US130099708004,130099708004,"Block Group 4, Census Tract 9708, Baldwin County, Georgia",1325,464,728,319,597,433
1500000US130119701001,130119701001,"Block Group 1, Census Tract 9701, Banks County, Georgia",2360,479,1693,420,667,251
1500000US130119701002,130119701002,"Block Group 2, Census Tract 9701, Banks County, Georgia",2909,423,2372,340,537,270
1500000US130119702001,130119702001,"Block Group 1, Census Tract 9702, Banks County, Georgia",2555,337,1702,326,853,265
1500000US130119702002,130119702002,"Block Group 2, Census Tract 9702, Banks County, Georgia",2458,263,1799,257,659,272
1500000US130119703001,130119703001,"Block Group 1, Census Tract 9703, Banks County, Georgia",1475,241,1222,219,253,142
1500000US130119703002,130119703002,"Block Group 2, Census Tract 9703, Banks County, Georgia",2691,341,2050,349,641,232
1500000US130119704001,130119704001,"Block Group 1, Census Tract 9704, Banks County, Georgia",3888,367,2925,346,963,383
1500000US130131801031,130131801031,"Block Group 1, Census Tract 1801.03, Barrow County, Georgia",4674,500,3961,495,713,291
1500000US130131801041,130131801041,"Block Group 1, Census Tract 1801.04, Barrow County, Georgia",1976,249,1468,259,508,206
1500000US130131801051,130131801051,"Block Group 1, Census Tract 1801.05, Barrow County, Georgia",2802,310,2545,289,257,188
1500000US130131801061,130131801061,"Block Group 1, Census Tract 1801.06, Barrow County, Georgia",1946,314,1190,250,756,266
1500000US130131801062,130131801062,"Block Group 2, Census Tract 1801.06, Barrow County, Georgia",885,208,610,187,275,213
1500000US130131801071,130131801071,"Block Group 1, Census Tract 1801.07, Barrow County, Georgia",1214,350,856,257,358,215
1500000US130131801072,130131801072,"Block Group 2, Census Tract 1801.07, Barrow County, Georgia",2639,456,1667,387,972,418
1500000US130131801081,130131801081,"Block Group 1, Census Tract 1801.08, Barrow County, Georgia",1568,324,1246,267,322,274
1500000US130131801082,130131801082,"Block Group 2, Census Tract 1801.08, Barrow County, Georgia",1634,383,987,312,647,390
1500000US130131802031,130131802031,"Block Group 1, Census Tract 1802.03, Barrow County, Georgia",1822,456,617,250,1205,413
1500000US130131802032,130131802032,"Block Group 2, Census Tract 1802.03, Barrow County, Georgia",1594,398,869,342,725,296
1500000US130131802041,130131802041,"Block Group 1, Census Tract 1802.04, Barrow County, Georgia",963,205,159,110,804,193
1500000US130131802042,130131802042,"Block Group 2, Census Tract 1802.04, Barrow County, Georgia",1560,324,904,247,656,330
1500000US130131802051,130131802051,"Block Group 1, Census Tract 1802.05, Barrow County, Georgia",1196,352,845,265,351,255
1500000US130131802052,130131802052,"Block Group 2, Census Tract 1802.05, Barrow County, Georgia",653,357,158,123,495,352
1500000US130131802053,130131802053,"Block Group 3, Census Tract 1802.05, Barrow County, Georgia",2504,397,735,213,1769,438
1500000US130131802061,130131802061,"Block Group 1, Census Tract 1802.06, Barrow County, Georgia",1358,329,774,273,584,325
1500000US130131802062,130131802062,"Block Group 2, Census Tract 1802.06, Barrow County, Georgia",1358,336,612,216,746,351
1500000US130131803011,130131803011,"Block Group 1, Census Tract 1803.01, Barrow County, Georgia",2167,175,1770,200,397,198
1500000US130131803021,130131803021,"Block Group 1, Census Tract 1803.02, Barrow County, Georgia",2276,527,1449,478,827,454
1500000US130131803022,130131803022,"Block Group 2, Census Tract 1803.02, Barrow County, Georgia",3231,496,2483,486,748,425
1500000US130131803031,130131803031,"Block Group 1, Census Tract 1803.03, Barrow County, Georgia",2334,426,2003,395,331,234
1500000US130131803032,130131803032,"Block Group 2, Census Tract 1803.03, Barrow County, Georgia",1980,362,1248,322,732,298
1500000US130131804011,130131804011,"Block Group 1, Census Tract 1804.01, Barrow County, Georgia",1852,439,1600,435,252,192
1500000US130131804012,130131804012,"Block Group 2, Census Tract 1804.01, Barrow County, Georgia",3616,624,2664,556,952,515
1500000US130131804021,130131804021,"Block Group 1, Census Tract 1804.02, Barrow County, Georgia",1197,650,425,187,772,648
1500000US130131804022,130131804022,"Block Group 2, Census Tract 1804.02, Barrow County, Georgia",4149,544,2738,506,1411,460
1500000US130131804023,130131804023,"Block Group 3, Census Tract 1804.02, Barrow County, Georgia",747,182,568,175,179,114
1500000US130131805011,130131805011,"Block Group 1, Census Tract 1805.01, Barrow County, Georgia",5718,537,4336,670,1382,532
1500000US130131805021,130131805021,"Block Group 1, Census Tract 1805.02, Barrow County, Georgia",1667,365,1360,363,307,217
1500000US130131805022,130131805022,"Block Group 2, Census Tract 1805.02, Barrow County, Georgia",1451,378,1170,416,281,187
1500000US130131805023,130131805023,"Block Group 3, Census Tract 1805.02, Barrow County, Georgia",1064,320,507,171,557,291
1500000US130131805024,130131805024,"Block Group 4, Census Tract 1805.02, Barrow County, Georgia",366,146,285,121,81,93
1500000US130131805031,130131805031,"Block Group 1, Census Tract 1805.03, Barrow County, Georgia",5592,856,4671,478,921,726
1500000US130159601011,130159601011,"Block Group 1, Census Tract 9601.01, Bartow County, Georgia",1474,221,1134,284,340,197
1500000US130159601021,130159601021,"Block Group 1, Census Tract 9601.02, Bartow County, Georgia",3913,824,3222,639,691,534
1500000US130159601022,130159601022,"Block Group 2, Census Tract 9601.02, Bartow County, Georgia",2919,580,2228,515,691,287
1500000US130159601023,130159601023,"Block Group 3, Census Tract 9601.02, Bartow County, Georgia",2386,508,1897,505,489,313
1500000US130159602001,130159602001,"Block Group 1, Census Tract 9602, Bartow County, Georgia",2727,697,2081,559,646,478
1500000US130159602002,130159602002,"Block Group 2, Census Tract 9602, Bartow County, Georgia",1029,392,197,143,832,407
1500000US130159602003,130159602003,"Block Group 3, Census Tract 9602, Bartow County, Georgia",2579,669,2061,545,518,396
1500000US130159602004,130159602004,"Block Group 4, Census Tract 9602, Bartow County, Georgia",3146,529,1929,506,1217,504
1500000US130159602005,130159602005,"Block Group 5, Census Tract 9602, Bartow County, Georgia",2260,712,1482,631,778,480
1500000US130159603001,130159603001,"Block Group 1, Census Tract 9603, Bartow County, Georgia",3139,553,2249,519,890,437
1500000US130159603002,130159603002,"Block Group 2, Census Tract 9603, Bartow County, Georgia",3501,588,2814,501,687,339
1500000US130159604011,130159604011,"Block Group 1, Census Tract 9604.01, Bartow County, Georgia",1259,495,925,416,334,264
1500000US130159604012,130159604012,"Block Group 2, Census Tract 9604.01, Bartow County, Georgia",4471,1064,1098,473,3373,1088
1500000US130159604013,130159604013,"Block Group 3, Census Tract 9604.01, Bartow County, Georgia",3565,829,2364,708,1201,573
1500000US130159604021,130159604021,"Block Group 1, Census Tract 9604.02, Bartow County, Georgia",1627,457,1215,416,412,303
1500000US130159604022,130159604022,"Block Group 2, Census Tract 9604.02, Bartow County, Georgia",3594,907,1743,451,1851,985
1500000US130159604023,130159604023,"Block Group 3, Census Tract 9604.02, Bartow County, Georgia",3190,609,1568,470,1622,609
1500000US130159605001,130159605001,"Block Group 1, Census Tract 9605, Bartow County, Georgia",1342,500,774,299,568,400
1500000US130159605002,130159605002,"Block Group 2, Census Tract 9605, Bartow County, Georgia",1317,402,724,284,593,401
1500000US130159605003,130159605003,"Block Group 3, Census Tract 9605, Bartow County, Georgia",1779,604,687,316,1092,633
1500000US130159605004,130159605004,"Block Group 4, Census Tract 9605, Bartow County, Georgia",3708,647,1569,480,2139,593
1500000US130159606001,130159606001,"Block Group 1, Census Tract 9606, Bartow County, Georgia",2025,795,726,328,1299,730
1500000US130159606002,130159606002,"Block Group 2, Census Tract 9606, Bartow County, Georgia",487,197,163,102,324,177
1500000US130159606003,130159606003,"Block Group 3, Census Tract 9606, Bartow County, Georgia",872,357,523,284,349,217
1500000US130159606004,130159606004,"Block Group 4, Census Tract 9606, Bartow County, Georgia",1408,359,576,203,832,391
1500000US130159606005,130159606005,"Block Group 5, Census Tract 9606, Bartow County, Georgia",4003,802,2684,583,1319,595
1500000US130159606006,130159606006,"Block Group 6, Census Tract 9606, Bartow County, Georgia",507,232,331,176,176,162
1500000US130159607001,130159607001,"Block Group 1, Census Tract 9607, Bartow County, Georgia",1655,490,1007,381,648,460
1500000US130159607002,130159607002,"Block Group 2, Census Tract 9607, Bartow County, Georgia",2143,493,1080,375,1063,402
1500000US130159607003,130159607003,"Block Group 3, Census Tract 9607, Bartow County, Georgia",1912,593,856,479,1056,448
1500000US130159607004,130159607004,"Block Group 4, Census Tract 9607, Bartow County, Georgia",887,400,193,155,694,399
1500000US130159607005,130159607005,"Block Group 5, Census Tract 9607, Bartow County, Georgia",422,240,61,64,361,239
1500000US130159608011,130159608011,"Block Group 1, Census Tract 9608.01, Bartow County, Georgia",1152,421,960,414,192,134
1500000US130159608012,130159608012,"Block Group 2, Census Tract 9608.01, Bartow County, Georgia",2333,379,1825,347,508,213
1500000US130159608021,130159608021,"Block Group 1, Census Tract 9608.02, Bartow County, Georgia",1712,321,1035,294,677,303
1500000US130159608022,130159608022,"Block Group 2, Census Tract 9608.02, Bartow County, Georgia",1106,369,939,352,167,153
1500000US130159608031,130159608031,"Block Group 1, Census Tract 9608.03, Bartow County, Georgia",1739,371,1283,328,456,245
1500000US130159608032,130159608032,"Block Group 2, Census Tract 9608.03, Bartow County, Georgia",1181,351,454,160,727,374
1500000US130159608033,130159608033,"Block Group 3, Census Tract 9608.03, Bartow County, Georgia",2785,371,1935,310,850,351
1500000US130159609011,130159609011,"Block Group 1, Census Tract 9609.01, Bartow County, Georgia",975,275,460,195,515,243
1500000US130159609012,130159609012,"Block Group 2, Census Tract 9609.01, Bartow County, Georgia",2261,288,1808,351,453,257
1500000US130159609021,130159609021,"Block Group 1, Census Tract 9609.02, Bartow County, Georgia",2467,455,1916,429,551,312
1500000US130159609022,130159609022,"Block Group 2, Census Tract 9609.02, Bartow County, Georgia",943,291,725,279,218,227
1500000US130159609023,130159609023,"Block Group 3, Census Tract 9609.02, Bartow County, Georgia",1044,297,1044,297,0,13
1500000US130159609024,130159609024,"Block Group 4, Census Tract 9609.02, Bartow County, Georgia",1850,571,1295,482,555,432
1500000US130159610001,130159610001,"Block Group 1, Census Tract 9610, Bartow County, Georgia",770,247,713,252,57,88
1500000US130159610002,130159610002,"Block Group 2, Census Tract 9610, Bartow County, Georgia",1922,471,1532,476,390,278
1500000US130159610003,130159610003,"Block Group 3, Census Tract 9610, Bartow County, Georgia",2409,670,2294,675,115,105
1500000US130159610004,130159610004,"Block Group 4, Census Tract 9610, Bartow County, Georgia",2576,642,2184,643,392,406
1500000US130179601001,130179601001,"Block Group 1, Census Tract 9601, Ben Hill County, Georgia",2674,315,2418,337,256,132
1500000US130179602001,130179602001,"Block Group 1, Census Tract 9602, Ben Hill County, Georgia",1730,217,1500,224,230,130
1500000US130179603001,130179603001,"Block Group 1, Census Tract 9603, Ben Hill County, Georgia",1165,262,734,260,431,226
1500000US130179603002,130179603002,"Block Group 2, Census Tract 9603, Ben Hill County, Georgia",533,219,217,141,316,179
1500000US130179603003,130179603003,"Block Group 3, Census Tract 9603, Ben Hill County, Georgia",1075,356,260,117,815,336
1500000US130179603004,130179603004,"Block Group 4, Census Tract 9603, Ben Hill County, Georgia",521,228,379,203,142,119
1500000US130179604001,130179604001,"Block Group 1, Census Tract 9604, Ben Hill County, Georgia",1699,400,798,384,901,353
1500000US130179604002,130179604002,"Block Group 2, Census Tract 9604, Ben Hill County, Georgia",1104,382,461,190,643,356
1500000US130179604003,130179604003,"Block Group 3, Census Tract 9604, Ben Hill County, Georgia",248,133,214,143,34,42
1500000US130179604004,130179604004,"Block Group 4, Census Tract 9604, Ben Hill County, Georgia",858,296,595,269,263,207
1500000US130179605001,130179605001,"Block Group 1, Census Tract 9605, Ben Hill County, Georgia",1231,298,1131,291,100,78
1500000US130179605002,130179605002,"Block Group 2, Census Tract 9605, Ben Hill County, Georgia",1199,475,589,281,610,443
1500000US130179605003,130179605003,"Block Group 3, Census Tract 9605, Ben Hill County, Georgia",1054,352,777,360,277,146
1500000US130179605004,130179605004,"Block Group 4, Census Tract 9605, Ben Hill County, Georgia",1162,416,395,323,767,352
1500000US130179605005,130179605005,"Block Group 5, Census Tract 9605, Ben Hill County, Georgia",912,284,632,234,280,199
1500000US130199701001,130199701001,"Block Group 1, Census Tract 9701, Berrien County, Georgia",850,181,769,184,81,66
1500000US130199701002,130199701002,"Block Group 2, Census Tract 9701, Berrien County, Georgia",994,226,768,210,226,120
1500000US130199702001,130199702001,"Block Group 1, Census Tract 9702, Berrien County, Georgia",2022,438,1168,317,854,387
1500000US130199702002,130199702002,"Block Group 2, Census Tract 9702, Berrien County, Georgia",1834,369,1314,322,520,237
1500000US130199703001,130199703001,"Block Group 1, Census Tract 9703, Berrien County, Georgia",1037,255,923,270,114,91
1500000US130199703002,130199703002,"Block Group 2, Census Tract 9703, Berrien County, Georgia",1205,300,980,277,225,133
1500000US130199703003,130199703003,"Block Group 3, Census Tract 9703, Berrien County, Georgia",911,257,445,214,466,191
1500000US130199704001,130199704001,"Block Group 1, Census Tract 9704, Berrien County, Georgia",843,249,572,212,271,201
1500000US130199704002,130199704002,"Block Group 2, Census Tract 9704, Berrien County, Georgia",803,294,577,267,226,130
1500000US130199704003,130199704003,"Block Group 3, Census Tract 9704, Berrien County, Georgia",1217,371,733,326,484,252
1500000US130199705001,130199705001,"Block Group 1, Census Tract 9705, Berrien County, Georgia",751,240,497,233,254,160
1500000US130199705002,130199705002,"Block Group 2, Census Tract 9705, Berrien County, Georgia",2627,367,2138,344,489,247
1500000US130199706001,130199706001,"Block Group 1, Census Tract 9706, Berrien County, Georgia",1198,278,1155,277,43,43
1500000US130199706002,130199706002,"Block Group 2, Census Tract 9706, Berrien County, Georgia",1697,303,1113,251,584,220
1500000US130199706003,130199706003,"Block Group 3, Census Tract 9706, Berrien County, Georgia",852,229,440,186,412,138
1500000US130210101001,130210101001,"Block Group 1, Census Tract 101, Bibb County, Georgia",630,244,166,150,464,211
1500000US130210101002,130210101002,"Block Group 2, Census Tract 101, Bibb County, Georgia",865,250,200,76,665,255
1500000US130210102001,130210102001,"Block Group 1, Census Tract 102, Bibb County, Georgia",420,186,74,77,346,173
1500000US130210102002,130210102002,"Block Group 2, Census Tract 102, Bibb County, Georgia",572,172,198,102,374,152
1500000US130210102003,130210102003,"Block Group 3, Census Tract 102, Bibb County, Georgia",949,188,623,149,326,146
1500000US130210103001,130210103001,"Block Group 1, Census Tract 103, Bibb County, Georgia",764,156,414,142,350,122
1500000US130210104001,130210104001,"Block Group 1, Census Tract 104, Bibb County, Georgia",421,169,130,97,291,139
1500000US130210104002,130210104002,"Block Group 2, Census Tract 104, Bibb County, Georgia",354,150,64,53,290,148
1500000US130210104003,130210104003,"Block Group 3, Census Tract 104, Bibb County, Georgia",588,229,239,118,349,227
1500000US130210104004,130210104004,"Block Group 4, Census Tract 104, Bibb County, Georgia",806,295,286,202,520,232
1500000US130210105001,130210105001,"Block Group 1, Census Tract 105, Bibb County, Georgia",1285,182,209,97,1076,178
1500000US130210105002,130210105002,"Block Group 2, Census Tract 105, Bibb County, Georgia",446,168,59,55,387,167
1500000US130210108001,130210108001,"Block Group 1, Census Tract 108, Bibb County, Georgia",1459,210,499,124,960,193
1500000US130210110001,130210110001,"Block Group 1, Census Tract 110, Bibb County, Georgia",487,279,470,278,17,20
1500000US130210110002,130210110002,"Block Group 2, Census Tract 110, Bibb County, Georgia",1890,514,289,233,1601,425
1500000US130210110003,130210110003,"Block Group 3, Census Tract 110, Bibb County, Georgia",615,456,486,413,129,206
1500000US130210110004,130210110004,"Block Group 4, Census Tract 110, Bibb County, Georgia",674,242,0,13,674,242
1500000US130210110005,130210110005,"Block Group 5, Census Tract 110, Bibb County, Georgia",905,333,483,199,422,268
1500000US130210111001,130210111001,"Block Group 1, Census Tract 111, Bibb County, Georgia",854,203,221,98,633,196
1500000US130210111002,130210111002,"Block Group 2, Census Tract 111, Bibb County, Georgia",665,203,151,79,514,183
1500000US130210111003,130210111003,"Block Group 3, Census Tract 111, Bibb County, Georgia",391,129,100,58,291,121
1500000US130210115001,130210115001,"Block Group 1, Census Tract 115, Bibb County, Georgia",504,170,245,152,259,110
1500000US130210115002,130210115002,"Block Group 2, Census Tract 115, Bibb County, Georgia",622,259,105,84,517,235
1500000US130210117011,130210117011,"Block Group 1, Census Tract 117.01, Bibb County, Georgia",1092,212,598,148,494,197
1500000US130210117012,130210117012,"Block Group 2, Census Tract 117.01, Bibb County, Georgia",1426,258,605,162,821,275
1500000US130210117021,130210117021,"Block Group 1, Census Tract 117.02, Bibb County, Georgia",555,244,250,138,305,231
1500000US130210117022,130210117022,"Block Group 2, Census Tract 117.02, Bibb County, Georgia",759,282,550,251,209,142
1500000US130210117023,130210117023,"Block Group 3, Census Tract 117.02, Bibb County, Georgia",871,454,475,213,396,439
1500000US130210117024,130210117024,"Block Group 4, Census Tract 117.02, Bibb County, Georgia",880,305,280,136,600,320
1500000US130210117025,130210117025,"Block Group 5, Census Tract 117.02, Bibb County, Georgia",815,347,467,234,348,278
1500000US130210117026,130210117026,"Block Group 6, Census Tract 117.02, Bibb County, Georgia",586,170,486,150,100,94
1500000US130210118001,130210118001,"Block Group 1, Census Tract 118, Bibb County, Georgia",1201,301,389,142,812,286
1500000US130210118002,130210118002,"Block Group 2, Census Tract 118, Bibb County, Georgia",751,173,525,161,226,135
1500000US130210118003,130210118003,"Block Group 3, Census Tract 118, Bibb County, Georgia",378,117,119,54,259,115
1500000US130210118004,130210118004,"Block Group 4, Census Tract 118, Bibb County, Georgia",1110,290,813,235,297,198
1500000US130210119001,130210119001,"Block Group 1, Census Tract 119, Bibb County, Georgia",426,126,43,50,383,119
1500000US130210119002,130210119002,"Block Group 2, Census Tract 119, Bibb County, Georgia",859,217,285,125,574,219
1500000US130210119003,130210119003,"Block Group 3, Census Tract 119, Bibb County, Georgia",547,349,185,103,362,350
1500000US130210120001,130210120001,"Block Group 1, Census Tract 120, Bibb County, Georgia",964,255,617,196,347,215
1500000US130210120002,130210120002,"Block Group 2, Census Tract 120, Bibb County, Georgia",689,233,606,180,83,131
1500000US130210120003,130210120003,"Block Group 3, Census Tract 120, Bibb County, Georgia",1367,305,1151,277,216,188
1500000US130210120004,130210120004,"Block Group 4, Census Tract 120, Bibb County, Georgia",1366,286,1035,229,331,234
1500000US130210121011,130210121011,"Block Group 1, Census Tract 121.01, Bibb County, Georgia",1703,295,1112,164,591,322
1500000US130210121021,130210121021,"Block Group 1, Census Tract 121.02, Bibb County, Georgia",1720,465,933,410,787,349
1500000US130210121022,130210121022,"Block Group 2, Census Tract 121.02, Bibb County, Georgia",1950,340,1373,306,577,165
1500000US130210121023,130210121023,"Block Group 3, Census Tract 121.02, Bibb County, Georgia",1333,344,766,285,567,285
1500000US130210122001,130210122001,"Block Group 1, Census Tract 122, Bibb County, Georgia",970,299,158,95,812,288
1500000US130210122002,130210122002,"Block Group 2, Census Tract 122, Bibb County, Georgia",1410,375,868,270,542,281
1500000US130210123001,130210123001,"Block Group 1, Census Tract 123, Bibb County, Georgia",895,402,248,163,647,379
1500000US130210123002,130210123002,"Block Group 2, Census Tract 123, Bibb County, Georgia",377,225,92,53,285,212
1500000US130210123003,130210123003,"Block Group 3, Census Tract 123, Bibb County, Georgia",1265,284,601,232,664,220
1500000US130210124001,130210124001,"Block Group 1, Census Tract 124, Bibb County, Georgia",1593,367,386,145,1207,357
1500000US130210124002,130210124002,"Block Group 2, Census Tract 124, Bibb County, Georgia",1135,344,589,233,546,284
1500000US130210124003,130210124003,"Block Group 3, Census Tract 124, Bibb County, Georgia",897,344,367,228,530,361
1500000US130210124004,130210124004,"Block Group 4, Census Tract 124, Bibb County, Georgia",579,186,536,175,43,64
1500000US130210125001,130210125001,"Block Group 1, Census Tract 125, Bibb County, Georgia",776,384,311,142,465,361
1500000US130210125002,130210125002,"Block Group 2, Census Tract 125, Bibb County, Georgia",1045,291,393,164,652,257
1500000US130210125003,130210125003,"Block Group 3, Census Tract 125, Bibb County, Georgia",1185,289,339,148,846,261
1500000US130210126001,130210126001,"Block Group 1, Census Tract 126, Bibb County, Georgia",1637,439,813,253,824,408
1500000US130210126002,130210126002,"Block Group 2, Census Tract 126, Bibb County, Georgia",646,206,505,188,141,111
1500000US130210126003,130210126003,"Block Group 3, Census Tract 126, Bibb County, Georgia",1312,399,536,234,776,390
1500000US130210126004,130210126004,"Block Group 4, Census Tract 126, Bibb County, Georgia",1275,381,690,336,585,274
1500000US130210127001,130210127001,"Block Group 1, Census Tract 127, Bibb County, Georgia",956,242,140,99,816,233
1500000US130210127002,130210127002,"Block Group 2, Census Tract 127, Bibb County, Georgia",778,244,232,117,546,223
1500000US130210127003,130210127003,"Block Group 3, Census Tract 127, Bibb County, Georgia",423,230,310,226,113,66
1500000US130210128001,130210128001,"Block Group 1, Census Tract 128, Bibb County, Georgia",2049,554,627,175,1422,556
1500000US130210128002,130210128002,"Block Group 2, Census Tract 128, Bibb County, Georgia",1137,516,283,206,854,494
1500000US130210128003,130210128003,"Block Group 3, Census Tract 128, Bibb County, Georgia",396,210,122,140,274,179
1500000US130210129001,130210129001,"Block Group 1, Census Tract 129, Bibb County, Georgia",932,224,153,90,779,226
1500000US130210129002,130210129002,"Block Group 2, Census Tract 129, Bibb County, Georgia",767,242,307,105,460,228
1500000US130210131011,130210131011,"Block Group 1, Census Tract 131.01, Bibb County, Georgia",2693,659,1270,438,1423,546
1500000US130210131012,130210131012,"Block Group 2, Census Tract 131.01, Bibb County, Georgia",1581,516,571,292,1010,463
1500000US130210131013,130210131013,"Block Group 3, Census Tract 131.01, Bibb County, Georgia",1482,695,275,139,1207,686
1500000US130210131021,130210131021,"Block Group 1, Census Tract 131.02, Bibb County, Georgia",466,227,348,188,118,141
1500000US130210131022,130210131022,"Block Group 2, Census Tract 131.02, Bibb County, Georgia",2087,765,1208,461,879,727
1500000US130210131023,130210131023,"Block Group 3, Census Tract 131.02, Bibb County, Georgia",1072,443,447,216,625,374
1500000US130210131024,130210131024,"Block Group 4, Census Tract 131.02, Bibb County, Georgia",653,310,355,201,298,255
1500000US130210132011,130210132011,"Block Group 1, Census Tract 132.01, Bibb County, Georgia",764,329,174,187,590,327
1500000US130210132012,130210132012,"Block Group 2, Census Tract 132.01, Bibb County, Georgia",3342,1070,1241,852,2101,792
1500000US130210132013,130210132013,"Block Group 3, Census Tract 132.01, Bibb County, Georgia",1175,415,192,129,983,420
1500000US130210132014,130210132014,"Block Group 4, Census Tract 132.01, Bibb County, Georgia",759,285,350,239,409,214
1500000US130210132021,130210132021,"Block Group 1, Census Tract 132.02, Bibb County, Georgia",1035,410,287,192,748,373
1500000US130210132022,130210132022,"Block Group 2, Census Tract 132.02, Bibb County, Georgia",854,439,140,107,714,417
1500000US130210132023,130210132023,"Block Group 3, Census Tract 132.02, Bibb County, Georgia",1025,275,447,218,578,250
1500000US130210133021,130210133021,"Block Group 1, Census Tract 133.02, Bibb County, Georgia",438,197,154,118,284,163
1500000US130210133022,130210133022,"Block Group 2, Census Tract 133.02, Bibb County, Georgia",826,263,658,205,168,167
1500000US130210133023,130210133023,"Block Group 3, Census Tract 133.02, Bibb County, Georgia",761,239,464,209,297,162
1500000US130210133024,130210133024,"Block Group 4, Census Tract 133.02, Bibb County, Georgia",1720,527,1476,526,244,185
1500000US130210134071,130210134071,"Block Group 1, Census Tract 134.07, Bibb County, Georgia",2057,557,1385,548,672,269
1500000US130210134072,130210134072,"Block Group 2, Census Tract 134.07, Bibb County, Georgia",1578,531,282,351,1296,371
1500000US130210134073,130210134073,"Block Group 3, Census Tract 134.07, Bibb County, Georgia",1038,410,642,287,396,349
1500000US130210134081,130210134081,"Block Group 1, Census Tract 134.08, Bibb County, Georgia",3394,309,2966,296,428,236
1500000US130210134082,130210134082,"Block Group 2, Census Tract 134.08, Bibb County, Georgia",1141,210,1041,206,100,80
1500000US130210134091,130210134091,"Block Group 1, Census Tract 134.09, Bibb County, Georgia",2201,334,1427,446,774,394
1500000US130210134092,130210134092,"Block Group 2, Census Tract 134.09, Bibb County, Georgia",1618,419,729,213,889,372
1500000US130210134101,130210134101,"Block Group 1, Census Tract 134.10, Bibb County, Georgia",1733,389,1582,397,151,94
1500000US130210134102,130210134102,"Block Group 2, Census Tract 134.10, Bibb County, Georgia",1976,360,1619,317,357,205
1500000US130210134103,130210134103,"Block Group 3, Census Tract 134.10, Bibb County, Georgia",1442,423,1151,383,291,235
1500000US130210134111,130210134111,"Block Group 1, Census Tract 134.11, Bibb County, Georgia",1333,344,208,153,1125,335
1500000US130210134112,130210134112,"Block Group 2, Census Tract 134.11, Bibb County, Georgia",2435,398,1207,315,1228,272
1500000US130210135021,130210135021,"Block Group 1, Census Tract 135.02, Bibb County, Georgia",462,155,349,135,113,102
1500000US130210135022,130210135022,"Block Group 2, Census Tract 135.02, Bibb County, Georgia",1285,313,741,248,544,272
1500000US130210135031,130210135031,"Block Group 1, Census Tract 135.03, Bibb County, Georgia",2754,365,1539,307,1215,336
1500000US130210135041,130210135041,"Block Group 1, Census Tract 135.04, Bibb County, Georgia",2350,470,1949,423,401,378
1500000US130210135042,130210135042,"Block Group 2, Census Tract 135.04, Bibb County, Georgia",2275,546,2145,551,130,88
1500000US130210135043,130210135043,"Block Group 3, Census Tract 135.04, Bibb County, Georgia",1537,469,1477,468,60,74
1500000US130210135044,130210135044,"Block Group 4, Census Tract 135.04, Bibb County, Georgia",2258,666,1983,638,275,237
1500000US130210136031,130210136031,"Block Group 1, Census Tract 136.03, Bibb County, Georgia",2521,415,2250,489,271,340
1500000US130210136032,130210136032,"Block Group 2, Census Tract 136.03, Bibb County, Georgia",1159,473,578,408,581,452
1500000US130210136041,130210136041,"Block Group 1, Census Tract 136.04, Bibb County, Georgia",1686,450,1318,303,368,378
1500000US130210136042,130210136042,"Block Group 2, Census Tract 136.04, Bibb County, Georgia",1782,418,1413,388,369,236
1500000US130210136043,130210136043,"Block Group 3, Census Tract 136.04, Bibb County, Georgia",1823,398,1694,413,129,104
1500000US130210136051,130210136051,"Block Group 1, Census Tract 136.05, Bibb County, Georgia",1683,409,660,308,1023,347
1500000US130210136052,130210136052,"Block Group 2, Census Tract 136.05, Bibb County, Georgia",1459,382,1025,386,434,261
1500000US130210136053,130210136053,"Block Group 3, Census Tract 136.05, Bibb County, Georgia",1580,478,1163,435,417,313
1500000US130210136061,130210136061,"Block Group 1, Census Tract 136.06, Bibb County, Georgia",753,232,753,232,0,13
1500000US130210136062,130210136062,"Block Group 2, Census Tract 136.06, Bibb County, Georgia",1180,277,1049,301,131,205
1500000US130210136063,130210136063,"Block Group 3, Census Tract 136.06, Bibb County, Georgia",1207,432,1047,386,160,213
1500000US130210136064,130210136064,"Block Group 4, Census Tract 136.06, Bibb County, Georgia",2969,523,2265,491,704,344
1500000US130210137001,130210137001,"Block Group 1, Census Tract 137, Bibb County, Georgia",612,150,165,122,447,109
1500000US130210137002,130210137002,"Block Group 2, Census Tract 137, Bibb County, Georgia",769,210,313,187,456,110
1500000US130210137003,130210137003,"Block Group 3, Census Tract 137, Bibb County, Georgia",395,146,125,103,270,99
1500000US130210138001,130210138001,"Block Group 1, Census Tract 138, Bibb County, Georgia",778,302,207,101,571,308
1500000US130210138002,130210138002,"Block Group 2, Census Tract 138, Bibb County, Georgia",1361,275,153,81,1208,264
1500000US130210139001,130210139001,"Block Group 1, Census Tract 139, Bibb County, Georgia",823,214,516,199,307,127
1500000US130210139002,130210139002,"Block Group 2, Census Tract 139, Bibb County, Georgia",1047,230,458,202,589,233
1500000US130237901001,130237901001,"Block Group 1, Census Tract 7901, Bleckley County, Georgia",2093,332,1683,301,410,195
1500000US130237901002,130237901002,"Block Group 2, Census Tract 7901, Bleckley County, Georgia",2528,461,2035,394,493,287
1500000US130237902001,130237902001,"Block Group 1, Census Tract 7902, Bleckley County, Georgia",1784,319,786,250,998,243
1500000US130237902002,130237902002,"Block Group 2, Census Tract 7902, Bleckley County, Georgia",535,193,415,192,120,94
1500000US130237903001,130237903001,"Block Group 1, Census Tract 7903, Bleckley County, Georgia",1880,313,1399,303,481,220
1500000US130237903002,130237903002,"Block Group 2, Census Tract 7903, Bleckley County, Georgia",744,217,544,200,200,108
1500000US130237903003,130237903003,"Block Group 3, Census Tract 7903, Bleckley County, Georgia",998,188,931,193,67,51
1500000US130237903004,130237903004,"Block Group 4, Census Tract 7903, Bleckley County, Georgia",586,179,416,156,170,121
1500000US130259601001,130259601001,"Block Group 1, Census Tract 9601, Brantley County, Georgia",3188,589,3035,580,153,131
1500000US130259601002,130259601002,"Block Group 2, Census Tract 9601, Brantley County, Georgia",2626,598,2019,622,607,341
1500000US130259601003,130259601003,"Block Group 3, Census Tract 9601, Brantley County, Georgia",1428,356,1410,356,18,30
1500000US130259602001,130259602001,"Block Group 1, Census Tract 9602, Brantley County, Georgia",2301,448,2006,491,295,222
1500000US130259602002,130259602002,"Block Group 2, Census Tract 9602, Brantley County, Georgia",1676,414,1344,366,332,163
1500000US130259602003,130259602003,"Block Group 3, Census Tract 9602, Brantley County, Georgia",1941,358,1657,361,284,192
1500000US130259603001,130259603001,"Block Group 1, Census Tract 9603, Brantley County, Georgia",976,340,530,214,446,311
1500000US130259603002,130259603002,"Block Group 2, Census Tract 9603, Brantley County, Georgia",2202,495,1752,443,450,285
1500000US130259603003,130259603003,"Block Group 3, Census Tract 9603, Brantley County, Georgia",2041,440,1264,364,777,418
1500000US130279602001,130279602001,"Block Group 1, Census Tract 9602, Brooks County, Georgia",872,214,476,131,396,194
1500000US130279602002,130279602002,"Block Group 2, Census Tract 9602, Brooks County, Georgia",707,112,623,106,84,52
1500000US130279603001,130279603001,"Block Group 1, Census Tract 9603, Brooks County, Georgia",1330,371,1005,356,325,120
1500000US130279603002,130279603002,"Block Group 2, Census Tract 9603, Brooks County, Georgia",893,304,724,295,169,122
1500000US130279603003,130279603003,"Block Group 3, Census Tract 9603, Brooks County, Georgia",2028,359,1644,309,384,220
1500000US130279603004,130279603004,"Block Group 4, Census Tract 9603, Brooks County, Georgia",1338,430,936,354,402,297
1500000US130279604001,130279604001,"Block Group 1, Census Tract 9604, Brooks County, Georgia",770,218,400,134,370,207
1500000US130279604002,130279604002,"Block Group 2, Census Tract 9604, Brooks County, Georgia",1649,319,949,239,700,274
1500000US130279604003,130279604003,"Block Group 3, Census Tract 9604, Brooks County, Georgia",951,226,416,150,535,213
1500000US130279605001,130279605001,"Block Group 1, Census Tract 9605, Brooks County, Georgia",845,281,526,194,319,168
1500000US130279605002,130279605002,"Block Group 2, Census Tract 9605, Brooks County, Georgia",700,256,538,245,162,143
1500000US130279605003,130279605003,"Block Group 3, Census Tract 9605, Brooks County, Georgia",1193,341,836,279,357,198
1500000US130279606001,130279606001,"Block Group 1, Census Tract 9606, Brooks County, Georgia",1122,310,702,207,420,238
1500000US130279606002,130279606002,"Block Group 2, Census Tract 9606, Brooks County, Georgia",636,203,573,209,63,63
1500000US130279606003,130279606003,"Block Group 3, Census Tract 9606, Brooks County, Georgia",562,169,417,120,145,136
1500000US130299201011,130299201011,"Block Group 1, Census Tract 9201.01, Bryan County, Georgia",2259,544,1458,444,801,355
1500000US130299201012,130299201012,"Block Group 2, Census Tract 9201.01, Bryan County, Georgia",2826,522,1894,401,932,535
1500000US130299201021,130299201021,"Block Group 1, Census Tract 9201.02, Bryan County, Georgia",2594,590,1487,450,1107,444
1500000US130299201022,130299201022,"Block Group 2, Census Tract 9201.02, Bryan County, Georgia",1673,505,1424,463,249,213
1500000US130299201023,130299201023,"Block Group 3, Census Tract 9201.02, Bryan County, Georgia",1480,597,1082,611,398,231
1500000US130299203011,130299203011,"Block Group 1, Census Tract 9203.01, Bryan County, Georgia",2041,269,1597,206,444,202
1500000US130299203031,130299203031,"Block Group 1, Census Tract 9203.03, Bryan County, Georgia",2880,521,1109,358,1771,495
1500000US130299203032,130299203032,"Block Group 2, Census Tract 9203.03, Bryan County, Georgia",3074,612,949,295,2125,618
1500000US130299203051,130299203051,"Block Group 1, Census Tract 9203.05, Bryan County, Georgia",2298,426,1943,394,355,230
1500000US130299203052,130299203052,"Block Group 2, Census Tract 9203.05, Bryan County, Georgia",2211,338,1876,357,335,364
1500000US130299203061,130299203061,"Block Group 1, Census Tract 9203.06, Bryan County, Georgia",2508,547,1870,539,638,319
1500000US130299203062,130299203062,"Block Group 2, Census Tract 9203.06, Bryan County, Georgia",5431,778,3977,713,1454,669
1500000US130299203063,130299203063,"Block Group 3, Census Tract 9203.06, Bryan County, Georgia",1784,441,1573,430,211,169
1500000US130299800001,130299800001,"Block Group 1, Census Tract 9800, Bryan County, Georgia",0,13,0,13,0,13
1500000US130311101001,130311101001,"Block Group 1, Census Tract 1101, Bulloch County, Georgia",1084,292,882,189,202,219
1500000US130311101002,130311101002,"Block Group 2, Census Tract 1101, Bulloch County, Georgia",1375,252,782,159,593,217
1500000US130311101003,130311101003,"Block Group 3, Census Tract 1101, Bulloch County, Georgia",1316,284,1010,233,306,197
1500000US130311102001,130311102001,"Block Group 1, Census Tract 1102, Bulloch County, Georgia",1777,347,1574,352,203,118
1500000US130311102002,130311102002,"Block Group 2, Census Tract 1102, Bulloch County, Georgia",1798,437,926,273,872,449
1500000US130311102003,130311102003,"Block Group 3, Census Tract 1102, Bulloch County, Georgia",969,316,482,220,487,324
1500000US130311102004,130311102004,"Block Group 4, Census Tract 1102, Bulloch County, Georgia",594,328,231,191,363,306
1500000US130311102005,130311102005,"Block Group 5, Census Tract 1102, Bulloch County, Georgia",679,327,59,96,620,334
1500000US130311102006,130311102006,"Block Group 6, Census Tract 1102, Bulloch County, Georgia",977,401,186,101,791,417
1500000US130311103001,130311103001,"Block Group 1, Census Tract 1103, Bulloch County, Georgia",2062,563,1196,345,866,483
1500000US130311103002,130311103002,"Block Group 2, Census Tract 1103, Bulloch County, Georgia",1582,669,675,315,907,585
1500000US130311103003,130311103003,"Block Group 3, Census Tract 1103, Bulloch County, Georgia",1927,610,1444,558,483,306
1500000US130311103004,130311103004,"Block Group 4, Census Tract 1103, Bulloch County, Georgia",2744,472,2496,463,248,217
1500000US130311104011,130311104011,"Block Group 1, Census Tract 1104.01, Bulloch County, Georgia",600,340,180,140,420,328
1500000US130311104012,130311104012,"Block Group 2, Census Tract 1104.01, Bulloch County, Georgia",2058,314,658,225,1400,326
1500000US130311104013,130311104013,"Block Group 3, Census Tract 1104.01, Bulloch County, Georgia",605,183,438,174,167,122
1500000US130311104031,130311104031,"Block Group 1, Census Tract 1104.03, Bulloch County, Georgia",2775,517,0,13,2775,517
1500000US130311104032,130311104032,"Block Group 2, Census Tract 1104.03, Bulloch County, Georgia",2741,572,168,109,2573,572
1500000US130311104033,130311104033,"Block Group 3, Census Tract 1104.03, Bulloch County, Georgia",1485,458,14,23,1471,458
1500000US130311104041,130311104041,"Block Group 1, Census Tract 1104.04, Bulloch County, Georgia",11,18,0,13,11,18
1500000US130311104042,130311104042,"Block Group 2, Census Tract 1104.04, Bulloch County, Georgia",1531,385,0,13,1531,385
1500000US130311104043,130311104043,"Block Group 3, Census Tract 1104.04, Bulloch County, Georgia",585,273,15,24,570,273
1500000US130311105001,130311105001,"Block Group 1, Census Tract 1105, Bulloch County, Georgia",995,269,287,115,708,272
1500000US130311105002,130311105002,"Block Group 2, Census Tract 1105, Bulloch County, Georgia",1039,274,404,180,635,240
1500000US130311105003,130311105003,"Block Group 3, Census Tract 1105, Bulloch County, Georgia",1684,290,509,178,1175,274
1500000US130311105004,130311105004,"Block Group 4, Census Tract 1105, Bulloch County, Georgia",1026,304,295,217,731,253
1500000US130311106011,130311106011,"Block Group 1, Census Tract 1106.01, Bulloch County, Georgia",3328,626,1609,451,1719,446
1500000US130311106012,130311106012,"Block Group 2, Census Tract 1106.01, Bulloch County, Georgia",965,325,92,70,873,323
1500000US130311106013,130311106013,"Block Group 3, Census Tract 1106.01, Bulloch County, Georgia",2421,524,1613,397,808,416
1500000US130311106021,130311106021,"Block Group 1, Census Tract 1106.02, Bulloch County, Georgia",818,212,495,189,323,172
1500000US130311106022,130311106022,"Block Group 2, Census Tract 1106.02, Bulloch County, Georgia",547,201,342,144,205,213
1500000US130311106023,130311106023,"Block Group 3, Census Tract 1106.02, Bulloch County, Georgia",2474,365,1070,318,1404,326
1500000US130311107001,130311107001,"Block Group 1, Census Tract 1107, Bulloch County, Georgia",4051,768,2138,629,1913,715
1500000US130311107002,130311107002,"Block Group 2, Census Tract 1107, Bulloch County, Georgia",2314,452,1558,376,756,405
1500000US130311107003,130311107003,"Block Group 3, Census Tract 1107, Bulloch County, Georgia",1145,324,881,321,264,106
1500000US130311107004,130311107004,"Block Group 4, Census Tract 1107, Bulloch County, Georgia",2836,613,1893,405,943,551
1500000US130311108001,130311108001,"Block Group 1, Census Tract 1108, Bulloch County, Georgia",1601,304,979,210,622,330
1500000US130311108002,130311108002,"Block Group 2, Census Tract 1108, Bulloch County, Georgia",925,175,848,172,77,44
1500000US130311109001,130311109001,"Block Group 1, Census Tract 1109, Bulloch County, Georgia",1263,409,1180,419,83,109
1500000US130311109002,130311109002,"Block Group 2, Census Tract 1109, Bulloch County, Georgia",2398,560,1942,581,456,276
1500000US130311109003,130311109003,"Block Group 3, Census Tract 1109, Bulloch County, Georgia",2370,531,2105,402,265,413
1500000US130311109004,130311109004,"Block Group 4, Census Tract 1109, Bulloch County, Georgia",891,353,604,236,287,324
1500000US130339501001,130339501001,"Block Group 1, Census Tract 9501, Burke County, Georgia",2059,415,1765,400,294,195
1500000US130339501002,130339501002,"Block Group 2, Census Tract 9501, Burke County, Georgia",3059,528,2647,521,412,246
1500000US130339502001,130339502001,"Block Group 1, Census Tract 9502, Burke County, Georgia",1097,309,807,268,290,190
1500000US130339502002,130339502002,"Block Group 2, Census Tract 9502, Burke County, Georgia",1662,313,1362,317,300,246
1500000US130339504001,130339504001,"Block Group 1, Census Tract 9504, Burke County, Georgia",1723,390,1150,297,573,316
1500000US130339504002,130339504002,"Block Group 2, Census Tract 9504, Burke County, Georgia",590,184,215,108,375,167
1500000US130339504003,130339504003,"Block Group 3, Census Tract 9504, Burke County, Georgia",1686,373,733,213,953,371
1500000US130339504004,130339504004,"Block Group 4, Census Tract 9504, Burke County, Georgia",1129,285,152,83,977,281
1500000US130339505001,130339505001,"Block Group 1, Census Tract 9505, Burke County, Georgia",1301,334,1182,330,119,113
1500000US130339505002,130339505002,"Block Group 2, Census Tract 9505, Burke County, Georgia",2266,383,1409,372,857,416
1500000US130339505003,130339505003,"Block Group 3, Census Tract 9505, Burke County, Georgia",1714,300,1364,291,350,193
1500000US130339507001,130339507001,"Block Group 1, Census Tract 9507, Burke County, Georgia",964,231,745,191,219,118
1500000US130339507002,130339507002,"Block Group 2, Census Tract 9507, Burke County, Georgia",778,229,537,207,241,98
1500000US130339507003,130339507003,"Block Group 3, Census Tract 9507, Burke County, Georgia",998,288,763,258,235,146
1500000US130339509001,130339509001,"Block Group 1, Census Tract 9509, Burke County, Georgia",878,203,627,153,251,164
1500000US130339509002,130339509002,"Block Group 2, Census Tract 9509, Burke County, Georgia",850,133,602,120,248,100
1500000US130351501001,130351501001,"Block Group 1, Census Tract 1501, Butts County, Georgia",1519,369,1391,360,128,122
1500000US130351501002,130351501002,"Block Group 2, Census Tract 1501, Butts County, Georgia",1319,351,1146,315,173,190
1500000US130351501003,130351501003,"Block Group 3, Census Tract 1501, Butts County, Georgia",1774,618,1574,624,200,133
1500000US130351501004,130351501004,"Block Group 4, Census Tract 1501, Butts County, Georgia",998,277,839,274,159,128
1500000US130351501005,130351501005,"Block Group 5, Census Tract 1501, Butts County, Georgia",2298,619,2228,630,70,112
1500000US130351502001,130351502001,"Block Group 1, Census Tract 1502, Butts County, Georgia",2801,646,1930,500,871,467
1500000US130351502002,130351502002,"Block Group 2, Census Tract 1502, Butts County, Georgia",640,241,232,151,408,205
1500000US130351502003,130351502003,"Block Group 3, Census Tract 1502, Butts County, Georgia",825,378,522,353,303,223
1500000US130351502004,130351502004,"Block Group 4, Census Tract 1502, Butts County, Georgia",1154,434,307,184,847,385
1500000US130351502005,130351502005,"Block Group 5, Census Tract 1502, Butts County, Georgia",2202,624,1405,391,797,563
1500000US130351503001,130351503001,"Block Group 1, Census Tract 1503, Butts County, Georgia",2611,498,1156,301,1455,491
1500000US130351503002,130351503002,"Block Group 2, Census Tract 1503, Butts County, Georgia",1019,307,949,309,70,67
1500000US130351503003,130351503003,"Block Group 3, Census Tract 1503, Butts County, Georgia",894,262,822,262,72,69
1500000US130351503004,130351503004,"Block Group 4, Census Tract 1503, Butts County, Georgia",928,308,644,188,284,260
1500000US130379501001,130379501001,"Block Group 1, Census Tract 9501, Calhoun County, Georgia",717,283,514,176,203,163
1500000US130379501002,130379501002,"Block Group 2, Census Tract 9501, Calhoun County, Georgia",521,223,379,183,142,72
1500000US130379502001,130379502001,"Block Group 1, Census Tract 9502, Calhoun County, Georgia",553,238,312,174,241,132
1500000US130379502002,130379502002,"Block Group 2, Census Tract 9502, Calhoun County, Georgia",527,214,452,186,75,76
1500000US130379502003,130379502003,"Block Group 3, Census Tract 9502, Calhoun County, Georgia",408,170,258,101,150,131
1500000US130379502004,130379502004,"Block Group 4, Census Tract 9502, Calhoun County, Georgia",1184,425,638,275,546,276
1500000US130390101001,130390101001,"Block Group 1, Census Tract 101, Camden County, Georgia",956,244,860,250,96,100
1500000US130390101002,130390101002,"Block Group 2, Census Tract 101, Camden County, Georgia",1589,326,1221,304,368,253
1500000US130390102001,130390102001,"Block Group 1, Census Tract 102, Camden County, Georgia",1137,223,979,218,158,85
1500000US130390102002,130390102002,"Block Group 2, Census Tract 102, Camden County, Georgia",1286,274,758,209,528,196
1500000US130390102003,130390102003,"Block Group 3, Census Tract 102, Camden County, Georgia",2515,326,1876,317,639,311
1500000US130390103011,130390103011,"Block Group 1, Census Tract 103.01, Camden County, Georgia",1832,466,1004,334,828,376
1500000US130390103012,130390103012,"Block Group 2, Census Tract 103.01, Camden County, Georgia",1871,482,1438,388,433,372
1500000US130390103013,130390103013,"Block Group 3, Census Tract 103.01, Camden County, Georgia",3639,583,1923,571,1716,662
1500000US130390103014,130390103014,"Block Group 4, Census Tract 103.01, Camden County, Georgia",1039,306,766,279,273,219
1500000US130390103021,130390103021,"Block Group 1, Census Tract 103.02, Camden County, Georgia",637,226,159,103,478,235
1500000US130390103022,130390103022,"Block Group 2, Census Tract 103.02, Camden County, Georgia",2609,464,1623,384,986,411
1500000US130390103023,130390103023,"Block Group 3, Census Tract 103.02, Camden County, Georgia",834,279,750,261,84,108
1500000US130390104011,130390104011,"Block Group 1, Census Tract 104.01, Camden County, Georgia",5325,785,2741,676,2584,705
1500000US130390104012,130390104012,"Block Group 2, Census Tract 104.01, Camden County, Georgia",1300,512,279,198,1021,553
1500000US130390104013,130390104013,"Block Group 3, Census Tract 104.01, Camden County, Georgia",5348,586,3226,545,2122,705
1500000US130390104021,130390104021,"Block Group 1, Census Tract 104.02, Camden County, Georgia",1484,316,1155,301,329,239
1500000US130390104022,130390104022,"Block Group 2, Census Tract 104.02, Camden County, Georgia",3712,483,2660,427,1052,404
1500000US130390104031,130390104031,"Block Group 1, Census Tract 104.03, Camden County, Georgia",4094,399,3126,346,968,356
1500000US130390105001,130390105001,"Block Group 1, Census Tract 105, Camden County, Georgia",1569,253,0,13,1569,253
1500000US130390105002,130390105002,"Block Group 2, Census Tract 105, Camden County, Georgia",0,13,0,13,0,13
1500000US130390106011,130390106011,"Block Group 1, Census Tract 106.01, Camden County, Georgia",1841,497,625,273,1216,510
1500000US130390106012,130390106012,"Block Group 2, Census Tract 106.01, Camden County, Georgia",1972,585,1032,365,940,539
1500000US130390106013,130390106013,"Block Group 3, Census Tract 106.01, Camden County, Georgia",2414,569,882,347,1532,541
1500000US130390106021,130390106021,"Block Group 1, Census Tract 106.02, Camden County, Georgia",883,161,587,130,296,128
1500000US130399900000,130399900000,"Block Group 0, Census Tract 9900, Camden County, Georgia",0,13,0,13,0,13
1500000US130439501001,130439501001,"Block Group 1, Census Tract 9501, Candler County, Georgia",1086,208,768,189,318,185
1500000US130439501002,130439501002,"Block Group 2, Census Tract 9501, Candler County, Georgia",2153,347,1222,362,931,326
1500000US130439501003,130439501003,"Block Group 3, Census Tract 9501, Candler County, Georgia",1861,332,812,280,1049,309
1500000US130439502001,130439502001,"Block Group 1, Census Tract 9502, Candler County, Georgia",1664,340,844,249,820,329
1500000US130439502002,130439502002,"Block Group 2, Census Tract 9502, Candler County, Georgia",1203,325,910,319,293,200
1500000US130439502003,130439502003,"Block Group 3, Census Tract 9502, Candler County, Georgia",678,190,475,181,203,112
1500000US130439503001,130439503001,"Block Group 1, Census Tract 9503, Candler County, Georgia",982,196,658,156,324,139
1500000US130439503002,130439503002,"Block Group 2, Census Tract 9503, Candler County, Georgia",1119,272,637,203,482,186
1500000US130459101011,130459101011,"Block Group 1, Census Tract 9101.01, Carroll County, Georgia",4173,498,2135,449,2038,453
1500000US130459101012,130459101012,"Block Group 2, Census Tract 9101.01, Carroll County, Georgia",1785,429,996,282,789,356
1500000US130459101031,130459101031,"Block Group 1, Census Tract 9101.03, Carroll County, Georgia",2744,468,1535,394,1209,508
1500000US130459101032,130459101032,"Block Group 2, Census Tract 9101.03, Carroll County, Georgia",2188,380,1814,366,374,229
1500000US130459101041,130459101041,"Block Group 1, Census Tract 9101.04, Carroll County, Georgia",1702,512,1348,475,354,210
1500000US130459101042,130459101042,"Block Group 2, Census Tract 9101.04, Carroll County, Georgia",5604,966,4448,986,1156,600
1500000US130459101043,130459101043,"Block Group 3, Census Tract 9101.04, Carroll County, Georgia",1549,430,917,343,632,332
1500000US130459101044,130459101044,"Block Group 4, Census Tract 9101.04, Carroll County, Georgia",801,407,547,381,254,162
1500000US130459102001,130459102001,"Block Group 1, Census Tract 9102, Carroll County, Georgia",2963,876,1918,608,1045,711
1500000US130459102002,130459102002,"Block Group 2, Census Tract 9102, Carroll County, Georgia",5624,1082,4257,948,1367,682
1500000US130459102003,130459102003,"Block Group 3, Census Tract 9102, Carroll County, Georgia",3571,785,2203,618,1368,678
1500000US130459103001,130459103001,"Block Group 1, Census Tract 9103, Carroll County, Georgia",1238,470,552,369,686,391
1500000US130459103002,130459103002,"Block Group 2, Census Tract 9103, Carroll County, Georgia",3302,602,2702,597,600,230
1500000US130459103003,130459103003,"Block Group 3, Census Tract 9103, Carroll County, Georgia",1329,307,973,323,356,184
1500000US130459104001,130459104001,"Block Group 1, Census Tract 9104, Carroll County, Georgia",1041,224,899,209,142,125
1500000US130459104002,130459104002,"Block Group 2, Census Tract 9104, Carroll County, Georgia",1301,253,730,176,571,227
1500000US130459104003,130459104003,"Block Group 3, Census Tract 9104, Carroll County, Georgia",927,261,599,203,328,197
1500000US130459105011,130459105011,"Block Group 1, Census Tract 9105.01, Carroll County, Georgia",3690,664,1279,402,2411,593
1500000US130459105012,130459105012,"Block Group 2, Census Tract 9105.01, Carroll County, Georgia",1244,442,209,84,1035,437
1500000US130459105013,130459105013,"Block Group 3, Census Tract 9105.01, Carroll County, Georgia",1125,365,525,247,600,425
1500000US130459105014,130459105014,"Block Group 4, Census Tract 9105.01, Carroll County, Georgia",434,205,0,13,434,205
1500000US130459105021,130459105021,"Block Group 1, Census Tract 9105.02, Carroll County, Georgia",1020,284,82,101,938,264
1500000US130459105022,130459105022,"Block Group 2, Census Tract 9105.02, Carroll County, Georgia",1155,308,158,172,997,275
1500000US130459105023,130459105023,"Block Group 3, Census Tract 9105.02, Carroll County, Georgia",787,240,163,87,624,228
1500000US130459106001,130459106001,"Block Group 1, Census Tract 9106, Carroll County, Georgia",3516,631,2731,630,785,446
1500000US130459106002,130459106002,"Block Group 2, Census Tract 9106, Carroll County, Georgia",1543,429,673,290,870,419
1500000US130459106003,130459106003,"Block Group 3, Census Tract 9106, Carroll County, Georgia",819,320,517,299,302,159
1500000US130459107011,130459107011,"Block Group 1, Census Tract 9107.01, Carroll County, Georgia",3514,615,2195,484,1319,531
1500000US130459107012,130459107012,"Block Group 2, Census Tract 9107.01, Carroll County, Georgia",1316,435,396,294,920,321
1500000US130459107013,130459107013,"Block Group 3, Census Tract 9107.01, Carroll County, Georgia",3040,579,2332,613,708,463
1500000US130459107021,130459107021,"Block Group 1, Census Tract 9107.02, Carroll County, Georgia",2874,573,2783,565,91,107
1500000US130459107022,130459107022,"Block Group 2, Census Tract 9107.02, Carroll County, Georgia",2319,490,2173,501,146,134
1500000US130459107023,130459107023,"Block Group 3, Census Tract 9107.02, Carroll County, Georgia",2225,657,1640,390,585,567
1500000US130459107031,130459107031,"Block Group 1, Census Tract 9107.03, Carroll County, Georgia",1874,661,1121,411,753,549
1500000US130459107032,130459107032,"Block Group 2, Census Tract 9107.03, Carroll County, Georgia",998,395,723,359,275,256
1500000US130459107033,130459107033,"Block Group 3, Census Tract 9107.03, Carroll County, Georgia",3470,850,1694,486,1776,813
1500000US130459107034,130459107034,"Block Group 4, Census Tract 9107.03, Carroll County, Georgia",2405,790,1179,445,1226,827
1500000US130459108001,130459108001,"Block Group 1, Census Tract 9108, Carroll County, Georgia",2007,456,1161,293,846,440
1500000US130459108002,130459108002,"Block Group 2, Census Tract 9108, Carroll County, Georgia",2117,308,1769,299,348,174
1500000US130459109001,130459109001,"Block Group 1, Census Tract 9109, Carroll County, Georgia",2005,375,1567,329,438,234
1500000US130459109002,130459109002,"Block Group 2, Census Tract 9109, Carroll County, Georgia",2110,390,1677,316,433,258
1500000US130459110001,130459110001,"Block Group 1, Census Tract 9110, Carroll County, Georgia",1429,599,341,288,1088,615
1500000US130459110002,130459110002,"Block Group 2, Census Tract 9110, Carroll County, Georgia",3322,563,2620,560,702,417
1500000US130459110003,130459110003,"Block Group 3, Census Tract 9110, Carroll County, Georgia",1383,424,772,272,611,343
1500000US130459111001,130459111001,"Block Group 1, Census Tract 9111, Carroll County, Georgia",1316,524,851,341,465,444
1500000US130459111002,130459111002,"Block Group 2, Census Tract 9111, Carroll County, Georgia",2146,608,1147,359,999,507
1500000US130459111003,130459111003,"Block Group 3, Census Tract 9111, Carroll County, Georgia",990,460,460,274,530,357
1500000US130459111004,130459111004,"Block Group 4, Census Tract 9111, Carroll County, Georgia",2248,480,1623,504,625,315
1500000US130459111005,130459111005,"Block Group 5, Census Tract 9111, Carroll County, Georgia",844,285,230,177,614,319
1500000US130459112001,130459112001,"Block Group 1, Census Tract 9112, Carroll County, Georgia",1902,465,1169,290,733,410
1500000US130459112002,130459112002,"Block Group 2, Census Tract 9112, Carroll County, Georgia",1161,354,921,279,240,249
1500000US130459112003,130459112003,"Block Group 3, Census Tract 9112, Carroll County, Georgia",1407,442,855,248,552,420
1500000US130459112004,130459112004,"Block Group 4, Census Tract 9112, Carroll County, Georgia",1211,236,621,188,590,209
1500000US130470301001,130470301001,"Block Group 1, Census Tract 301, Catoosa County, Georgia",2640,635,2495,645,145,156
1500000US130470301002,130470301002,"Block Group 2, Census Tract 301, Catoosa County, Georgia",565,219,404,203,161,124
1500000US130470301003,130470301003,"Block Group 3, Census Tract 301, Catoosa County, Georgia",1322,434,1027,301,295,332
1500000US130470301004,130470301004,"Block Group 4, Census Tract 301, Catoosa County, Georgia",1949,507,1187,400,762,372
1500000US130470302011,130470302011,"Block Group 1, Census Tract 302.01, Catoosa County, Georgia",1481,288,824,354,657,250
1500000US130470302012,130470302012,"Block Group 2, Census Tract 302.01, Catoosa County, Georgia",2879,383,2313,338,566,231
1500000US130470302021,130470302021,"Block Group 1, Census Tract 302.02, Catoosa County, Georgia",1676,637,1135,461,541,519
1500000US130470302022,130470302022,"Block Group 2, Census Tract 302.02, Catoosa County, Georgia",1703,539,1393,490,310,256
1500000US130470302023,130470302023,"Block Group 3, Census Tract 302.02, Catoosa County, Georgia",2888,469,2516,498,372,384
1500000US130470303011,130470303011,"Block Group 1, Census Tract 303.01, Catoosa County, Georgia",2300,496,1872,497,428,454
1500000US130470303012,130470303012,"Block Group 2, Census Tract 303.01, Catoosa County, Georgia",2385,643,2264,639,121,128
1500000US130470303013,130470303013,"Block Group 3, Census Tract 303.01, Catoosa County, Georgia",2823,610,2285,594,538,271
1500000US130470303031,130470303031,"Block Group 1, Census Tract 303.03, Catoosa County, Georgia",3175,329,2536,347,639,242
1500000US130470303041,130470303041,"Block Group 1, Census Tract 303.04, Catoosa County, Georgia",3787,347,3345,289,442,265
1500000US130470304011,130470304011,"Block Group 1, Census Tract 304.01, Catoosa County, Georgia",1547,374,1399,385,148,198
1500000US130470304012,130470304012,"Block Group 2, Census Tract 304.01, Catoosa County, Georgia",3012,468,2850,480,162,162
1500000US130470304013,130470304013,"Block Group 3, Census Tract 304.01, Catoosa County, Georgia",2428,554,2341,555,87,133
1500000US130470304021,130470304021,"Block Group 1, Census Tract 304.02, Catoosa County, Georgia",1228,368,953,328,275,207
1500000US130470304022,130470304022,"Block Group 2, Census Tract 304.02, Catoosa County, Georgia",851,482,725,464,126,100
1500000US130470304023,130470304023,"Block Group 3, Census Tract 304.02, Catoosa County, Georgia",2479,598,2196,594,283,246
1500000US130470304024,130470304024,"Block Group 4, Census Tract 304.02, Catoosa County, Georgia",1915,513,1346,487,569,313
1500000US130470305001,130470305001,"Block Group 1, Census Tract 305, Catoosa County, Georgia",3705,514,1974,502,1731,474
1500000US130470305002,130470305002,"Block Group 2, Census Tract 305, Catoosa County, Georgia",805,236,711,248,94,93
1500000US130470305003,130470305003,"Block Group 3, Census Tract 305, Catoosa County, Georgia",1596,458,647,245,949,446
1500000US130470306001,130470306001,"Block Group 1, Census Tract 306, Catoosa County, Georgia",674,262,529,268,145,133
1500000US130470306002,130470306002,"Block Group 2, Census Tract 306, Catoosa County, Georgia",1667,531,1345,538,322,298
1500000US130470306003,130470306003,"Block Group 3, Census Tract 306, Catoosa County, Georgia",1282,378,1000,326,282,233
1500000US130470306004,130470306004,"Block Group 4, Census Tract 306, Catoosa County, Georgia",905,352,860,363,45,33
1500000US130470306005,130470306005,"Block Group 5, Census Tract 306, Catoosa County, Georgia",1112,395,676,224,436,352
1500000US130470307001,130470307001,"Block Group 1, Census Tract 307, Catoosa County, Georgia",2569,531,1475,504,1094,440
1500000US130470307002,130470307002,"Block Group 2, Census Tract 307, Catoosa County, Georgia",954,268,746,255,208,124
1500000US130470307003,130470307003,"Block Group 3, Census Tract 307, Catoosa County, Georgia",2924,505,995,325,1929,523
1500000US130470307004,130470307004,"Block Group 4, Census Tract 307, Catoosa County, Georgia",968,377,829,361,139,108
1500000US130470307005,130470307005,"Block Group 5, Census Tract 307, Catoosa County, Georgia",626,293,495,261,131,121
1500000US130490101001,130490101001,"Block Group 1, Census Tract 101, Charlton County, Georgia",1448,384,807,201,641,349
1500000US130490101002,130490101002,"Block Group 2, Census Tract 101, Charlton County, Georgia",1463,329,1025,244,438,259
1500000US130490101003,130490101003,"Block Group 3, Census Tract 101, Charlton County, Georgia",2244,644,1989,625,255,195
1500000US130490101004,130490101004,"Block Group 4, Census Tract 101, Charlton County, Georgia",3205,653,2479,721,726,311
1500000US130490102001,130490102001,"Block Group 1, Census Tract 102, Charlton County, Georgia",1647,473,1414,461,233,167
1500000US130490102002,130490102002,"Block Group 2, Census Tract 102, Charlton County, Georgia",1706,340,1573,342,133,97
1500000US130510001001,130510001001,"Block Group 1, Census Tract 1, Chatham County, Georgia",882,127,0,13,882,127
1500000US130510003001,130510003001,"Block Group 1, Census Tract 3, Chatham County, Georgia",514,82,187,77,327,98
1500000US130510003002,130510003002,"Block Group 2, Census Tract 3, Chatham County, Georgia",701,219,323,160,378,153
1500000US130510006011,130510006011,"Block Group 1, Census Tract 6.01, Chatham County, Georgia",349,175,117,103,232,153
1500000US130510006012,130510006012,"Block Group 2, Census Tract 6.01, Chatham County, Georgia",481,268,180,116,301,268
1500000US130510006013,130510006013,"Block Group 3, Census Tract 6.01, Chatham County, Georgia",774,321,303,154,471,302
1500000US130510006014,130510006014,"Block Group 4, Census Tract 6.01, Chatham County, Georgia",387,154,219,117,168,126
1500000US130510006015,130510006015,"Block Group 5, Census Tract 6.01, Chatham County, Georgia",995,298,381,204,614,242
1500000US130510009001,130510009001,"Block Group 1, Census Tract 9, Chatham County, Georgia",1160,141,532,107,628,104
1500000US130510011001,130510011001,"Block Group 1, Census Tract 11, Chatham County, Georgia",1075,180,252,102,823,186
1500000US130510011002,130510011002,"Block Group 2, Census Tract 11, Chatham County, Georgia",997,195,303,123,694,221
1500000US130510012001,130510012001,"Block Group 1, Census Tract 12, Chatham County, Georgia",1962,258,176,98,1786,243
1500000US130510015001,130510015001,"Block Group 1, Census Tract 15, Chatham County, Georgia",1411,246,156,63,1255,249
1500000US130510020001,130510020001,"Block Group 1, Census Tract 20, Chatham County, Georgia",582,170,183,95,399,162
1500000US130510020002,130510020002,"Block Group 2, Census Tract 20, Chatham County, Georgia",677,140,352,97,325,109
1500000US130510021001,130510021001,"Block Group 1, Census Tract 21, Chatham County, Georgia",629,194,262,102,367,167
1500000US130510021002,130510021002,"Block Group 2, Census Tract 21, Chatham County, Georgia",574,201,320,155,254,145
1500000US130510021003,130510021003,"Block Group 3, Census Tract 21, Chatham County, Georgia",948,236,497,262,451,267
1500000US130510022001,130510022001,"Block Group 1, Census Tract 22, Chatham County, Georgia",923,311,270,221,653,229
1500000US130510022002,130510022002,"Block Group 2, Census Tract 22, Chatham County, Georgia",796,253,316,140,480,205
1500000US130510022003,130510022003,"Block Group 3, Census Tract 22, Chatham County, Georgia",692,184,315,107,377,180
1500000US130510022004,130510022004,"Block Group 4, Census Tract 22, Chatham County, Georgia",970,278,311,160,659,288
1500000US130510022005,130510022005,"Block Group 5, Census Tract 22, Chatham County, Georgia",714,199,377,166,337,165
1500000US130510023001,130510023001,"Block Group 1, Census Tract 23, Chatham County, Georgia",1287,281,238,95,1049,301
1500000US130510023002,130510023002,"Block Group 2, Census Tract 23, Chatham County, Georgia",775,169,306,95,469,178
1500000US130510026001,130510026001,"Block Group 1, Census Tract 26, Chatham County, Georgia",765,205,271,108,494,193
1500000US130510026002,130510026002,"Block Group 2, Census Tract 26, Chatham County, Georgia",781,176,361,110,420,169
1500000US130510027001,130510027001,"Block Group 1, Census Tract 27, Chatham County, Georgia",534,204,318,175,216,121
1500000US130510027002,130510027002,"Block Group 2, Census Tract 27, Chatham County, Georgia",1332,525,1014,531,318,180
1500000US130510027003,130510027003,"Block Group 3, Census Tract 27, Chatham County, Georgia",696,226,495,216,201,101
1500000US130510027004,130510027004,"Block Group 4, Census Tract 27, Chatham County, Georgia",406,122,282,110,124,75
1500000US130510028001,130510028001,"Block Group 1, Census Tract 28, Chatham County, Georgia",643,194,345,151,298,162
1500000US130510028002,130510028002,"Block Group 2, Census Tract 28, Chatham County, Georgia",570,221,254,133,316,211
1500000US130510028003,130510028003,"Block Group 3, Census Tract 28, Chatham County, Georgia",780,227,257,176,523,193
1500000US130510029001,130510029001,"Block Group 1, Census Tract 29, Chatham County, Georgia",1083,240,881,304,202,112
1500000US130510029002,130510029002,"Block Group 2, Census Tract 29, Chatham County, Georgia",700,132,550,157,150,96
1500000US130510029003,130510029003,"Block Group 3, Census Tract 29, Chatham County, Georgia",769,146,555,142,214,106
1500000US130510029004,130510029004,"Block Group 4, Census Tract 29, Chatham County, Georgia",601,152,408,139,193,115
1500000US130510030001,130510030001,"Block Group 1, Census Tract 30, Chatham County, Georgia",541,115,367,113,174,94
1500000US130510030002,130510030002,"Block Group 2, Census Tract 30, Chatham County, Georgia",1494,196,951,162,543,156
1500000US130510033011,130510033011,"Block Group 1, Census Tract 33.01, Chatham County, Georgia",1033,229,783,221,250,135
1500000US130510033012,130510033012,"Block Group 2, Census Tract 33.01, Chatham County, Georgia",971,225,246,109,725,228
1500000US130510033021,130510033021,"Block Group 1, Census Tract 33.02, Chatham County, Georgia",768,183,626,176,142,81
1500000US130510033022,130510033022,"Block Group 2, Census Tract 33.02, Chatham County, Georgia",891,180,505,167,386,170
1500000US130510034001,130510034001,"Block Group 1, Census Tract 34, Chatham County, Georgia",777,282,360,244,417,211
1500000US130510034002,130510034002,"Block Group 2, Census Tract 34, Chatham County, Georgia",714,219,311,135,403,200
1500000US130510034003,130510034003,"Block Group 3, Census Tract 34, Chatham County, Georgia",525,182,292,125,233,178
1500000US130510034004,130510034004,"Block Group 4, Census Tract 34, Chatham County, Georgia",1185,288,838,280,347,140
1500000US130510034005,130510034005,"Block Group 5, Census Tract 34, Chatham County, Georgia",595,157,219,107,376,151
1500000US130510035011,130510035011,"Block Group 1, Census Tract 35.01, Chatham County, Georgia",1052,271,496,238,556,193
1500000US130510035012,130510035012,"Block Group 2, Census Tract 35.01, Chatham County, Georgia",1152,245,353,180,799,239
1500000US130510035013,130510035013,"Block Group 3, Census Tract 35.01, Chatham County, Georgia",580,199,168,148,412,161
1500000US130510035021,130510035021,"Block Group 1, Census Tract 35.02, Chatham County, Georgia",561,208,272,163,289,173
1500000US130510035022,130510035022,"Block Group 2, Census Tract 35.02, Chatham County, Georgia",1220,305,416,186,804,344
1500000US130510035023,130510035023,"Block Group 3, Census Tract 35.02, Chatham County, Georgia",1107,343,795,263,312,268
1500000US130510035024,130510035024,"Block Group 4, Census Tract 35.02, Chatham County, Georgia",1268,355,742,304,526,327
1500000US130510036011,130510036011,"Block Group 1, Census Tract 36.01, Chatham County, Georgia",2310,437,747,246,1563,512
1500000US130510036012,130510036012,"Block Group 2, Census Tract 36.01, Chatham County, Georgia",707,254,177,97,530,247
1500000US130510036021,130510036021,"Block Group 1, Census Tract 36.02, Chatham County, Georgia",515,268,128,81,387,264
1500000US130510036022,130510036022,"Block Group 2, Census Tract 36.02, Chatham County, Georgia",1039,379,346,198,693,333
1500000US130510036023,130510036023,"Block Group 3, Census Tract 36.02, Chatham County, Georgia",802,407,325,194,477,370
1500000US130510036024,130510036024,"Block Group 4, Census Tract 36.02, Chatham County, Georgia",858,266,582,228,276,139
1500000US130510036025,130510036025,"Block Group 5, Census Tract 36.02, Chatham County, Georgia",1210,357,575,262,635,294
1500000US130510037001,130510037001,"Block Group 1, Census Tract 37, Chatham County, Georgia",884,190,417,145,467,161
1500000US130510037002,130510037002,"Block Group 2, Census Tract 37, Chatham County, Georgia",879,182,348,138,531,209
1500000US130510038001,130510038001,"Block Group 1, Census Tract 38, Chatham County, Georgia",1214,273,836,242,378,184
1500000US130510038002,130510038002,"Block Group 2, Census Tract 38, Chatham County, Georgia",859,187,354,148,505,179
1500000US130510039001,130510039001,"Block Group 1, Census Tract 39, Chatham County, Georgia",704,233,439,180,265,173
1500000US130510039002,130510039002,"Block Group 2, Census Tract 39, Chatham County, Georgia",765,316,491,299,274,149
1500000US130510039003,130510039003,"Block Group 3, Census Tract 39, Chatham County, Georgia",924,381,473,202,451,317
1500000US130510039004,130510039004,"Block Group 4, Census Tract 39, Chatham County, Georgia",1202,504,727,407,475,360
1500000US130510040011,130510040011,"Block Group 1, Census Tract 40.01, Chatham County, Georgia",735,228,546,123,189,208
1500000US130510040012,130510040012,"Block Group 2, Census Tract 40.01, Chatham County, Georgia",657,192,557,201,100,77
1500000US130510040013,130510040013,"Block Group 3, Census Tract 40.01, Chatham County, Georgia",1072,249,676,211,396,176
1500000US130510040014,130510040014,"Block Group 4, Census Tract 40.01, Chatham County, Georgia",749,146,446,122,303,107
1500000US130510040015,130510040015,"Block Group 5, Census Tract 40.01, Chatham County, Georgia",957,363,94,76,863,364
1500000US130510040021,130510040021,"Block Group 1, Census Tract 40.02, Chatham County, Georgia",768,269,492,179,276,224
1500000US130510040022,130510040022,"Block Group 2, Census Tract 40.02, Chatham County, Georgia",1279,250,436,170,843,243
1500000US130510040023,130510040023,"Block Group 3, Census Tract 40.02, Chatham County, Georgia",711,298,102,66,609,304
1500000US130510040024,130510040024,"Block Group 4, Census Tract 40.02, Chatham County, Georgia",841,242,471,216,370,176
1500000US130510041001,130510041001,"Block Group 1, Census Tract 41, Chatham County, Georgia",1222,170,663,133,559,177
1500000US130510041002,130510041002,"Block Group 2, Census Tract 41, Chatham County, Georgia",575,115,476,106,99,62
1500000US130510042071,130510042071,"Block Group 1, Census Tract 42.07, Chatham County, Georgia",2232,418,442,185,1790,372
1500000US130510042072,130510042072,"Block Group 2, Census Tract 42.07, Chatham County, Georgia",1144,291,621,202,523,229
1500000US130510042073,130510042073,"Block Group 3, Census Tract 42.07, Chatham County, Georgia",187,112,0,13,187,112
1500000US130510042081,130510042081,"Block Group 1, Census Tract 42.08, Chatham County, Georgia",1303,322,771,307,532,272
1500000US130510042082,130510042082,"Block Group 2, Census Tract 42.08, Chatham County, Georgia",772,364,285,139,487,355
1500000US130510042083,130510042083,"Block Group 3, Census Tract 42.08, Chatham County, Georgia",697,216,353,150,344,214
1500000US130510042084,130510042084,"Block Group 4, Census Tract 42.08, Chatham County, Georgia",1245,289,367,130,878,300
1500000US130510042085,130510042085,"Block Group 5, Census Tract 42.08, Chatham County, Georgia",1113,259,0,13,1113,259
1500000US130510042091,130510042091,"Block Group 1, Census Tract 42.09, Chatham County, Georgia",1537,343,395,132,1142,330
1500000US130510042092,130510042092,"Block Group 2, Census Tract 42.09, Chatham County, Georgia",1280,348,0,13,1280,348
1500000US130510042093,130510042093,"Block Group 3, Census Tract 42.09, Chatham County, Georgia",564,160,395,132,169,134
1500000US130510042101,130510042101,"Block Group 1, Census Tract 42.10, Chatham County, Georgia",422,196,0,13,422,196
1500000US130510042102,130510042102,"Block Group 2, Census Tract 42.10, Chatham County, Georgia",1637,439,559,346,1078,437
1500000US130510042103,130510042103,"Block Group 3, Census Tract 42.10, Chatham County, Georgia",1481,433,834,399,647,260
1500000US130510042104,130510042104,"Block Group 4, Census Tract 42.10, Chatham County, Georgia",1462,391,330,147,1132,362
1500000US130510042111,130510042111,"Block Group 1, Census Tract 42.11, Chatham County, Georgia",773,338,210,150,563,307
1500000US130510042112,130510042112,"Block Group 2, Census Tract 42.11, Chatham County, Georgia",1737,502,1242,476,495,266
1500000US130510042113,130510042113,"Block Group 3, Census Tract 42.11, Chatham County, Georgia",1349,457,967,447,382,247
1500000US130510042114,130510042114,"Block Group 4, Census Tract 42.11, Chatham County, Georgia",1311,317,1263,324,48,61
1500000US130510042121,130510042121,"Block Group 1, Census Tract 42.12, Chatham County, Georgia",2239,367,981,350,1258,244
1500000US130510042122,130510042122,"Block Group 2, Census Tract 42.12, Chatham County, Georgia",1434,327,1209,345,225,180
1500000US130510042123,130510042123,"Block Group 3, Census Tract 42.12, Chatham County, Georgia",1193,266,1147,263,46,60
1500000US130510043001,130510043001,"Block Group 1, Census Tract 43, Chatham County, Georgia",2061,242,0,13,2061,242
1500000US130510044001,130510044001,"Block Group 1, Census Tract 44, Chatham County, Georgia",1232,171,183,79,1049,174
1500000US130510044002,130510044002,"Block Group 2, Census Tract 44, Chatham County, Georgia",884,168,390,132,494,177
1500000US130510045001,130510045001,"Block Group 1, Census Tract 45, Chatham County, Georgia",556,261,189,123,367,263
1500000US130510045002,130510045002,"Block Group 2, Census Tract 45, Chatham County, Georgia",1008,413,766,415,242,198
1500000US130510045003,130510045003,"Block Group 3, Census Tract 45, Chatham County, Georgia",1498,383,1053,254,445,316
1500000US130510045004,130510045004,"Block Group 4, Census Tract 45, Chatham County, Georgia",1177,303,713,247,464,248
1500000US130510101011,130510101011,"Block Group 1, Census Tract 101.01, Chatham County, Georgia",553,156,0,13,553,156
1500000US130510101012,130510101012,"Block Group 2, Census Tract 101.01, Chatham County, Georgia",362,53,323,72,39,47
1500000US130510101021,130510101021,"Block Group 1, Census Tract 101.02, Chatham County, Georgia",1021,201,378,150,643,169
1500000US130510101022,130510101022,"Block Group 2, Census Tract 101.02, Chatham County, Georgia",854,319,324,125,530,290
1500000US130510101023,130510101023,"Block Group 3, Census Tract 101.02, Chatham County, Georgia",1360,211,848,217,512,188
1500000US130510102001,130510102001,"Block Group 1, Census Tract 102, Chatham County, Georgia",1483,403,1335,388,148,138
1500000US130510102002,130510102002,"Block Group 2, Census Tract 102, Chatham County, Georgia",1686,396,1043,313,643,344
1500000US130510102003,130510102003,"Block Group 3, Census Tract 102, Chatham County, Georgia",1481,484,859,336,622,379
1500000US130510105011,130510105011,"Block Group 1, Census Tract 105.01, Chatham County, Georgia",868,422,181,166,687,439
1500000US130510105012,130510105012,"Block Group 2, Census Tract 105.01, Chatham County, Georgia",901,408,677,495,224,236
1500000US130510105013,130510105013,"Block Group 3, Census Tract 105.01, Chatham County, Georgia",2383,484,244,132,2139,501
1500000US130510105014,130510105014,"Block Group 4, Census Tract 105.01, Chatham County, Georgia",536,330,174,105,362,321
1500000US130510105015,130510105015,"Block Group 5, Census Tract 105.01, Chatham County, Georgia",560,254,184,203,376,300
1500000US130510105021,130510105021,"Block Group 1, Census Tract 105.02, Chatham County, Georgia",913,349,44,41,869,348
1500000US130510105022,130510105022,"Block Group 2, Census Tract 105.02, Chatham County, Georgia",2674,421,1439,325,1235,360
1500000US130510106011,130510106011,"Block Group 1, Census Tract 106.01, Chatham County, Georgia",349,182,263,145,86,138
1500000US130510106012,130510106012,"Block Group 2, Census Tract 106.01, Chatham County, Georgia",1017,315,684,341,333,268
1500000US130510106013,130510106013,"Block Group 3, Census Tract 106.01, Chatham County, Georgia",429,223,187,133,242,186
1500000US130510106014,130510106014,"Block Group 4, Census Tract 106.01, Chatham County, Georgia",784,356,309,230,475,309
1500000US130510106015,130510106015,"Block Group 5, Census Tract 106.01, Chatham County, Georgia",733,393,57,89,676,374
1500000US130510106016,130510106016,"Block Group 6, Census Tract 106.01, Chatham County, Georgia",918,460,120,87,798,472
1500000US130510106031,130510106031,"Block Group 1, Census Tract 106.03, Chatham County, Georgia",1869,268,523,139,1346,245
1500000US130510106051,130510106051,"Block Group 1, Census Tract 106.05, Chatham County, Georgia",10,15,0,13,10,15
1500000US130510107001,130510107001,"Block Group 1, Census Tract 107, Chatham County, Georgia",17886,1765,11791,1900,6095,1278
1500000US130510107002,130510107002,"Block Group 2, Census Tract 107, Chatham County, Georgia",748,433,579,399,169,226
1500000US130510107003,130510107003,"Block Group 3, Census Tract 107, Chatham County, Georgia",607,401,411,273,196,313
1500000US130510108011,130510108011,"Block Group 1, Census Tract 108.01, Chatham County, Georgia",1340,193,933,195,407,172
1500000US130510108012,130510108012,"Block Group 2, Census Tract 108.01, Chatham County, Georgia",1313,177,835,168,478,116
1500000US130510108021,130510108021,"Block Group 1, Census Tract 108.02, Chatham County, Georgia",7320,875,4377,765,2943,835
1500000US130510108022,130510108022,"Block Group 2, Census Tract 108.02, Chatham County, Georgia",2052,602,1768,599,284,213
1500000US130510108031,130510108031,"Block Group 1, Census Tract 108.03, Chatham County, Georgia",1284,371,1212,374,72,82
1500000US130510108032,130510108032,"Block Group 2, Census Tract 108.03, Chatham County, Georgia",826,454,561,348,265,274
1500000US130510108033,130510108033,"Block Group 3, Census Tract 108.03, Chatham County, Georgia",4337,898,2870,768,1467,623
1500000US130510108034,130510108034,"Block Group 4, Census Tract 108.03, Chatham County, Georgia",4685,873,3912,858,773,425
1500000US130510108061,130510108061,"Block Group 1, Census Tract 108.06, Chatham County, Georgia",2010,496,1082,322,928,442
1500000US130510108062,130510108062,"Block Group 2, Census Tract 108.06, Chatham County, Georgia",702,232,439,200,263,113
1500000US130510108063,130510108063,"Block Group 3, Census Tract 108.06, Chatham County, Georgia",1330,435,726,356,604,369
1500000US130510108064,130510108064,"Block Group 4, Census Tract 108.06, Chatham County, Georgia",2342,527,502,304,1840,604
1500000US130510108071,130510108071,"Block Group 1, Census Tract 108.07, Chatham County, Georgia",2702,603,1976,538,726,424
1500000US130510108072,130510108072,"Block Group 2, Census Tract 108.07, Chatham County, Georgia",299,192,299,192,0,13
1500000US130510108073,130510108073,"Block Group 3, Census Tract 108.07, Chatham County, Georgia",1959,440,778,342,1181,402
1500000US130510108081,130510108081,"Block Group 1, Census Tract 108.08, Chatham County, Georgia",3843,781,1742,520,2101,659
1500000US130510108082,130510108082,"Block Group 2, Census Tract 108.08, Chatham County, Georgia",1294,654,338,274,956,750
1500000US130510108083,130510108083,"Block Group 3, Census Tract 108.08, Chatham County, Georgia",2249,728,1606,600,643,514
1500000US130510108084,130510108084,"Block Group 4, Census Tract 108.08, Chatham County, Georgia",3335,931,1848,762,1487,603
1500000US130510108091,130510108091,"Block Group 1, Census Tract 108.09, Chatham County, Georgia",4719,821,3892,790,827,456
1500000US130510108092,130510108092,"Block Group 2, Census Tract 108.09, Chatham County, Georgia",7053,845,4461,824,2592,769
1500000US130510109011,130510109011,"Block Group 1, Census Tract 109.01, Chatham County, Georgia",1881,427,676,234,1205,427
1500000US130510109012,130510109012,"Block Group 2, Census Tract 109.01, Chatham County, Georgia",1366,402,17,26,1349,403
1500000US130510109013,130510109013,"Block Group 3, Census Tract 109.01, Chatham County, Georgia",809,262,470,239,339,176
1500000US130510110031,130510110031,"Block Group 1, Census Tract 110.03, Chatham County, Georgia",1996,406,1763,366,233,199
1500000US130510110032,130510110032,"Block Group 2, Census Tract 110.03, Chatham County, Georgia",1343,460,802,373,541,313
1500000US130510110033,130510110033,"Block Group 3, Census Tract 110.03, Chatham County, Georgia",1649,539,1091,414,558,409
1500000US130510110034,130510110034,"Block Group 4, Census Tract 110.03, Chatham County, Georgia",643,277,369,226,274,186
1500000US130510110035,130510110035,"Block Group 5, Census Tract 110.03, Chatham County, Georgia",909,231,897,233,12,20
1500000US130510110041,130510110041,"Block Group 1, Census Tract 110.04, Chatham County, Georgia",1729,249,1715,251,14,22
1500000US130510110042,130510110042,"Block Group 2, Census Tract 110.04, Chatham County, Georgia",1019,181,820,167,199,113
1500000US130510110043,130510110043,"Block Group 3, Census Tract 110.04, Chatham County, Georgia",756,193,663,199,93,79
1500000US130510110051,130510110051,"Block Group 1, Census Tract 110.05, Chatham County, Georgia",684,223,659,226,25,30
1500000US130510110052,130510110052,"Block Group 2, Census Tract 110.05, Chatham County, Georgia",1071,209,1071,209,0,13
1500000US130510110053,130510110053,"Block Group 3, Census Tract 110.05, Chatham County, Georgia",1156,315,1156,315,0,13
1500000US130510110054,130510110054,"Block Group 4, Census Tract 110.05, Chatham County, Georgia",1597,279,1597,279,0,13
1500000US130510110061,130510110061,"Block Group 1, Census Tract 110.06, Chatham County, Georgia",1145,198,1036,186,109,58
1500000US130510110062,130510110062,"Block Group 2, Census Tract 110.06, Chatham County, Georgia",2417,266,2186,302,231,168
1500000US130510111031,130510111031,"Block Group 1, Census Tract 111.03, Chatham County, Georgia",825,342,639,274,186,226
1500000US130510111032,130510111032,"Block Group 2, Census Tract 111.03, Chatham County, Georgia",841,250,603,238,238,166
1500000US130510111033,130510111033,"Block Group 3, Census Tract 111.03, Chatham County, Georgia",694,264,432,202,262,233
1500000US130510111034,130510111034,"Block Group 4, Census Tract 111.03, Chatham County, Georgia",918,312,481,295,437,219
1500000US130510111041,130510111041,"Block Group 1, Census Tract 111.04, Chatham County, Georgia",1560,352,795,251,765,324
1500000US130510111042,130510111042,"Block Group 2, Census Tract 111.04, Chatham County, Georgia",2562,491,2116,516,446,328
1500000US130510111043,130510111043,"Block Group 3, Census Tract 111.04, Chatham County, Georgia",830,302,717,305,113,88
1500000US130510111061,130510111061,"Block Group 1, Census Tract 111.06, Chatham County, Georgia",2597,425,1694,376,903,269
1500000US130510111062,130510111062,"Block Group 2, Census Tract 111.06, Chatham County, Georgia",3197,586,2065,585,1132,400
1500000US130510111071,130510111071,"Block Group 1, Census Tract 111.07, Chatham County, Georgia",662,209,617,220,45,43
1500000US130510111072,130510111072,"Block Group 2, Census Tract 111.07, Chatham County, Georgia",1237,249,1237,249,0,13
1500000US130510111073,130510111073,"Block Group 3, Census Tract 111.07, Chatham County, Georgia",1175,222,1053,215,122,85
1500000US130510111081,130510111081,"Block Group 1, Census Tract 111.08, Chatham County, Georgia",1488,235,1283,242,205,151
1500000US130510111082,130510111082,"Block Group 2, Census Tract 111.08, Chatham County, Georgia",1511,276,1262,340,249,184
1500000US130510111091,130510111091,"Block Group 1, Census Tract 111.09, Chatham County, Georgia",2143,443,1821,468,322,216
1500000US130510111092,130510111092,"Block Group 2, Census Tract 111.09, Chatham County, Georgia",3031,467,2266,429,765,298
1500000US130510111093,130510111093,"Block Group 3, Census Tract 111.09, Chatham County, Georgia",962,233,900,223,62,71
1500000US130510111094,130510111094,"Block Group 4, Census Tract 111.09, Chatham County, Georgia",683,224,443,244,240,192
1500000US130510112001,130510112001,"Block Group 1, Census Tract 112, Chatham County, Georgia",874,164,261,64,613,155
1500000US130510112002,130510112002,"Block Group 2, Census Tract 112, Chatham County, Georgia",714,155,334,141,380,91
1500000US130510113001,130510113001,"Block Group 1, Census Tract 113, Chatham County, Georgia",1181,323,197,138,984,349
1500000US130510113002,130510113002,"Block Group 2, Census Tract 113, Chatham County, Georgia",1270,333,245,150,1025,303
1500000US130510114001,130510114001,"Block Group 1, Census Tract 114, Chatham County, Georgia",1262,241,487,244,775,146
1500000US130510114002,130510114002,"Block Group 2, Census Tract 114, Chatham County, Georgia",770,169,132,77,638,165
1500000US130510115001,130510115001,"Block Group 1, Census Tract 115, Chatham County, Georgia",1123,195,974,205,149,79
1500000US130510115002,130510115002,"Block Group 2, Census Tract 115, Chatham County, Georgia",1460,207,1432,207,28,26
1500000US130510116001,130510116001,"Block Group 1, Census Tract 116, Chatham County, Georgia",1028,323,331,103,697,367
1500000US130510116002,130510116002,"Block Group 2, Census Tract 116, Chatham County, Georgia",1416,367,380,151,1036,353
1500000US130519800001,130519800001,"Block Group 1, Census Tract 9800, Chatham County, Georgia",0,13,0,13,0,13
1500000US130519900000,130519900000,"Block Group 0, Census Tract 9900, Chatham County, Georgia",0,13,0,13,0,13
1500000US130530201001,130530201001,"Block Group 1, Census Tract 201, Chattahoochee County, Georgia",1600,300,1079,245,521,238
1500000US130530201002,130530201002,"Block Group 2, Census Tract 201, Chattahoochee County, Georgia",948,242,782,274,166,137
1500000US130530202011,130530202011,"Block Group 1, Census Tract 202.01, Chattahoochee County, Georgia",793,141,0,13,793,141
1500000US130530202012,130530202012,"Block Group 2, Census Tract 202.01, Chattahoochee County, Georgia",241,181,0,13,241,181
1500000US130530202031,130530202031,"Block Group 1, Census Tract 202.03, Chattahoochee County, Georgia",1818,290,19,32,1799,291
1500000US130530202032,130530202032,"Block Group 2, Census Tract 202.03, Chattahoochee County, Georgia",182,81,0,13,182,81
1500000US130530202051,130530202051,"Block Group 1, Census Tract 202.05, Chattahoochee County, Georgia",1341,249,55,61,1286,244
1500000US130530202052,130530202052,"Block Group 2, Census Tract 202.05, Chattahoochee County, Georgia",458,131,0,13,458,131
1500000US130530202053,130530202053,"Block Group 3, Census Tract 202.05, Chattahoochee County, Georgia",1039,255,0,13,1039,255
1500000US130530202061,130530202061,"Block Group 1, Census Tract 202.06, Chattahoochee County, Georgia",0,13,0,13,0,13
1500000US130550101001,130550101001,"Block Group 1, Census Tract 101, Chattooga County, Georgia",756,142,652,136,104,62
1500000US130550101002,130550101002,"Block Group 2, Census Tract 101, Chattooga County, Georgia",1233,135,989,134,244,118
1500000US130550102001,130550102001,"Block Group 1, Census Tract 102, Chattooga County, Georgia",802,348,551,254,251,255
1500000US130550102002,130550102002,"Block Group 2, Census Tract 102, Chattooga County, Georgia",989,243,493,167,496,209
1500000US130550102003,130550102003,"Block Group 3, Census Tract 102, Chattooga County, Georgia",862,247,744,249,118,74
1500000US130550102004,130550102004,"Block Group 4, Census Tract 102, Chattooga County, Georgia",1519,478,1059,459,460,224
1500000US130550102005,130550102005,"Block Group 5, Census Tract 102, Chattooga County, Georgia",1170,217,439,181,731,272
1500000US130550102006,130550102006,"Block Group 6, Census Tract 102, Chattooga County, Georgia",978,285,853,303,125,123
1500000US130550103001,130550103001,"Block Group 1, Census Tract 103, Chattooga County, Georgia",919,208,531,193,388,152
1500000US130550103002,130550103002,"Block Group 2, Census Tract 103, Chattooga County, Georgia",1074,275,933,280,141,83
1500000US130550103003,130550103003,"Block Group 3, Census Tract 103, Chattooga County, Georgia",934,231,544,178,390,214
1500000US130550104001,130550104001,"Block Group 1, Census Tract 104, Chattooga County, Georgia",2421,504,1856,518,565,343
1500000US130550104002,130550104002,"Block Group 2, Census Tract 104, Chattooga County, Georgia",1358,326,629,247,729,272
1500000US130550104003,130550104003,"Block Group 3, Census Tract 104, Chattooga County, Georgia",851,238,701,240,150,107
1500000US130550104004,130550104004,"Block Group 4, Census Tract 104, Chattooga County, Georgia",644,271,172,185,472,219
1500000US130550105001,130550105001,"Block Group 1, Census Tract 105, Chattooga County, Georgia",978,228,547,162,431,205
1500000US130550105002,130550105002,"Block Group 2, Census Tract 105, Chattooga County, Georgia",1029,283,753,201,276,224
1500000US130550105003,130550105003,"Block Group 3, Census Tract 105, Chattooga County, Georgia",716,196,479,165,237,168
1500000US130550105004,130550105004,"Block Group 4, Census Tract 105, Chattooga County, Georgia",848,259,415,191,433,177
1500000US130550105005,130550105005,"Block Group 5, Census Tract 105, Chattooga County, Georgia",741,214,373,142,368,182
1500000US130550106001,130550106001,"Block Group 1, Census Tract 106, Chattooga County, Georgia",1477,257,1036,239,441,188
1500000US130550106002,130550106002,"Block Group 2, Census Tract 106, Chattooga County, Georgia",1026,218,690,206,336,122
1500000US130570901001,130570901001,"Block Group 1, Census Tract 901, Cherokee County, Georgia",999,480,709,312,290,381
1500000US130570901002,130570901002,"Block Group 2, Census Tract 901, Cherokee County, Georgia",2904,392,2626,379,278,141
1500000US130570901003,130570901003,"Block Group 3, Census Tract 901, Cherokee County, Georgia",1649,284,1302,245,347,209
1500000US130570901004,130570901004,"Block Group 4, Census Tract 901, Cherokee County, Georgia",3378,547,2602,580,776,456
1500000US130570902001,130570902001,"Block Group 1, Census Tract 902, Cherokee County, Georgia",1549,545,1468,546,81,95
1500000US130570902002,130570902002,"Block Group 2, Census Tract 902, Cherokee County, Georgia",3132,581,2617,536,515,347
1500000US130570902003,130570902003,"Block Group 3, Census Tract 902, Cherokee County, Georgia",2926,459,2473,451,453,275
1500000US130570903001,130570903001,"Block Group 1, Census Tract 903, Cherokee County, Georgia",5042,691,4211,593,831,460
1500000US130570903002,130570903002,"Block Group 2, Census Tract 903, Cherokee County, Georgia",7346,695,6439,713,907,427
1500000US130570904001,130570904001,"Block Group 1, Census Tract 904, Cherokee County, Georgia",1121,335,590,283,531,295
1500000US130570904002,130570904002,"Block Group 2, Census Tract 904, Cherokee County, Georgia",4952,1017,2689,861,2263,769
1500000US130570904003,130570904003,"Block Group 3, Census Tract 904, Cherokee County, Georgia",3660,607,626,398,3034,558
1500000US130570905011,130570905011,"Block Group 1, Census Tract 905.01, Cherokee County, Georgia",1774,482,1663,474,111,160
1500000US130570905012,130570905012,"Block Group 2, Census Tract 905.01, Cherokee County, Georgia",4499,515,3974,570,525,333
1500000US130570905021,130570905021,"Block Group 1, Census Tract 905.02, Cherokee County, Georgia",7231,1129,7096,1119,135,188
1500000US130570905022,130570905022,"Block Group 2, Census Tract 905.02, Cherokee County, Georgia",1932,792,1215,460,717,788
1500000US130570905023,130570905023,"Block Group 3, Census Tract 905.02, Cherokee County, Georgia",3282,1428,3096,1432,186,181
1500000US130570905024,130570905024,"Block Group 4, Census Tract 905.02, Cherokee County, Georgia",1470,470,1290,536,180,215
1500000US130570906011,130570906011,"Block Group 1, Census Tract 906.01, Cherokee County, Georgia",1403,495,1029,367,374,375
1500000US130570906012,130570906012,"Block Group 2, Census Tract 906.01, Cherokee County, Georgia",3620,668,1641,385,1979,658
1500000US130570906013,130570906013,"Block Group 3, Census Tract 906.01, Cherokee County, Georgia",2037,734,410,361,1627,756
1500000US130570906021,130570906021,"Block Group 1, Census Tract 906.02, Cherokee County, Georgia",5100,506,4411,539,689,406
1500000US130570906022,130570906022,"Block Group 2, Census Tract 906.02, Cherokee County, Georgia",1809,502,1465,445,344,302
1500000US130570906023,130570906023,"Block Group 3, Census Tract 906.02, Cherokee County, Georgia",1371,526,345,206,1026,514
1500000US130570907011,130570907011,"Block Group 1, Census Tract 907.01, Cherokee County, Georgia",4068,1339,3550,1460,518,480
1500000US130570907012,130570907012,"Block Group 2, Census Tract 907.01, Cherokee County, Georgia",2082,948,1989,948,93,162
1500000US130570907013,130570907013,"Block Group 3, Census Tract 907.01, Cherokee County, Georgia",5277,1434,4741,1473,536,625
1500000US130570907014,130570907014,"Block Group 4, Census Tract 907.01, Cherokee County, Georgia",7376,1179,4452,997,2924,1080
1500000US130570907021,130570907021,"Block Group 1, Census Tract 907.02, Cherokee County, Georgia",2742,591,1757,444,985,425
1500000US130570907022,130570907022,"Block Group 2, Census Tract 907.02, Cherokee County, Georgia",1229,464,947,419,282,252
1500000US130570907023,130570907023,"Block Group 3, Census Tract 907.02, Cherokee County, Georgia",2197,539,1572,489,625,341
1500000US130570907024,130570907024,"Block Group 4, Census Tract 907.02, Cherokee County, Georgia",1520,436,1430,417,90,147
1500000US130570908021,130570908021,"Block Group 1, Census Tract 908.02, Cherokee County, Georgia",1996,402,1759,416,237,169
1500000US130570908022,130570908022,"Block Group 2, Census Tract 908.02, Cherokee County, Georgia",1949,394,1813,394,136,128
1500000US130570908023,130570908023,"Block Group 3, Census Tract 908.02, Cherokee County, Georgia",2983,657,2267,503,716,718
1500000US130570908031,130570908031,"Block Group 1, Census Tract 908.03, Cherokee County, Georgia",5678,606,5149,644,529,229
1500000US130570908032,130570908032,"Block Group 2, Census Tract 908.03, Cherokee County, Georgia",2276,566,2220,554,56,90
1500000US130570908033,130570908033,"Block Group 3, Census Tract 908.03, Cherokee County, Georgia",2301,608,2172,587,129,151
1500000US130570908041,130570908041,"Block Group 1, Census Tract 908.04, Cherokee County, Georgia",3220,669,2735,618,485,361
1500000US130570908042,130570908042,"Block Group 2, Census Tract 908.04, Cherokee County, Georgia",4687,681,3994,643,693,441
1500000US130570908043,130570908043,"Block Group 3, Census Tract 908.04, Cherokee County, Georgia",1558,503,1515,513,43,68
1500000US130570909011,130570909011,"Block Group 1, Census Tract 909.01, Cherokee County, Georgia",2676,590,2555,606,121,137
1500000US130570909012,130570909012,"Block Group 2, Census Tract 909.01, Cherokee County, Georgia",3420,667,2735,624,685,396
1500000US130570909013,130570909013,"Block Group 3, Census Tract 909.01, Cherokee County, Georgia",1697,456,1554,468,143,94
1500000US130570909021,130570909021,"Block Group 1, Census Tract 909.02, Cherokee County, Georgia",1603,424,1357,403,246,308
1500000US130570909022,130570909022,"Block Group 2, Census Tract 909.02, Cherokee County, Georgia",2418,641,2176,660,242,204
1500000US130570909023,130570909023,"Block Group 3, Census Tract 909.02, Cherokee County, Georgia",6168,891,4642,802,1526,767
1500000US130570909024,130570909024,"Block Group 4, Census Tract 909.02, Cherokee County, Georgia",2281,443,1845,418,436,304
1500000US130570909025,130570909025,"Block Group 5, Census Tract 909.02, Cherokee County, Georgia",1969,557,1969,557,0,13
1500000US130570909041,130570909041,"Block Group 1, Census Tract 909.04, Cherokee County, Georgia",3010,626,2361,673,649,472
1500000US130570909042,130570909042,"Block Group 2, Census Tract 909.04, Cherokee County, Georgia",1534,629,783,397,751,532
1500000US130570909043,130570909043,"Block Group 3, Census Tract 909.04, Cherokee County, Georgia",2562,687,2423,735,139,168
1500000US130570909044,130570909044,"Block Group 4, Census Tract 909.04, Cherokee County, Georgia",1427,400,514,196,913,343
1500000US130570909051,130570909051,"Block Group 1, Census Tract 909.05, Cherokee County, Georgia",2048,272,1775,272,273,175
1500000US130570909052,130570909052,"Block Group 2, Census Tract 909.05, Cherokee County, Georgia",1524,288,712,205,812,242
1500000US130570910011,130570910011,"Block Group 1, Census Tract 910.01, Cherokee County, Georgia",802,264,199,120,603,281
1500000US130570910012,130570910012,"Block Group 2, Census Tract 910.01, Cherokee County, Georgia",791,451,509,314,282,362
1500000US130570910013,130570910013,"Block Group 3, Census Tract 910.01, Cherokee County, Georgia",2704,449,1193,253,1511,467
1500000US130570910031,130570910031,"Block Group 1, Census Tract 910.03, Cherokee County, Georgia",3000,560,1505,410,1495,474
1500000US130570910032,130570910032,"Block Group 2, Census Tract 910.03, Cherokee County, Georgia",1585,637,615,284,970,590
1500000US130570910033,130570910033,"Block Group 3, Census Tract 910.03, Cherokee County, Georgia",2662,523,1513,389,1149,467
1500000US130570910051,130570910051,"Block Group 1, Census Tract 910.05, Cherokee County, Georgia",2935,653,1418,393,1517,636
1500000US130570910052,130570910052,"Block Group 2, Census Tract 910.05, Cherokee County, Georgia",779,335,471,255,308,318
1500000US130570910053,130570910053,"Block Group 3, Census Tract 910.05, Cherokee County, Georgia",2472,787,1100,426,1372,689
1500000US130570910054,130570910054,"Block Group 4, Census Tract 910.05, Cherokee County, Georgia",1833,924,1666,962,167,208
1500000US130570910061,130570910061,"Block Group 1, Census Tract 910.06, Cherokee County, Georgia",2345,305,1783,263,562,301
1500000US130570910062,130570910062,"Block Group 2, Census Tract 910.06, Cherokee County, Georgia",2549,339,2444,372,105,106
1500000US130570910071,130570910071,"Block Group 1, Census Tract 910.07, Cherokee County, Georgia",2091,417,2091,417,0,13
1500000US130570910072,130570910072,"Block Group 2, Census Tract 910.07, Cherokee County, Georgia",2852,640,2404,621,448,350
1500000US130570910073,130570910073,"Block Group 3, Census Tract 910.07, Cherokee County, Georgia",1657,470,1548,470,109,136
1500000US130570910081,130570910081,"Block Group 1, Census Tract 910.08, Cherokee County, Georgia",1174,349,1037,347,137,237
1500000US130570910082,130570910082,"Block Group 2, Census Tract 910.08, Cherokee County, Georgia",1248,348,1248,348,0,13
1500000US130570910083,130570910083,"Block Group 3, Census Tract 910.08, Cherokee County, Georgia",1876,444,1876,444,0,13
1500000US130570910084,130570910084,"Block Group 4, Census Tract 910.08, Cherokee County, Georgia",3894,672,2855,560,1039,399
1500000US130570911011,130570911011,"Block Group 1, Census Tract 911.01, Cherokee County, Georgia",1871,376,1652,381,219,148
1500000US130570911012,130570911012,"Block Group 2, Census Tract 911.01, Cherokee County, Georgia",1961,347,1702,349,259,150
1500000US130570911013,130570911013,"Block Group 3, Census Tract 911.01, Cherokee County, Georgia",2164,488,1549,451,615,442
1500000US130570911021,130570911021,"Block Group 1, Census Tract 911.02, Cherokee County, Georgia",1965,609,1329,477,636,415
1500000US130570911022,130570911022,"Block Group 2, Census Tract 911.02, Cherokee County, Georgia",3188,613,2501,591,687,420
1500000US130570911023,130570911023,"Block Group 3, Census Tract 911.02, Cherokee County, Georgia",1830,444,1532,439,298,146
1500000US130570911024,130570911024,"Block Group 4, Census Tract 911.02, Cherokee County, Georgia",2004,683,1278,508,726,567
1500000US130570911031,130570911031,"Block Group 1, Census Tract 911.03, Cherokee County, Georgia",2168,497,1962,534,206,207
1500000US130570911032,130570911032,"Block Group 2, Census Tract 911.03, Cherokee County, Georgia",2699,497,1966,463,733,477
1500000US130570911033,130570911033,"Block Group 3, Census Tract 911.03, Cherokee County, Georgia",1395,480,847,218,548,514
1500000US130570911034,130570911034,"Block Group 4, Census Tract 911.03, Cherokee County, Georgia",2395,695,1783,485,612,505
1500000US130590001001,130590001001,"Block Group 1, Census Tract 1, Clarke County, Georgia",1705,311,60,33,1645,310
1500000US130590004011,130590004011,"Block Group 1, Census Tract 4.01, Clarke County, Georgia",1234,148,24,18,1210,152
1500000US130590004021,130590004021,"Block Group 1, Census Tract 4.02, Clarke County, Georgia",609,158,0,13,609,158
1500000US130590004022,130590004022,"Block Group 2, Census Tract 4.02, Clarke County, Georgia",106,143,0,13,106,143
1500000US130590004023,130590004023,"Block Group 3, Census Tract 4.02, Clarke County, Georgia",0,13,0,13,0,13
1500000US130590006001,130590006001,"Block Group 1, Census Tract 6, Clarke County, Georgia",991,284,81,40,910,291
1500000US130590006002,130590006002,"Block Group 2, Census Tract 6, Clarke County, Georgia",1316,219,245,93,1071,226
1500000US130590009001,130590009001,"Block Group 1, Census Tract 9, Clarke County, Georgia",993,351,161,148,832,369
1500000US130590009002,130590009002,"Block Group 2, Census Tract 9, Clarke County, Georgia",1150,352,335,160,815,335
1500000US130590009003,130590009003,"Block Group 3, Census Tract 9, Clarke County, Georgia",1029,316,344,140,685,285
1500000US130590012001,130590012001,"Block Group 1, Census Tract 12, Clarke County, Georgia",1985,382,707,231,1278,321
1500000US130590012002,130590012002,"Block Group 2, Census Tract 12, Clarke County, Georgia",1050,380,612,226,438,366
1500000US130590017001,130590017001,"Block Group 1, Census Tract 17, Clarke County, Georgia",2021,158,1410,196,611,176
1500000US130590018001,130590018001,"Block Group 1, Census Tract 18, Clarke County, Georgia",1040,232,691,254,349,118
1500000US130590018002,130590018002,"Block Group 2, Census Tract 18, Clarke County, Georgia",158,102,23,36,135,95
1500000US130590018003,130590018003,"Block Group 3, Census Tract 18, Clarke County, Georgia",1094,225,511,156,583,180
1500000US130590019001,130590019001,"Block Group 1, Census Tract 19, Clarke County, Georgia",2091,350,798,227,1293,355
1500000US130590019002,130590019002,"Block Group 2, Census Tract 19, Clarke County, Georgia",2018,484,221,155,1797,483
1500000US130590020001,130590020001,"Block Group 1, Census Tract 20, Clarke County, Georgia",982,198,207,97,775,192
1500000US130590020002,130590020002,"Block Group 2, Census Tract 20, Clarke County, Georgia",1069,160,759,113,310,148
1500000US130590021001,130590021001,"Block Group 1, Census Tract 21, Clarke County, Georgia",1270,218,273,112,997,208
1500000US130590021002,130590021002,"Block Group 2, Census Tract 21, Clarke County, Georgia",1481,329,681,317,800,215
1500000US130590022001,130590022001,"Block Group 1, Census Tract 22, Clarke County, Georgia",1064,208,501,96,563,209
1500000US130590022002,130590022002,"Block Group 2, Census Tract 22, Clarke County, Georgia",1210,260,176,89,1034,257
1500000US130590301001,130590301001,"Block Group 1, Census Tract 301, Clarke County, Georgia",1902,415,521,216,1381,417
1500000US130590301002,130590301002,"Block Group 2, Census Tract 301, Clarke County, Georgia",3006,532,451,284,2555,498
1500000US130590302001,130590302001,"Block Group 1, Census Tract 302, Clarke County, Georgia",1011,315,7,11,1004,317
1500000US130590302002,130590302002,"Block Group 2, Census Tract 302, Clarke County, Georgia",1201,454,352,203,849,454
1500000US130590302003,130590302003,"Block Group 3, Census Tract 302, Clarke County, Georgia",2517,478,850,217,1667,474
1500000US130591303001,130591303001,"Block Group 1, Census Tract 1303, Clarke County, Georgia",2585,597,1667,503,918,368
1500000US130591303002,130591303002,"Block Group 2, Census Tract 1303, Clarke County, Georgia",3377,573,1074,404,2303,524
1500000US130591304001,130591304001,"Block Group 1, Census Tract 1304, Clarke County, Georgia",2554,500,1907,522,647,328
1500000US130591304002,130591304002,"Block Group 2, Census Tract 1304, Clarke County, Georgia",1736,512,1184,504,552,322
1500000US130591304003,130591304003,"Block Group 3, Census Tract 1304, Clarke County, Georgia",1341,445,669,266,672,398
1500000US130591305001,130591305001,"Block Group 1, Census Tract 1305, Clarke County, Georgia",1245,226,886,211,359,170
1500000US130591305002,130591305002,"Block Group 2, Census Tract 1305, Clarke County, Georgia",896,199,688,170,208,144
1500000US130591305003,130591305003,"Block Group 3, Census Tract 1305, Clarke County, Georgia",523,170,376,129,147,119
1500000US130591306001,130591306001,"Block Group 1, Census Tract 1306, Clarke County, Georgia",1596,392,1182,363,414,249
1500000US130591306002,130591306002,"Block Group 2, Census Tract 1306, Clarke County, Georgia",2981,746,1053,335,1928,646
1500000US130591306003,130591306003,"Block Group 3, Census Tract 1306, Clarke County, Georgia",2003,623,178,153,1825,653
1500000US130591307001,130591307001,"Block Group 1, Census Tract 1307, Clarke County, Georgia",2381,466,561,276,1820,467
1500000US130591307002,130591307002,"Block Group 2, Census Tract 1307, Clarke County, Georgia",1270,329,1133,337,137,99
1500000US130591307003,130591307003,"Block Group 3, Census Tract 1307, Clarke County, Georgia",1552,425,351,144,1201,419
1500000US130591403001,130591403001,"Block Group 1, Census Tract 1403, Clarke County, Georgia",1897,507,578,243,1319,491
1500000US130591403002,130591403002,"Block Group 2, Census Tract 1403, Clarke County, Georgia",1282,385,376,133,906,364
1500000US130591403003,130591403003,"Block Group 3, Census Tract 1403, Clarke County, Georgia",2034,538,1402,569,632,239
1500000US130591404001,130591404001,"Block Group 1, Census Tract 1404, Clarke County, Georgia",1190,253,733,169,457,266
1500000US130591404002,130591404002,"Block Group 2, Census Tract 1404, Clarke County, Georgia",2418,468,1232,346,1186,432
1500000US130591405001,130591405001,"Block Group 1, Census Tract 1405, Clarke County, Georgia",1794,261,516,167,1278,259
1500000US130591406001,130591406001,"Block Group 1, Census Tract 1406, Clarke County, Georgia",672,199,556,198,116,85
1500000US130591406002,130591406002,"Block Group 2, Census Tract 1406, Clarke County, Georgia",2793,370,2028,335,765,329
1500000US130591406003,130591406003,"Block Group 3, Census Tract 1406, Clarke County, Georgia",1457,348,344,117,1113,352
1500000US130591503001,130591503001,"Block Group 1, Census Tract 1503, Clarke County, Georgia",1117,248,703,202,414,215
1500000US130591503002,130591503002,"Block Group 2, Census Tract 1503, Clarke County, Georgia",956,340,496,308,460,176
1500000US130591503003,130591503003,"Block Group 3, Census Tract 1503, Clarke County, Georgia",1266,302,989,269,277,105
1500000US130591504001,130591504001,"Block Group 1, Census Tract 1504, Clarke County, Georgia",2276,580,100,69,2176,595
1500000US130591504002,130591504002,"Block Group 2, Census Tract 1504, Clarke County, Georgia",1701,392,257,114,1444,379
1500000US130591504003,130591504003,"Block Group 3, Census Tract 1504, Clarke County, Georgia",961,370,0,13,961,370
1500000US130591505001,130591505001,"Block Group 1, Census Tract 1505, Clarke County, Georgia",1433,325,162,130,1271,308
1500000US130591505002,130591505002,"Block Group 2, Census Tract 1505, Clarke County, Georgia",1352,314,610,230,742,255
1500000US130591505003,130591505003,"Block Group 3, Census Tract 1505, Clarke County, Georgia",1792,467,107,120,1685,465
1500000US130591506001,130591506001,"Block Group 1, Census Tract 1506, Clarke County, Georgia",1361,271,113,89,1248,259
1500000US130591506002,130591506002,"Block Group 2, Census Tract 1506, Clarke County, Georgia",1537,246,265,83,1272,238
1500000US130591507001,130591507001,"Block Group 1, Census Tract 1507, Clarke County, Georgia",1480,372,732,278,748,321
1500000US130591507002,130591507002,"Block Group 2, Census Tract 1507, Clarke County, Georgia",2959,601,969,318,1990,543
1500000US130591507003,130591507003,"Block Group 3, Census Tract 1507, Clarke County, Georgia",1215,429,902,383,313,255
1500000US130591508001,130591508001,"Block Group 1, Census Tract 1508, Clarke County, Georgia",1824,342,1246,323,578,342
1500000US130591508002,130591508002,"Block Group 2, Census Tract 1508, Clarke County, Georgia",945,360,181,113,764,372
1500000US130591508003,130591508003,"Block Group 3, Census Tract 1508, Clarke County, Georgia",1318,427,1041,301,277,362
1500000US130591508004,130591508004,"Block Group 4, Census Tract 1508, Clarke County, Georgia",2027,425,1507,431,520,471
1500000US130591509001,130591509001,"Block Group 1, Census Tract 1509, Clarke County, Georgia",2170,340,1390,311,780,285
1500000US130591509002,130591509002,"Block Group 2, Census Tract 1509, Clarke County, Georgia",1984,407,1086,276,898,386
1500000US130619603001,130619603001,"Block Group 1, Census Tract 9603, Clay County, Georgia",1699,242,1212,257,487,177
1500000US130619603002,130619603002,"Block Group 2, Census Tract 9603, Clay County, Georgia",609,162,140,67,469,151
1500000US130619603003,130619603003,"Block Group 3, Census Tract 9603, Clay County, Georgia",738,182,506,119,232,141
1500000US130630402021,130630402021,"Block Group 1, Census Tract 402.02, Clayton County, Georgia",1350,252,125,77,1225,245
1500000US130630402022,130630402022,"Block Group 2, Census Tract 402.02, Clayton County, Georgia",1139,282,609,176,530,234
1500000US130630402031,130630402031,"Block Group 1, Census Tract 402.03, Clayton County, Georgia",763,432,51,121,712,443
1500000US130630402032,130630402032,"Block Group 2, Census Tract 402.03, Clayton County, Georgia",2434,436,760,267,1674,411
1500000US130630402041,130630402041,"Block Group 1, Census Tract 402.04, Clayton County, Georgia",1149,405,421,204,728,375
1500000US130630402042,130630402042,"Block Group 2, Census Tract 402.04, Clayton County, Georgia",877,349,327,282,550,218
1500000US130630402043,130630402043,"Block Group 3, Census Tract 402.04, Clayton County, Georgia",1554,431,550,233,1004,409
1500000US130630403021,130630403021,"Block Group 1, Census Tract 403.02, Clayton County, Georgia",1190,370,253,181,937,347
1500000US130630403022,130630403022,"Block Group 2, Census Tract 403.02, Clayton County, Georgia",1189,429,496,180,693,443
1500000US130630403023,130630403023,"Block Group 3, Census Tract 403.02, Clayton County, Georgia",1275,467,309,176,966,448
1500000US130630403024,130630403024,"Block Group 4, Census Tract 403.02, Clayton County, Georgia",1177,419,926,394,251,122
1500000US130630403031,130630403031,"Block Group 1, Census Tract 403.03, Clayton County, Georgia",1448,591,1149,501,299,363
1500000US130630403032,130630403032,"Block Group 2, Census Tract 403.03, Clayton County, Georgia",874,440,413,279,461,419
1500000US130630403033,130630403033,"Block Group 3, Census Tract 403.03, Clayton County, Georgia",784,445,393,227,391,411
1500000US130630403034,130630403034,"Block Group 4, Census Tract 403.03, Clayton County, Georgia",1160,468,784,522,376,252
1500000US130630403035,130630403035,"Block Group 5, Census Tract 403.03, Clayton County, Georgia",1048,432,410,328,638,373
1500000US130630403036,130630403036,"Block Group 6, Census Tract 403.03, Clayton County, Georgia",968,584,612,504,356,379
1500000US130630403061,130630403061,"Block Group 1, Census Tract 403.06, Clayton County, Georgia",2143,569,256,149,1887,551
1500000US130630403062,130630403062,"Block Group 2, Census Tract 403.06, Clayton County, Georgia",1914,458,171,142,1743,441
1500000US130630403071,130630403071,"Block Group 1, Census Tract 403.07, Clayton County, Georgia",1803,484,1042,367,761,347
1500000US130630403072,130630403072,"Block Group 2, Census Tract 403.07, Clayton County, Georgia",2753,476,1888,389,865,386
1500000US130630403081,130630403081,"Block Group 1, Census Tract 403.08, Clayton County, Georgia",1511,395,229,128,1282,375
1500000US130630403082,130630403082,"Block Group 2, Census Tract 403.08, Clayton County, Georgia",1653,351,975,360,678,296
1500000US130630403083,130630403083,"Block Group 3, Census Tract 403.08, Clayton County, Georgia",819,218,427,153,392,202
1500000US130630404071,130630404071,"Block Group 1, Census Tract 404.07, Clayton County, Georgia",1919,435,1069,311,850,393
1500000US130630404072,130630404072,"Block Group 2, Census Tract 404.07, Clayton County, Georgia",2143,628,1195,394,948,447
1500000US130630404081,130630404081,"Block Group 1, Census Tract 404.08, Clayton County, Georgia",1674,497,1310,456,364,248
1500000US130630404082,130630404082,"Block Group 2, Census Tract 404.08, Clayton County, Georgia",3097,490,380,295,2717,467
1500000US130630404083,130630404083,"Block Group 3, Census Tract 404.08, Clayton County, Georgia",2473,535,1323,368,1150,420
1500000US130630404091,130630404091,"Block Group 1, Census Tract 404.09, Clayton County, Georgia",2270,367,1291,309,979,302
1500000US130630404092,130630404092,"Block Group 2, Census Tract 404.09, Clayton County, Georgia",3613,651,2612,682,1001,380
1500000US130630404101,130630404101,"Block Group 1, Census Tract 404.10, Clayton County, Georgia",5999,1089,3859,563,2140,1085
1500000US130630404102,130630404102,"Block Group 2, Census Tract 404.10, Clayton County, Georgia",1317,634,495,444,822,463
1500000US130630404111,130630404111,"Block Group 1, Census Tract 404.11, Clayton County, Georgia",2912,811,2375,718,537,512
1500000US130630404112,130630404112,"Block Group 2, Census Tract 404.11, Clayton County, Georgia",2873,863,1842,750,1031,685
1500000US130630404113,130630404113,"Block Group 3, Census Tract 404.11, Clayton County, Georgia",2351,620,2283,635,68,80
1500000US130630404114,130630404114,"Block Group 4, Census Tract 404.11, Clayton County, Georgia",4860,1110,4039,1035,821,747
1500000US130630404121,130630404121,"Block Group 1, Census Tract 404.12, Clayton County, Georgia",2743,810,1608,579,1135,586
1500000US130630404122,130630404122,"Block Group 2, Census Tract 404.12, Clayton County, Georgia",3161,675,752,338,2409,655
1500000US130630404123,130630404123,"Block Group 3, Census Tract 404.12, Clayton County, Georgia",2139,606,1669,549,470,319
1500000US130630404131,130630404131,"Block Group 1, Census Tract 404.13, Clayton County, Georgia",2950,556,1772,481,1178,404
1500000US130630404132,130630404132,"Block Group 2, Census Tract 404.13, Clayton County, Georgia",4002,602,3213,654,789,414
1500000US130630404141,130630404141,"Block Group 1, Census Tract 404.14, Clayton County, Georgia",1870,310,655,170,1215,331
1500000US130630404151,130630404151,"Block Group 1, Census Tract 404.15, Clayton County, Georgia",1458,556,712,435,746,436
1500000US130630404152,130630404152,"Block Group 2, Census Tract 404.15, Clayton County, Georgia",1858,843,856,785,1002,420
1500000US130630404153,130630404153,"Block Group 3, Census Tract 404.15, Clayton County, Georgia",689,289,0,13,689,289
1500000US130630404154,130630404154,"Block Group 4, Census Tract 404.15, Clayton County, Georgia",1985,765,57,91,1928,772
1500000US130630404161,130630404161,"Block Group 1, Census Tract 404.16, Clayton County, Georgia",2180,462,1246,336,934,474
1500000US130630404162,130630404162,"Block Group 2, Census Tract 404.16, Clayton County, Georgia",1991,525,1522,519,469,288
1500000US130630404171,130630404171,"Block Group 1, Census Tract 404.17, Clayton County, Georgia",2417,590,593,219,1824,501
1500000US130630404172,130630404172,"Block Group 2, Census Tract 404.17, Clayton County, Georgia",791,319,419,206,372,247
1500000US130630404173,130630404173,"Block Group 3, Census Tract 404.17, Clayton County, Georgia",1403,338,0,13,1403,338
1500000US130630405091,130630405091,"Block Group 1, Census Tract 405.09, Clayton County, Georgia",1909,391,1310,325,599,293
1500000US130630405092,130630405092,"Block Group 2, Census Tract 405.09, Clayton County, Georgia",2795,561,1578,326,1217,487
1500000US130630405101,130630405101,"Block Group 1, Census Tract 405.10, Clayton County, Georgia",1793,391,1055,319,738,314
1500000US130630405102,130630405102,"Block Group 2, Census Tract 405.10, Clayton County, Georgia",1530,518,847,505,683,271
1500000US130630405121,130630405121,"Block Group 1, Census Tract 405.12, Clayton County, Georgia",2436,506,787,314,1649,411
1500000US130630405122,130630405122,"Block Group 2, Census Tract 405.12, Clayton County, Georgia",595,279,576,282,19,21
1500000US130630405123,130630405123,"Block Group 3, Census Tract 405.12, Clayton County, Georgia",2331,557,1264,431,1067,601
1500000US130630405131,130630405131,"Block Group 1, Census Tract 405.13, Clayton County, Georgia",1690,701,853,280,837,704
1500000US130630405132,130630405132,"Block Group 2, Census Tract 405.13, Clayton County, Georgia",985,323,855,297,130,138
1500000US130630405133,130630405133,"Block Group 3, Census Tract 405.13, Clayton County, Georgia",2098,564,1182,413,916,435
1500000US130630405141,130630405141,"Block Group 1, Census Tract 405.14, Clayton County, Georgia",1231,372,791,284,440,294
1500000US130630405142,130630405142,"Block Group 2, Census Tract 405.14, Clayton County, Georgia",1717,438,1002,429,715,450
1500000US130630405143,130630405143,"Block Group 3, Census Tract 405.14, Clayton County, Georgia",3965,624,1558,501,2407,667
1500000US130630405151,130630405151,"Block Group 1, Census Tract 405.15, Clayton County, Georgia",867,443,533,313,334,368
1500000US130630405152,130630405152,"Block Group 2, Census Tract 405.15, Clayton County, Georgia",2225,745,1757,703,468,336
1500000US130630405153,130630405153,"Block Group 3, Census Tract 405.15, Clayton County, Georgia",1670,692,807,530,863,461
1500000US130630405154,130630405154,"Block Group 4, Census Tract 405.15, Clayton County, Georgia",3010,775,994,485,2016,644
1500000US130630405161,130630405161,"Block Group 1, Census Tract 405.16, Clayton County, Georgia",3561,742,2239,656,1322,522
1500000US130630405162,130630405162,"Block Group 2, Census Tract 405.16, Clayton County, Georgia",1293,595,600,322,693,535
1500000US130630405163,130630405163,"Block Group 3, Census Tract 405.16, Clayton County, Georgia",1178,472,528,399,650,503
1500000US130630405181,130630405181,"Block Group 1, Census Tract 405.18, Clayton County, Georgia",698,246,380,144,318,252
1500000US130630405182,130630405182,"Block Group 2, Census Tract 405.18, Clayton County, Georgia",2841,460,1192,310,1649,460
1500000US130630405183,130630405183,"Block Group 3, Census Tract 405.18, Clayton County, Georgia",1580,510,692,400,888,363
1500000US130630405191,130630405191,"Block Group 1, Census Tract 405.19, Clayton County, Georgia",3414,539,129,202,3285,540
1500000US130630405192,130630405192,"Block Group 2, Census Tract 405.19, Clayton County, Georgia",785,277,0,13,785,277
1500000US130630405201,130630405201,"Block Group 1, Census Tract 405.20, Clayton County, Georgia",818,294,100,97,718,283
1500000US130630405202,130630405202,"Block Group 2, Census Tract 405.20, Clayton County, Georgia",580,207,19,34,561,205
1500000US130630405203,130630405203,"Block Group 3, Census Tract 405.20, Clayton County, Georgia",2044,389,700,248,1344,331
1500000US130630405211,130630405211,"Block Group 1, Census Tract 405.21, Clayton County, Georgia",1977,405,969,332,1008,422
1500000US130630405212,130630405212,"Block Group 2, Census Tract 405.21, Clayton County, Georgia",1371,342,885,263,486,272
1500000US130630405221,130630405221,"Block Group 1, Census Tract 405.22, Clayton County, Georgia",1824,429,502,176,1322,434
1500000US130630405222,130630405222,"Block Group 2, Census Tract 405.22, Clayton County, Georgia",1452,292,399,199,1053,298
1500000US130630405223,130630405223,"Block Group 3, Census Tract 405.22, Clayton County, Georgia",1106,323,477,206,629,351
1500000US130630405231,130630405231,"Block Group 1, Census Tract 405.23, Clayton County, Georgia",3106,447,1727,392,1379,387
1500000US130630405241,130630405241,"Block Group 1, Census Tract 405.24, Clayton County, Georgia",2086,557,916,353,1170,521
1500000US130630405242,130630405242,"Block Group 2, Census Tract 405.24, Clayton County, Georgia",1966,638,1027,539,939,380
1500000US130630405243,130630405243,"Block Group 3, Census Tract 405.24, Clayton County, Georgia",1025,387,532,301,493,323
1500000US130630405244,130630405244,"Block Group 4, Census Tract 405.24, Clayton County, Georgia",2123,687,1233,483,890,547
1500000US130630405251,130630405251,"Block Group 1, Census Tract 405.25, Clayton County, Georgia",2719,344,1682,362,1037,270
1500000US130630405261,130630405261,"Block Group 1, Census Tract 405.26, Clayton County, Georgia",2492,805,1314,686,1178,646
1500000US130630405262,130630405262,"Block Group 2, Census Tract 405.26, Clayton County, Georgia",2289,925,635,300,1654,892
1500000US130630405263,130630405263,"Block Group 3, Census Tract 405.26, Clayton County, Georgia",1565,546,603,353,962,501
1500000US130630406061,130630406061,"Block Group 1, Census Tract 406.06, Clayton County, Georgia",1666,399,1283,393,383,218
1500000US130630406062,130630406062,"Block Group 2, Census Tract 406.06, Clayton County, Georgia",1335,449,636,274,699,369
1500000US130630406081,130630406081,"Block Group 1, Census Tract 406.08, Clayton County, Georgia",8643,798,5952,922,2691,748
1500000US130630406082,130630406082,"Block Group 2, Census Tract 406.08, Clayton County, Georgia",2726,561,1959,529,767,459
1500000US130630406091,130630406091,"Block Group 1, Census Tract 406.09, Clayton County, Georgia",1631,521,1134,451,497,273
1500000US130630406092,130630406092,"Block Group 2, Census Tract 406.09, Clayton County, Georgia",2267,666,1451,493,816,470
1500000US130630406093,130630406093,"Block Group 3, Census Tract 406.09, Clayton County, Georgia",2236,516,1225,348,1011,409
1500000US130630406111,130630406111,"Block Group 1, Census Tract 406.11, Clayton County, Georgia",3422,802,958,513,2464,730
1500000US130630406112,130630406112,"Block Group 2, Census Tract 406.11, Clayton County, Georgia",762,341,233,162,529,306
1500000US130630406113,130630406113,"Block Group 3, Census Tract 406.11, Clayton County, Georgia",2025,554,551,347,1474,471
1500000US130630406121,130630406121,"Block Group 1, Census Tract 406.12, Clayton County, Georgia",940,286,388,170,552,284
1500000US130630406122,130630406122,"Block Group 2, Census Tract 406.12, Clayton County, Georgia",2979,676,807,261,2172,720
1500000US130630406123,130630406123,"Block Group 3, Census Tract 406.12, Clayton County, Georgia",1057,312,913,293,144,114
1500000US130630406131,130630406131,"Block Group 1, Census Tract 406.13, Clayton County, Georgia",2696,748,2270,722,426,241
1500000US130630406132,130630406132,"Block Group 2, Census Tract 406.13, Clayton County, Georgia",2869,879,989,399,1880,838
1500000US130630406133,130630406133,"Block Group 3, Census Tract 406.13, Clayton County, Georgia",2585,643,2491,624,94,124
1500000US130630406141,130630406141,"Block Group 1, Census Tract 406.14, Clayton County, Georgia",1207,250,812,208,395,215
1500000US130630406142,130630406142,"Block Group 2, Census Tract 406.14, Clayton County, Georgia",1943,236,1636,247,307,176
1500000US130630406143,130630406143,"Block Group 3, Census Tract 406.14, Clayton County, Georgia",1677,402,1186,297,491,311
1500000US130630406151,130630406151,"Block Group 1, Census Tract 406.15, Clayton County, Georgia",2102,276,1364,222,738,338
1500000US130630406161,130630406161,"Block Group 1, Census Tract 406.16, Clayton County, Georgia",5156,913,842,482,4314,943
1500000US130630406162,130630406162,"Block Group 2, Census Tract 406.16, Clayton County, Georgia",737,277,659,283,78,126
1500000US130630406163,130630406163,"Block Group 3, Census Tract 406.16, Clayton County, Georgia",2450,814,1551,714,899,712
1500000US130630406171,130630406171,"Block Group 1, Census Tract 406.17, Clayton County, Georgia",1694,315,1209,315,485,237
1500000US130630406191,130630406191,"Block Group 1, Census Tract 406.19, Clayton County, Georgia",3526,444,2398,374,1128,404
1500000US130630406201,130630406201,"Block Group 1, Census Tract 406.20, Clayton County, Georgia",3287,481,2763,464,524,252
1500000US130630406211,130630406211,"Block Group 1, Census Tract 406.21, Clayton County, Georgia",5776,994,4388,917,1388,801
1500000US130630406212,130630406212,"Block Group 2, Census Tract 406.21, Clayton County, Georgia",4622,847,2606,802,2016,756
1500000US130630406221,130630406221,"Block Group 1, Census Tract 406.22, Clayton County, Georgia",3455,1253,1496,461,1959,1243
1500000US130630406222,130630406222,"Block Group 2, Census Tract 406.22, Clayton County, Georgia",3382,829,1920,611,1462,698
1500000US130630406223,130630406223,"Block Group 3, Census Tract 406.22, Clayton County, Georgia",1651,716,1058,507,593,515
1500000US130639800001,130639800001,"Block Group 1, Census Tract 9800, Clayton County, Georgia",0,13,0,13,0,13
1500000US130659701001,130659701001,"Block Group 1, Census Tract 9701, Clinch County, Georgia",763,207,508,168,255,171
1500000US130659701002,130659701002,"Block Group 2, Census Tract 9701, Clinch County, Georgia",1664,297,1083,246,581,216
1500000US130659701003,130659701003,"Block Group 3, Census Tract 9701, Clinch County, Georgia",491,136,327,131,164,86
1500000US130659701004,130659701004,"Block Group 4, Census Tract 9701, Clinch County, Georgia",864,270,575,248,289,160
1500000US130659701005,130659701005,"Block Group 5, Census Tract 9701, Clinch County, Georgia",1175,282,917,229,258,151
1500000US130659702001,130659702001,"Block Group 1, Census Tract 9702, Clinch County, Georgia",653,177,552,165,101,62
1500000US130659702002,130659702002,"Block Group 2, Census Tract 9702, Clinch County, Georgia",824,150,331,105,493,138
1500000US130670301011,130670301011,"Block Group 1, Census Tract 301.01, Cobb County, Georgia",1402,381,1152,382,250,297
1500000US130670301012,130670301012,"Block Group 2, Census Tract 301.01, Cobb County, Georgia",1858,474,1203,444,655,475
1500000US130670301013,130670301013,"Block Group 3, Census Tract 301.01, Cobb County, Georgia",2656,585,1962,469,694,545
1500000US130670301014,130670301014,"Block Group 4, Census Tract 301.01, Cobb County, Georgia",1883,453,1573,418,310,254
1500000US130670301031,130670301031,"Block Group 1, Census Tract 301.03, Cobb County, Georgia",2252,841,1203,389,1049,875
1500000US130670301032,130670301032,"Block Group 2, Census Tract 301.03, Cobb County, Georgia",2769,657,2091,535,678,523
1500000US130670301033,130670301033,"Block Group 3, Census Tract 301.03, Cobb County, Georgia",4074,646,3248,644,826,493
1500000US130670301041,130670301041,"Block Group 1, Census Tract 301.04, Cobb County, Georgia",951,307,298,215,653,251
1500000US130670301042,130670301042,"Block Group 2, Census Tract 301.04, Cobb County, Georgia",2695,366,1714,387,981,362
1500000US130670301061,130670301061,"Block Group 1, Census Tract 301.06, Cobb County, Georgia",2365,667,2047,679,318,196
1500000US130670301062,130670301062,"Block Group 2, Census Tract 301.06, Cobb County, Georgia",2241,573,1907,636,334,252
1500000US130670301063,130670301063,"Block Group 3, Census Tract 301.06, Cobb County, Georgia",3234,597,931,464,2303,468
1500000US130670301071,130670301071,"Block Group 1, Census Tract 301.07, Cobb County, Georgia",1813,443,1622,469,191,188
1500000US130670301072,130670301072,"Block Group 2, Census Tract 301.07, Cobb County, Georgia",3006,369,2576,358,430,238
1500000US130670302091,130670302091,"Block Group 1, Census Tract 302.09, Cobb County, Georgia",1727,386,1607,379,120,117
1500000US130670302092,130670302092,"Block Group 2, Census Tract 302.09, Cobb County, Georgia",1980,438,1902,458,78,110
1500000US130670302093,130670302093,"Block Group 3, Census Tract 302.09, Cobb County, Georgia",2961,542,2787,516,174,233
1500000US130670302141,130670302141,"Block Group 1, Census Tract 302.14, Cobb County, Georgia",2945,470,2687,480,258,274
1500000US130670302142,130670302142,"Block Group 2, Census Tract 302.14, Cobb County, Georgia",2324,549,1619,471,705,320
1500000US130670302143,130670302143,"Block Group 3, Census Tract 302.14, Cobb County, Georgia",2921,642,2571,552,350,396
1500000US130670302151,130670302151,"Block Group 1, Census Tract 302.15, Cobb County, Georgia",2687,453,2439,459,248,204
1500000US130670302152,130670302152,"Block Group 2, Census Tract 302.15, Cobb County, Georgia",2212,841,1464,687,748,548
1500000US130670302153,130670302153,"Block Group 3, Census Tract 302.15, Cobb County, Georgia",1559,395,1036,339,523,289
1500000US130670302154,130670302154,"Block Group 4, Census Tract 302.15, Cobb County, Georgia",2968,458,2595,511,373,252
1500000US130670302181,130670302181,"Block Group 1, Census Tract 302.18, Cobb County, Georgia",2864,426,2668,396,196,202
1500000US130670302182,130670302182,"Block Group 2, Census Tract 302.18, Cobb County, Georgia",2777,493,2434,581,343,294
1500000US130670302191,130670302191,"Block Group 1, Census Tract 302.19, Cobb County, Georgia",2257,504,1988,532,269,291
1500000US130670302192,130670302192,"Block Group 2, Census Tract 302.19, Cobb County, Georgia",2357,520,2215,527,142,173
1500000US130670302193,130670302193,"Block Group 3, Census Tract 302.19, Cobb County, Georgia",2215,572,2202,573,13,21
1500000US130670302194,130670302194,"Block Group 4, Census Tract 302.19, Cobb County, Georgia",2406,654,2296,656,110,180
1500000US130670302201,130670302201,"Block Group 1, Census Tract 302.20, Cobb County, Georgia",1866,118,1418,117,448,187
1500000US130670302221,130670302221,"Block Group 1, Census Tract 302.22, Cobb County, Georgia",2660,449,2502,461,158,194
1500000US130670302222,130670302222,"Block Group 2, Census Tract 302.22, Cobb County, Georgia",2365,425,2033,442,332,184
1500000US130670302223,130670302223,"Block Group 3, Census Tract 302.22, Cobb County, Georgia",860,233,778,236,82,86
1500000US130670302231,130670302231,"Block Group 1, Census Tract 302.23, Cobb County, Georgia",3135,482,1985,453,1150,518
1500000US130670302232,130670302232,"Block Group 2, Census Tract 302.23, Cobb County, Georgia",2132,460,872,352,1260,354
1500000US130670302233,130670302233,"Block Group 3, Census Tract 302.23, Cobb County, Georgia",650,290,650,290,0,13
1500000US130670302241,130670302241,"Block Group 1, Census Tract 302.24, Cobb County, Georgia",5609,711,4276,729,1333,647
1500000US130670302242,130670302242,"Block Group 2, Census Tract 302.24, Cobb County, Georgia",1040,329,618,228,422,320
1500000US130670302261,130670302261,"Block Group 1, Census Tract 302.26, Cobb County, Georgia",4182,795,2402,694,1780,554
1500000US130670302262,130670302262,"Block Group 2, Census Tract 302.26, Cobb County, Georgia",1749,535,1339,480,410,252
1500000US130670302263,130670302263,"Block Group 3, Census Tract 302.26, Cobb County, Georgia",2959,725,2801,731,158,138
1500000US130670302271,130670302271,"Block Group 1, Census Tract 302.27, Cobb County, Georgia",2002,690,1028,525,974,591
1500000US130670302272,130670302272,"Block Group 2, Census Tract 302.27, Cobb County, Georgia",3512,779,1950,714,1562,634
1500000US130670302273,130670302273,"Block Group 3, Census Tract 302.27, Cobb County, Georgia",2367,546,1377,491,990,487
1500000US130670302281,130670302281,"Block Group 1, Census Tract 302.28, Cobb County, Georgia",2369,512,294,278,2075,434
1500000US130670302282,130670302282,"Block Group 2, Census Tract 302.28, Cobb County, Georgia",1212,413,79,80,1133,399
1500000US130670302283,130670302283,"Block Group 3, Census Tract 302.28, Cobb County, Georgia",2131,804,1681,321,450,714
1500000US130670302284,130670302284,"Block Group 4, Census Tract 302.28, Cobb County, Georgia",1377,498,333,223,1044,429
1500000US130670302291,130670302291,"Block Group 1, Census Tract 302.29, Cobb County, Georgia",171,102,43,52,128,93
1500000US130670302292,130670302292,"Block Group 2, Census Tract 302.29, Cobb County, Georgia",2514,349,1426,286,1088,309
1500000US130670302301,130670302301,"Block Group 1, Census Tract 302.30, Cobb County, Georgia",7425,1084,3749,909,3676,883
1500000US130670302302,130670302302,"Block Group 2, Census Tract 302.30, Cobb County, Georgia",5400,878,3525,802,1875,616
1500000US130670302311,130670302311,"Block Group 1, Census Tract 302.31, Cobb County, Georgia",827,316,708,281,119,153
1500000US130670302312,130670302312,"Block Group 2, Census Tract 302.31, Cobb County, Georgia",1777,397,1610,453,167,212
1500000US130670302313,130670302313,"Block Group 3, Census Tract 302.31, Cobb County, Georgia",1750,374,1622,361,128,141
1500000US130670302314,130670302314,"Block Group 4, Census Tract 302.31, Cobb County, Georgia",2838,448,2744,461,94,106
1500000US130670302321,130670302321,"Block Group 1, Census Tract 302.32, Cobb County, Georgia",2481,304,2299,321,182,129
1500000US130670302322,130670302322,"Block Group 2, Census Tract 302.32, Cobb County, Georgia",3201,402,2524,459,677,307
1500000US130670302331,130670302331,"Block Group 1, Census Tract 302.33, Cobb County, Georgia",1411,334,1123,298,288,217
1500000US130670302332,130670302332,"Block Group 2, Census Tract 302.33, Cobb County, Georgia",2830,285,2681,276,149,122
1500000US130670302341,130670302341,"Block Group 1, Census Tract 302.34, Cobb County, Georgia",3140,409,3110,420,30,50
1500000US130670302342,130670302342,"Block Group 2, Census Tract 302.34, Cobb County, Georgia",2959,400,2762,422,197,138
1500000US130670302351,130670302351,"Block Group 1, Census Tract 302.35, Cobb County, Georgia",1696,260,1647,257,49,55
1500000US130670302352,130670302352,"Block Group 2, Census Tract 302.35, Cobb County, Georgia",3184,314,2934,357,250,127
1500000US130670302361,130670302361,"Block Group 1, Census Tract 302.36, Cobb County, Georgia",2306,352,2207,364,99,125
1500000US130670302362,130670302362,"Block Group 2, Census Tract 302.36, Cobb County, Georgia",2451,458,2310,423,141,140
1500000US130670302381,130670302381,"Block Group 1, Census Tract 302.38, Cobb County, Georgia",3335,567,3335,567,0,13
1500000US130670302382,130670302382,"Block Group 2, Census Tract 302.38, Cobb County, Georgia",3376,611,2688,421,688,600
1500000US130670302391,130670302391,"Block Group 1, Census Tract 302.39, Cobb County, Georgia",1978,669,1738,656,240,250
1500000US130670302392,130670302392,"Block Group 2, Census Tract 302.39, Cobb County, Georgia",3033,590,2846,573,187,171
1500000US130670302393,130670302393,"Block Group 3, Census Tract 302.39, Cobb County, Georgia",3453,669,3421,675,32,61
1500000US130670303101,130670303101,"Block Group 1, Census Tract 303.10, Cobb County, Georgia",1495,540,783,388,712,474
1500000US130670303102,130670303102,"Block Group 2, Census Tract 303.10, Cobb County, Georgia",2526,587,1899,499,627,482
1500000US130670303103,130670303103,"Block Group 3, Census Tract 303.10, Cobb County, Georgia",687,273,687,273,0,13
1500000US130670303104,130670303104,"Block Group 4, Census Tract 303.10, Cobb County, Georgia",1998,471,1280,414,718,457
1500000US130670303105,130670303105,"Block Group 5, Census Tract 303.10, Cobb County, Georgia",1415,508,896,302,519,409
1500000US130670303111,130670303111,"Block Group 1, Census Tract 303.11, Cobb County, Georgia",1687,432,1415,352,272,314
1500000US130670303112,130670303112,"Block Group 2, Census Tract 303.11, Cobb County, Georgia",1137,295,1117,298,20,32
1500000US130670303113,130670303113,"Block Group 3, Census Tract 303.11, Cobb County, Georgia",973,211,921,218,52,56
1500000US130670303114,130670303114,"Block Group 4, Census Tract 303.11, Cobb County, Georgia",2066,388,1326,349,740,351
1500000US130670303121,130670303121,"Block Group 1, Census Tract 303.12, Cobb County, Georgia",2622,332,2390,313,232,158
1500000US130670303122,130670303122,"Block Group 2, Census Tract 303.12, Cobb County, Georgia",1380,357,1001,328,379,287
1500000US130670303123,130670303123,"Block Group 3, Census Tract 303.12, Cobb County, Georgia",1373,269,1237,280,136,153
1500000US130670303124,130670303124,"Block Group 4, Census Tract 303.12, Cobb County, Georgia",686,323,538,321,148,97
1500000US130670303131,130670303131,"Block Group 1, Census Tract 303.13, Cobb County, Georgia",1697,381,1455,415,242,255
1500000US130670303132,130670303132,"Block Group 2, Census Tract 303.13, Cobb County, Georgia",679,279,359,165,320,251
1500000US130670303133,130670303133,"Block Group 3, Census Tract 303.13, Cobb County, Georgia",1109,326,853,323,256,221
1500000US130670303134,130670303134,"Block Group 4, Census Tract 303.13, Cobb County, Georgia",1751,435,1347,439,404,274
1500000US130670303135,130670303135,"Block Group 5, Census Tract 303.13, Cobb County, Georgia",3156,706,2421,664,735,551
1500000US130670303141,130670303141,"Block Group 1, Census Tract 303.14, Cobb County, Georgia",2244,332,2159,333,85,97
1500000US130670303142,130670303142,"Block Group 2, Census Tract 303.14, Cobb County, Georgia",2243,350,2135,353,108,101
1500000US130670303143,130670303143,"Block Group 3, Census Tract 303.14, Cobb County, Georgia",3414,435,2931,397,483,349
1500000US130670303181,130670303181,"Block Group 1, Census Tract 303.18, Cobb County, Georgia",2577,432,2457,432,120,112
1500000US130670303182,130670303182,"Block Group 2, Census Tract 303.18, Cobb County, Georgia",2733,351,2647,351,86,88
1500000US130670303183,130670303183,"Block Group 3, Census Tract 303.18, Cobb County, Georgia",2677,464,2299,434,378,333
1500000US130670303191,130670303191,"Block Group 1, Census Tract 303.19, Cobb County, Georgia",1896,337,1611,328,285,168
1500000US130670303192,130670303192,"Block Group 2, Census Tract 303.19, Cobb County, Georgia",2369,346,2110,325,259,170
1500000US130670303201,130670303201,"Block Group 1, Census Tract 303.20, Cobb County, Georgia",2908,410,1478,310,1430,386
1500000US130670303202,130670303202,"Block Group 2, Census Tract 303.20, Cobb County, Georgia",2757,434,2464,464,293,266
1500000US130670303203,130670303203,"Block Group 3, Census Tract 303.20, Cobb County, Georgia",2206,365,858,211,1348,349
1500000US130670303221,130670303221,"Block Group 1, Census Tract 303.22, Cobb County, Georgia",1312,220,1076,211,236,169
1500000US130670303222,130670303222,"Block Group 2, Census Tract 303.22, Cobb County, Georgia",2101,208,1999,228,102,103
1500000US130670303241,130670303241,"Block Group 1, Census Tract 303.24, Cobb County, Georgia",1801,334,1732,341,69,94
1500000US130670303242,130670303242,"Block Group 2, Census Tract 303.24, Cobb County, Georgia",1718,393,1314,320,404,281
1500000US130670303261,130670303261,"Block Group 1, Census Tract 303.26, Cobb County, Georgia",1566,287,1529,283,37,62
1500000US130670303262,130670303262,"Block Group 2, Census Tract 303.26, Cobb County, Georgia",1978,296,1978,296,0,13
1500000US130670303263,130670303263,"Block Group 3, Census Tract 303.26, Cobb County, Georgia",1102,445,735,196,367,466
1500000US130670303271,130670303271,"Block Group 1, Census Tract 303.27, Cobb County, Georgia",3082,330,2658,350,424,215
1500000US130670303272,130670303272,"Block Group 2, Census Tract 303.27, Cobb County, Georgia",1328,251,1168,241,160,151
1500000US130670303281,130670303281,"Block Group 1, Census Tract 303.28, Cobb County, Georgia",1867,409,1634,352,233,257
1500000US130670303282,130670303282,"Block Group 2, Census Tract 303.28, Cobb County, Georgia",2539,566,2277,640,262,235
1500000US130670303283,130670303283,"Block Group 3, Census Tract 303.28, Cobb County, Georgia",2001,350,2001,350,0,13
1500000US130670303291,130670303291,"Block Group 1, Census Tract 303.29, Cobb County, Georgia",2809,293,2479,294,330,177
1500000US130670303292,130670303292,"Block Group 2, Census Tract 303.29, Cobb County, Georgia",1498,218,1442,220,56,57
1500000US130670303301,130670303301,"Block Group 1, Census Tract 303.30, Cobb County, Georgia",1756,338,1547,328,209,170
1500000US130670303302,130670303302,"Block Group 2, Census Tract 303.30, Cobb County, Georgia",2447,391,2294,396,153,126
1500000US130670303303,130670303303,"Block Group 3, Census Tract 303.30, Cobb County, Georgia",1654,278,1580,278,74,54
1500000US130670303311,130670303311,"Block Group 1, Census Tract 303.31, Cobb County, Georgia",2412,368,2193,379,219,180
1500000US130670303312,130670303312,"Block Group 2, Census Tract 303.31, Cobb County, Georgia",2250,334,2000,331,250,162
1500000US130670303313,130670303313,"Block Group 3, Census Tract 303.31, Cobb County, Georgia",1031,251,873,250,158,111
1500000US130670303321,130670303321,"Block Group 1, Census Tract 303.32, Cobb County, Georgia",1527,187,1426,205,101,70
1500000US130670303322,130670303322,"Block Group 2, Census Tract 303.32, Cobb County, Georgia",1892,255,1727,280,165,133
1500000US130670303331,130670303331,"Block Group 1, Census Tract 303.33, Cobb County, Georgia",2782,434,2490,359,292,306
1500000US130670303332,130670303332,"Block Group 2, Census Tract 303.33, Cobb County, Georgia",1857,341,1771,345,86,131
1500000US130670303333,130670303333,"Block Group 3, Census Tract 303.33, Cobb County, Georgia",1273,281,1168,292,105,118
1500000US130670303341,130670303341,"Block Group 1, Census Tract 303.34, Cobb County, Georgia",1385,298,1330,306,55,60
1500000US130670303342,130670303342,"Block Group 2, Census Tract 303.34, Cobb County, Georgia",1894,321,1495,289,399,236
1500000US130670303351,130670303351,"Block Group 1, Census Tract 303.35, Cobb County, Georgia",2471,264,2254,264,217,143
1500000US130670303352,130670303352,"Block Group 2, Census Tract 303.35, Cobb County, Georgia",2101,240,2061,242,40,61
1500000US130670303361,130670303361,"Block Group 1, Census Tract 303.36, Cobb County, Georgia",1946,384,1917,380,29,49
1500000US130670303362,130670303362,"Block Group 2, Census Tract 303.36, Cobb County, Georgia",1556,351,1338,366,218,203
1500000US130670303363,130670303363,"Block Group 3, Census Tract 303.36, Cobb County, Georgia",2336,315,2227,324,109,173
1500000US130670303364,130670303364,"Block Group 4, Census Tract 303.36, Cobb County, Georgia",1468,267,1393,277,75,89
1500000US130670303371,130670303371,"Block Group 1, Census Tract 303.37, Cobb County, Georgia",1521,284,1472,282,49,44
1500000US130670303372,130670303372,"Block Group 2, Census Tract 303.37, Cobb County, Georgia",1902,270,1708,274,194,104
1500000US130670303373,130670303373,"Block Group 3, Census Tract 303.37, Cobb County, Georgia",994,233,973,238,21,33
1500000US130670303391,130670303391,"Block Group 1, Census Tract 303.39, Cobb County, Georgia",1439,360,13,20,1426,359
1500000US130670303392,130670303392,"Block Group 2, Census Tract 303.39, Cobb County, Georgia",4423,489,754,222,3669,472
1500000US130670303401,130670303401,"Block Group 1, Census Tract 303.40, Cobb County, Georgia",1802,301,1673,270,129,197
1500000US130670303402,130670303402,"Block Group 2, Census Tract 303.40, Cobb County, Georgia",2141,286,2141,286,0,13
1500000US130670303411,130670303411,"Block Group 1, Census Tract 303.41, Cobb County, Georgia",2154,255,2007,276,147,179
1500000US130670303412,130670303412,"Block Group 2, Census Tract 303.41, Cobb County, Georgia",2283,312,1705,330,578,301
1500000US130670303421,130670303421,"Block Group 1, Census Tract 303.42, Cobb County, Georgia",1801,274,1503,234,298,230
1500000US130670303422,130670303422,"Block Group 2, Census Tract 303.42, Cobb County, Georgia",2935,281,2659,316,276,199
1500000US130670303431,130670303431,"Block Group 1, Census Tract 303.43, Cobb County, Georgia",1734,266,1630,271,104,91
1500000US130670303432,130670303432,"Block Group 2, Census Tract 303.43, Cobb County, Georgia",1722,302,1652,309,70,79
1500000US130670303433,130670303433,"Block Group 3, Census Tract 303.43, Cobb County, Georgia",1137,200,1114,209,23,32
1500000US130670303441,130670303441,"Block Group 1, Census Tract 303.44, Cobb County, Georgia",2402,362,446,161,1956,352
1500000US130670303442,130670303442,"Block Group 2, Census Tract 303.44, Cobb County, Georgia",732,213,0,13,732,213
1500000US130670303443,130670303443,"Block Group 3, Census Tract 303.44, Cobb County, Georgia",474,129,0,13,474,129
1500000US130670303451,130670303451,"Block Group 1, Census Tract 303.45, Cobb County, Georgia",2693,508,462,145,2231,529
1500000US130670303452,130670303452,"Block Group 2, Census Tract 303.45, Cobb County, Georgia",347,133,0,13,347,133
1500000US130670303453,130670303453,"Block Group 3, Census Tract 303.45, Cobb County, Georgia",1912,350,38,63,1874,344
1500000US130670304051,130670304051,"Block Group 1, Census Tract 304.05, Cobb County, Georgia",2611,496,782,230,1829,547
1500000US130670304052,130670304052,"Block Group 2, Census Tract 304.05, Cobb County, Georgia",1169,379,984,366,185,138
1500000US130670304053,130670304053,"Block Group 3, Census Tract 304.05, Cobb County, Georgia",1829,417,187,135,1642,401
1500000US130670304054,130670304054,"Block Group 4, Census Tract 304.05, Cobb County, Georgia",575,276,225,143,350,290
1500000US130670304071,130670304071,"Block Group 1, Census Tract 304.07, Cobb County, Georgia",1900,259,1786,238,114,120
1500000US130670304072,130670304072,"Block Group 2, Census Tract 304.07, Cobb County, Georgia",1451,376,859,237,592,391
1500000US130670304073,130670304073,"Block Group 3, Census Tract 304.07, Cobb County, Georgia",1491,275,925,238,566,210
1500000US130670304081,130670304081,"Block Group 1, Census Tract 304.08, Cobb County, Georgia",1557,280,645,152,912,236
1500000US130670304082,130670304082,"Block Group 2, Census Tract 304.08, Cobb County, Georgia",1577,283,1042,245,535,225
1500000US130670304091,130670304091,"Block Group 1, Census Tract 304.09, Cobb County, Georgia",2000,233,1685,232,315,167
1500000US130670304092,130670304092,"Block Group 2, Census Tract 304.09, Cobb County, Georgia",1576,233,1481,237,95,84
1500000US130670304101,130670304101,"Block Group 1, Census Tract 304.10, Cobb County, Georgia",2587,632,1376,313,1211,652
1500000US130670304102,130670304102,"Block Group 2, Census Tract 304.10, Cobb County, Georgia",2242,400,689,231,1553,359
1500000US130670304111,130670304111,"Block Group 1, Census Tract 304.11, Cobb County, Georgia",1014,387,0,13,1014,387
1500000US130670304112,130670304112,"Block Group 2, Census Tract 304.11, Cobb County, Georgia",1009,392,239,128,770,350
1500000US130670304113,130670304113,"Block Group 3, Census Tract 304.11, Cobb County, Georgia",1566,364,0,13,1566,364
1500000US130670304121,130670304121,"Block Group 1, Census Tract 304.12, Cobb County, Georgia",401,123,145,80,256,133
1500000US130670304122,130670304122,"Block Group 2, Census Tract 304.12, Cobb County, Georgia",3313,457,159,150,3154,447
1500000US130670304123,130670304123,"Block Group 3, Census Tract 304.12, Cobb County, Georgia",398,167,245,91,153,150
1500000US130670304124,130670304124,"Block Group 4, Census Tract 304.12, Cobb County, Georgia",356,226,0,13,356,226
1500000US130670304131,130670304131,"Block Group 1, Census Tract 304.13, Cobb County, Georgia",1861,714,191,129,1670,719
1500000US130670304132,130670304132,"Block Group 2, Census Tract 304.13, Cobb County, Georgia",2109,570,99,151,2010,553
1500000US130670304133,130670304133,"Block Group 3, Census Tract 304.13, Cobb County, Georgia",2073,557,340,153,1733,547
1500000US130670304141,130670304141,"Block Group 1, Census Tract 304.14, Cobb County, Georgia",2038,389,0,13,2038,389
1500000US130670304142,130670304142,"Block Group 2, Census Tract 304.14, Cobb County, Georgia",912,236,0,13,912,236
1500000US130670305021,130670305021,"Block Group 1, Census Tract 305.02, Cobb County, Georgia",3077,418,2519,395,558,364
1500000US130670305022,130670305022,"Block Group 2, Census Tract 305.02, Cobb County, Georgia",2437,453,1706,370,731,325
1500000US130670305023,130670305023,"Block Group 3, Census Tract 305.02, Cobb County, Georgia",1184,295,1071,273,113,146
1500000US130670305041,130670305041,"Block Group 1, Census Tract 305.04, Cobb County, Georgia",3454,644,3075,624,379,311
1500000US130670305042,130670305042,"Block Group 2, Census Tract 305.04, Cobb County, Georgia",1124,429,948,393,176,245
1500000US130670305043,130670305043,"Block Group 3, Census Tract 305.04, Cobb County, Georgia",1769,623,479,267,1290,741
1500000US130670305044,130670305044,"Block Group 4, Census Tract 305.04, Cobb County, Georgia",457,178,210,117,247,167
1500000US130670305051,130670305051,"Block Group 1, Census Tract 305.05, Cobb County, Georgia",1707,414,516,239,1191,402
1500000US130670305052,130670305052,"Block Group 2, Census Tract 305.05, Cobb County, Georgia",1801,454,210,101,1591,446
1500000US130670305053,130670305053,"Block Group 3, Census Tract 305.05, Cobb County, Georgia",1514,462,0,13,1514,462
1500000US130670305054,130670305054,"Block Group 4, Census Tract 305.05, Cobb County, Georgia",2037,699,844,764,1193,417
1500000US130670305061,130670305061,"Block Group 1, Census Tract 305.06, Cobb County, Georgia",2354,384,852,255,1502,404
1500000US130670305062,130670305062,"Block Group 2, Census Tract 305.06, Cobb County, Georgia",1822,422,1498,421,324,238
1500000US130670305071,130670305071,"Block Group 1, Census Tract 305.07, Cobb County, Georgia",3123,482,2177,431,946,418
1500000US130670305072,130670305072,"Block Group 2, Census Tract 305.07, Cobb County, Georgia",1899,361,1557,289,342,268
1500000US130670306011,130670306011,"Block Group 1, Census Tract 306.01, Cobb County, Georgia",3225,1168,616,398,2609,1211
1500000US130670306012,130670306012,"Block Group 2, Census Tract 306.01, Cobb County, Georgia",1345,753,786,510,559,522
1500000US130670306013,130670306013,"Block Group 3, Census Tract 306.01, Cobb County, Georgia",4539,825,1462,848,3077,620
1500000US130670306021,130670306021,"Block Group 1, Census Tract 306.02, Cobb County, Georgia",2745,417,2381,417,364,169
1500000US130670306022,130670306022,"Block Group 2, Census Tract 306.02, Cobb County, Georgia",113,64,11,18,102,60
1500000US130670306023,130670306023,"Block Group 3, Census Tract 306.02, Cobb County, Georgia",2316,512,1054,282,1262,535
1500000US130670306024,130670306024,"Block Group 4, Census Tract 306.02, Cobb County, Georgia",975,226,468,169,507,210
1500000US130670307001,130670307001,"Block Group 1, Census Tract 307, Cobb County, Georgia",1382,268,192,94,1190,265
1500000US130670307002,130670307002,"Block Group 2, Census Tract 307, Cobb County, Georgia",1004,257,717,246,287,194
1500000US130670307003,130670307003,"Block Group 3, Census Tract 307, Cobb County, Georgia",797,242,409,146,388,204
1500000US130670307004,130670307004,"Block Group 4, Census Tract 307, Cobb County, Georgia",641,194,338,178,303,156
1500000US130670308001,130670308001,"Block Group 1, Census Tract 308, Cobb County, Georgia",1187,402,154,136,1033,410
1500000US130670308002,130670308002,"Block Group 2, Census Tract 308, Cobb County, Georgia",1384,396,154,143,1230,396
1500000US130670308003,130670308003,"Block Group 3, Census Tract 308, Cobb County, Georgia",1113,293,462,143,651,284
1500000US130670309011,130670309011,"Block Group 1, Census Tract 309.01, Cobb County, Georgia",589,220,585,215,4,53
1500000US130670309012,130670309012,"Block Group 2, Census Tract 309.01, Cobb County, Georgia",1134,288,1119,288,15,24
1500000US130670309013,130670309013,"Block Group 3, Census Tract 309.01, Cobb County, Georgia",1759,952,363,150,1396,946
1500000US130670309014,130670309014,"Block Group 4, Census Tract 309.01, Cobb County, Georgia",1229,269,1190,291,39,69
1500000US130670309015,130670309015,"Block Group 5, Census Tract 309.01, Cobb County, Georgia",2742,544,1364,333,1378,480
1500000US130670309021,130670309021,"Block Group 1, Census Tract 309.02, Cobb County, Georgia",1287,510,385,204,902,524
1500000US130670309022,130670309022,"Block Group 2, Census Tract 309.02, Cobb County, Georgia",2287,404,625,272,1662,391
1500000US130670309023,130670309023,"Block Group 3, Census Tract 309.02, Cobb County, Georgia",1354,421,1107,290,247,299
1500000US130670309024,130670309024,"Block Group 4, Census Tract 309.02, Cobb County, Georgia",840,348,510,138,330,315
1500000US130670309041,130670309041,"Block Group 1, Census Tract 309.04, Cobb County, Georgia",1529,709,597,376,932,614
1500000US130670309042,130670309042,"Block Group 2, Census Tract 309.04, Cobb County, Georgia",1723,436,662,273,1061,411
1500000US130670309043,130670309043,"Block Group 3, Census Tract 309.04, Cobb County, Georgia",1679,543,354,199,1325,521
1500000US130670309044,130670309044,"Block Group 4, Census Tract 309.04, Cobb County, Georgia",1615,528,542,316,1073,484
1500000US130670309051,130670309051,"Block Group 1, Census Tract 309.05, Cobb County, Georgia",474,185,377,171,97,96
1500000US130670309052,130670309052,"Block Group 2, Census Tract 309.05, Cobb County, Georgia",833,375,514,241,319,299
1500000US130670309053,130670309053,"Block Group 3, Census Tract 309.05, Cobb County, Georgia",3511,650,2476,639,1035,416
1500000US130670309054,130670309054,"Block Group 4, Census Tract 309.05, Cobb County, Georgia",930,343,882,337,48,57
1500000US130670310011,130670310011,"Block Group 1, Census Tract 310.01, Cobb County, Georgia",1634,537,611,330,1023,462
1500000US130670310012,130670310012,"Block Group 2, Census Tract 310.01, Cobb County, Georgia",918,302,259,116,659,284
1500000US130670310013,130670310013,"Block Group 3, Census Tract 310.01, Cobb County, Georgia",2987,591,898,380,2089,528
1500000US130670310021,130670310021,"Block Group 1, Census Tract 310.02, Cobb County, Georgia",3636,805,1202,610,2434,740
1500000US130670310022,130670310022,"Block Group 2, Census Tract 310.02, Cobb County, Georgia",1848,714,124,104,1724,726
1500000US130670310023,130670310023,"Block Group 3, Census Tract 310.02, Cobb County, Georgia",1960,634,717,330,1243,620
1500000US130670310024,130670310024,"Block Group 4, Census Tract 310.02, Cobb County, Georgia",2023,586,689,359,1334,472
1500000US130670310041,130670310041,"Block Group 1, Census Tract 310.04, Cobb County, Georgia",2770,637,1380,439,1390,549
1500000US130670310042,130670310042,"Block Group 2, Census Tract 310.04, Cobb County, Georgia",1088,416,420,274,668,359
1500000US130670310043,130670310043,"Block Group 3, Census Tract 310.04, Cobb County, Georgia",2414,567,754,268,1660,644
1500000US130670310044,130670310044,"Block Group 4, Census Tract 310.04, Cobb County, Georgia",1269,387,355,192,914,361
1500000US130670310051,130670310051,"Block Group 1, Census Tract 310.05, Cobb County, Georgia",2988,531,2270,512,718,362
1500000US130670310052,130670310052,"Block Group 2, Census Tract 310.05, Cobb County, Georgia",2538,473,1950,448,588,355
1500000US130670311011,130670311011,"Block Group 1, Census Tract 311.01, Cobb County, Georgia",2148,499,694,299,1454,453
1500000US130670311012,130670311012,"Block Group 2, Census Tract 311.01, Cobb County, Georgia",1268,417,409,127,859,414
1500000US130670311013,130670311013,"Block Group 3, Census Tract 311.01, Cobb County, Georgia",1236,303,353,132,883,303
1500000US130670311061,130670311061,"Block Group 1, Census Tract 311.06, Cobb County, Georgia",1400,698,1083,663,317,341
1500000US130670311062,130670311062,"Block Group 2, Census Tract 311.06, Cobb County, Georgia",2734,773,2231,652,503,409
1500000US130670311063,130670311063,"Block Group 3, Census Tract 311.06, Cobb County, Georgia",1777,389,1585,382,192,168
1500000US130670311064,130670311064,"Block Group 4, Census Tract 311.06, Cobb County, Georgia",2923,922,1281,465,1642,799
1500000US130670311081,130670311081,"Block Group 1, Census Tract 311.08, Cobb County, Georgia",591,396,206,209,385,347
1500000US130670311082,130670311082,"Block Group 2, Census Tract 311.08, Cobb County, Georgia",539,201,470,194,69,71
1500000US130670311083,130670311083,"Block Group 3, Census Tract 311.08, Cobb County, Georgia",2725,634,658,254,2067,595
1500000US130670311084,130670311084,"Block Group 4, Census Tract 311.08, Cobb County, Georgia",1452,434,525,213,927,493
1500000US130670311101,130670311101,"Block Group 1, Census Tract 311.10, Cobb County, Georgia",2521,398,819,257,1702,476
1500000US130670311102,130670311102,"Block Group 2, Census Tract 311.10, Cobb County, Georgia",1017,197,739,190,278,171
1500000US130670311111,130670311111,"Block Group 1, Census Tract 311.11, Cobb County, Georgia",1976,268,1533,284,443,165
1500000US130670311112,130670311112,"Block Group 2, Census Tract 311.11, Cobb County, Georgia",1457,330,747,229,710,316
1500000US130670311121,130670311121,"Block Group 1, Census Tract 311.12, Cobb County, Georgia",711,215,636,221,75,68
1500000US130670311122,130670311122,"Block Group 2, Census Tract 311.12, Cobb County, Georgia",1930,436,649,244,1281,400
1500000US130670311123,130670311123,"Block Group 3, Census Tract 311.12, Cobb County, Georgia",2662,440,2541,475,121,141
1500000US130670311131,130670311131,"Block Group 1, Census Tract 311.13, Cobb County, Georgia",942,164,45,33,897,162
1500000US130670311141,130670311141,"Block Group 1, Census Tract 311.14, Cobb County, Georgia",3471,799,860,342,2611,775
1500000US130670311142,130670311142,"Block Group 2, Census Tract 311.14, Cobb County, Georgia",1893,427,104,77,1789,424
1500000US130670311143,130670311143,"Block Group 3, Census Tract 311.14, Cobb County, Georgia",1560,341,424,207,1136,303
1500000US130670311144,130670311144,"Block Group 4, Census Tract 311.14, Cobb County, Georgia",529,321,0,13,529,321
1500000US130670311151,130670311151,"Block Group 1, Census Tract 311.15, Cobb County, Georgia",2238,534,516,202,1722,528
1500000US130670311152,130670311152,"Block Group 2, Census Tract 311.15, Cobb County, Georgia",2721,505,1742,403,979,540
1500000US130670311161,130670311161,"Block Group 1, Census Tract 311.16, Cobb County, Georgia",2319,757,845,558,1474,600
1500000US130670311162,130670311162,"Block Group 2, Census Tract 311.16, Cobb County, Georgia",1681,498,1372,530,309,321
1500000US130670311163,130670311163,"Block Group 3, Census Tract 311.16, Cobb County, Georgia",169,149,0,13,169,149
1500000US130670311171,130670311171,"Block Group 1, Census Tract 311.17, Cobb County, Georgia",2685,490,1871,369,814,396
1500000US130670311172,130670311172,"Block Group 2, Census Tract 311.17, Cobb County, Georgia",1763,260,1667,266,96,79
1500000US130670311173,130670311173,"Block Group 3, Census Tract 311.17, Cobb County, Georgia",844,237,671,194,173,153
1500000US130670311181,130670311181,"Block Group 1, Census Tract 311.18, Cobb County, Georgia",1471,603,1106,521,365,332
1500000US130670311182,130670311182,"Block Group 2, Census Tract 311.18, Cobb County, Georgia",2089,522,1790,512,299,223
1500000US130670311183,130670311183,"Block Group 3, Census Tract 311.18, Cobb County, Georgia",2040,374,1067,343,973,320
1500000US130670312051,130670312051,"Block Group 1, Census Tract 312.05, Cobb County, Georgia",1450,467,677,306,773,371
1500000US130670312052,130670312052,"Block Group 2, Census Tract 312.05, Cobb County, Georgia",2256,581,1227,279,1029,588
1500000US130670312053,130670312053,"Block Group 3, Census Tract 312.05, Cobb County, Georgia",2103,600,833,334,1270,554
1500000US130670312061,130670312061,"Block Group 1, Census Tract 312.06, Cobb County, Georgia",5457,821,3563,819,1894,880
1500000US130670312062,130670312062,"Block Group 2, Census Tract 312.06, Cobb County, Georgia",602,499,0,13,602,499
1500000US130670312063,130670312063,"Block Group 3, Census Tract 312.06, Cobb County, Georgia",3971,811,1360,438,2611,755
1500000US130670312071,130670312071,"Block Group 1, Census Tract 312.07, Cobb County, Georgia",1033,383,428,179,605,320
1500000US130670312072,130670312072,"Block Group 2, Census Tract 312.07, Cobb County, Georgia",2058,492,209,164,1849,466
1500000US130670312073,130670312073,"Block Group 3, Census Tract 312.07, Cobb County, Georgia",877,299,298,162,579,302
1500000US130670312081,130670312081,"Block Group 1, Census Tract 312.08, Cobb County, Georgia",556,158,239,121,317,137
1500000US130670312082,130670312082,"Block Group 2, Census Tract 312.08, Cobb County, Georgia",1953,415,393,206,1560,395
1500000US130670312083,130670312083,"Block Group 3, Census Tract 312.08, Cobb County, Georgia",3833,548,609,203,3224,606
1500000US130670312091,130670312091,"Block Group 1, Census Tract 312.09, Cobb County, Georgia",2794,275,2502,310,292,167
1500000US130670312092,130670312092,"Block Group 2, Census Tract 312.09, Cobb County, Georgia",1378,267,1264,255,114,111
1500000US130670312111,130670312111,"Block Group 1, Census Tract 312.11, Cobb County, Georgia",360,204,0,13,360,204
1500000US130670312112,130670312112,"Block Group 2, Census Tract 312.11, Cobb County, Georgia",3065,591,517,254,2548,570
1500000US130670312113,130670312113,"Block Group 3, Census Tract 312.11, Cobb County, Georgia",525,318,0,13,525,318
1500000US130670312121,130670312121,"Block Group 1, Census Tract 312.12, Cobb County, Georgia",2476,296,2373,306,103,87
1500000US130670313061,130670313061,"Block Group 1, Census Tract 313.06, Cobb County, Georgia",2480,459,1409,439,1071,454
1500000US130670313062,130670313062,"Block Group 2, Census Tract 313.06, Cobb County, Georgia",1495,414,1232,419,263,114
1500000US130670313071,130670313071,"Block Group 1, Census Tract 313.07, Cobb County, Georgia",925,305,811,274,114,114
1500000US130670313072,130670313072,"Block Group 2, Census Tract 313.07, Cobb County, Georgia",2368,438,1504,330,864,470
1500000US130670313073,130670313073,"Block Group 3, Census Tract 313.07, Cobb County, Georgia",2311,561,1640,451,671,411
1500000US130670313081,130670313081,"Block Group 1, Census Tract 313.08, Cobb County, Georgia",917,273,459,190,458,257
1500000US130670313082,130670313082,"Block Group 2, Census Tract 313.08, Cobb County, Georgia",2190,615,848,465,1342,497
1500000US130670313083,130670313083,"Block Group 3, Census Tract 313.08, Cobb County, Georgia",2394,493,1299,415,1095,445
1500000US130670313091,130670313091,"Block Group 1, Census Tract 313.09, Cobb County, Georgia",1510,602,1025,418,485,674
1500000US130670313092,130670313092,"Block Group 2, Census Tract 313.09, Cobb County, Georgia",1859,598,1544,650,315,238
1500000US130670313093,130670313093,"Block Group 3, Census Tract 313.09, Cobb County, Georgia",2941,678,2258,607,683,490
1500000US130670313094,130670313094,"Block Group 4, Census Tract 313.09, Cobb County, Georgia",2025,479,1751,421,274,224
1500000US130670313101,130670313101,"Block Group 1, Census Tract 313.10, Cobb County, Georgia",1687,371,388,250,1299,354
1500000US130670313102,130670313102,"Block Group 2, Census Tract 313.10, Cobb County, Georgia",3504,589,1274,508,2230,612
1500000US130670313103,130670313103,"Block Group 3, Census Tract 313.10, Cobb County, Georgia",2440,608,258,224,2182,603
1500000US130670313111,130670313111,"Block Group 1, Census Tract 313.11, Cobb County, Georgia",3783,629,1558,337,2225,616
1500000US130670313112,130670313112,"Block Group 2, Census Tract 313.11, Cobb County, Georgia",2728,640,1147,348,1581,575
1500000US130670313113,130670313113,"Block Group 3, Census Tract 313.11, Cobb County, Georgia",2887,515,943,322,1944,560
1500000US130670313121,130670313121,"Block Group 1, Census Tract 313.12, Cobb County, Georgia",1343,670,602,380,741,599
1500000US130670313122,130670313122,"Block Group 2, Census Tract 313.12, Cobb County, Georgia",557,256,445,221,112,150
1500000US130670313123,130670313123,"Block Group 3, Census Tract 313.12, Cobb County, Georgia",4775,796,3997,803,778,461
1500000US130670313124,130670313124,"Block Group 4, Census Tract 313.12, Cobb County, Georgia",2872,628,2224,656,648,612
1500000US130670313131,130670313131,"Block Group 1, Census Tract 313.13, Cobb County, Georgia",7154,796,5795,718,1359,595
1500000US130670313132,130670313132,"Block Group 2, Census Tract 313.13, Cobb County, Georgia",3171,612,2575,629,596,376
1500000US130670314041,130670314041,"Block Group 1, Census Tract 314.04, Cobb County, Georgia",1000,414,1000,414,0,13
1500000US130670314042,130670314042,"Block Group 2, Census Tract 314.04, Cobb County, Georgia",2996,554,2098,467,898,457
1500000US130670314043,130670314043,"Block Group 3, Census Tract 314.04, Cobb County, Georgia",1281,421,998,342,283,313
1500000US130670314044,130670314044,"Block Group 4, Census Tract 314.04, Cobb County, Georgia",458,235,296,143,162,175
1500000US130670314051,130670314051,"Block Group 1, Census Tract 314.05, Cobb County, Georgia",1690,666,1095,507,595,433
1500000US130670314052,130670314052,"Block Group 2, Census Tract 314.05, Cobb County, Georgia",2892,592,2440,548,452,306
1500000US130670314053,130670314053,"Block Group 3, Census Tract 314.05, Cobb County, Georgia",1181,508,656,337,525,410
1500000US130670314054,130670314054,"Block Group 4, Census Tract 314.05, Cobb County, Georgia",1504,466,1052,479,452,460
1500000US130670314055,130670314055,"Block Group 5, Census Tract 314.05, Cobb County, Georgia",1093,446,420,334,673,459
1500000US130670314061,130670314061,"Block Group 1, Census Tract 314.06, Cobb County, Georgia",1025,395,274,150,751,363
1500000US130670314062,130670314062,"Block Group 2, Census Tract 314.06, Cobb County, Georgia",2725,670,772,460,1953,617
1500000US130670314063,130670314063,"Block Group 3, Census Tract 314.06, Cobb County, Georgia",3415,716,1062,325,2353,745
1500000US130670314081,130670314081,"Block Group 1, Census Tract 314.08, Cobb County, Georgia",838,498,373,218,465,493
1500000US130670314082,130670314082,"Block Group 2, Census Tract 314.08, Cobb County, Georgia",3634,564,2558,519,1076,512
1500000US130670314083,130670314083,"Block Group 3, Census Tract 314.08, Cobb County, Georgia",1156,310,545,283,611,305
1500000US130670314091,130670314091,"Block Group 1, Census Tract 314.09, Cobb County, Georgia",2805,425,1984,402,821,397
1500000US130670314092,130670314092,"Block Group 2, Census Tract 314.09, Cobb County, Georgia",2175,422,1296,336,879,361
1500000US130670315031,130670315031,"Block Group 1, Census Tract 315.03, Cobb County, Georgia",1408,511,1158,447,250,269
1500000US130670315032,130670315032,"Block Group 2, Census Tract 315.03, Cobb County, Georgia",3049,778,2459,812,590,461
1500000US130670315033,130670315033,"Block Group 3, Census Tract 315.03, Cobb County, Georgia",3445,996,2258,644,1187,811
1500000US130670315034,130670315034,"Block Group 4, Census Tract 315.03, Cobb County, Georgia",2159,810,1786,827,373,260
1500000US130670315051,130670315051,"Block Group 1, Census Tract 315.05, Cobb County, Georgia",2435,535,1111,442,1324,568
1500000US130670315052,130670315052,"Block Group 2, Census Tract 315.05, Cobb County, Georgia",1647,409,1240,398,407,278
1500000US130670315053,130670315053,"Block Group 3, Census Tract 315.05, Cobb County, Georgia",1853,465,1628,441,225,195
1500000US130670315061,130670315061,"Block Group 1, Census Tract 315.06, Cobb County, Georgia",2092,452,1669,437,423,309
1500000US130670315062,130670315062,"Block Group 2, Census Tract 315.06, Cobb County, Georgia",1885,379,1454,384,431,252
1500000US130670315063,130670315063,"Block Group 3, Census Tract 315.06, Cobb County, Georgia",627,178,381,115,246,170
1500000US130670315071,130670315071,"Block Group 1, Census Tract 315.07, Cobb County, Georgia",2251,543,1728,583,523,271
1500000US130670315072,130670315072,"Block Group 2, Census Tract 315.07, Cobb County, Georgia",1274,494,809,313,465,434
1500000US130670315081,130670315081,"Block Group 1, Census Tract 315.08, Cobb County, Georgia",1651,422,1087,263,564,443
1500000US130670315082,130670315082,"Block Group 2, Census Tract 315.08, Cobb County, Georgia",3422,730,3072,744,350,210
1500000US130670315091,130670315091,"Block Group 1, Census Tract 315.09, Cobb County, Georgia",2360,630,2203,633,157,197
1500000US130670315092,130670315092,"Block Group 2, Census Tract 315.09, Cobb County, Georgia",1958,618,1755,684,203,263
1500000US130670315093,130670315093,"Block Group 3, Census Tract 315.09, Cobb County, Georgia",1698,478,1183,350,515,457
1500000US130670315094,130670315094,"Block Group 4, Census Tract 315.09, Cobb County, Georgia",2097,616,1634,519,463,303
1500000US130670315095,130670315095,"Block Group 5, Census Tract 315.09, Cobb County, Georgia",2018,495,1965,502,53,87
1500000US130690101001,130690101001,"Block Group 1, Census Tract 101, Coffee County, Georgia",811,243,545,197,266,162
1500000US130690101002,130690101002,"Block Group 2, Census Tract 101, Coffee County, Georgia",708,185,565,187,143,83
1500000US130690101003,130690101003,"Block Group 3, Census Tract 101, Coffee County, Georgia",1917,312,1520,297,397,190
1500000US130690102001,130690102001,"Block Group 1, Census Tract 102, Coffee County, Georgia",1884,468,1825,478,59,67
1500000US130690102002,130690102002,"Block Group 2, Census Tract 102, Coffee County, Georgia",1033,288,929,289,104,83
1500000US130690103001,130690103001,"Block Group 1, Census Tract 103, Coffee County, Georgia",1624,373,1266,336,358,185
1500000US130690103002,130690103002,"Block Group 2, Census Tract 103, Coffee County, Georgia",1420,325,1033,256,387,184
1500000US130690104001,130690104001,"Block Group 1, Census Tract 104, Coffee County, Georgia",2172,577,1098,353,1074,531
1500000US130690104002,130690104002,"Block Group 2, Census Tract 104, Coffee County, Georgia",386,247,226,164,160,184
1500000US130690104003,130690104003,"Block Group 3, Census Tract 104, Coffee County, Georgia",706,253,588,266,118,102
1500000US130690104004,130690104004,"Block Group 4, Census Tract 104, Coffee County, Georgia",1134,386,573,287,561,287
1500000US130690105001,130690105001,"Block Group 1, Census Tract 105, Coffee County, Georgia",731,344,441,161,290,312
1500000US130690105002,130690105002,"Block Group 2, Census Tract 105, Coffee County, Georgia",691,251,292,209,399,180
1500000US130690105003,130690105003,"Block Group 3, Census Tract 105, Coffee County, Georgia",1889,582,897,238,992,581
1500000US130690106001,130690106001,"Block Group 1, Census Tract 106, Coffee County, Georgia",2806,591,2632,576,174,179
1500000US130690106002,130690106002,"Block Group 2, Census Tract 106, Coffee County, Georgia",1371,577,887,483,484,404
1500000US130690106003,130690106003,"Block Group 3, Census Tract 106, Coffee County, Georgia",1474,397,1304,390,170,139
1500000US130690107001,130690107001,"Block Group 1, Census Tract 107, Coffee County, Georgia",1431,472,1123,478,308,197
1500000US130690107002,130690107002,"Block Group 2, Census Tract 107, Coffee County, Georgia",811,371,511,254,300,296
1500000US130690107003,130690107003,"Block Group 3, Census Tract 107, Coffee County, Georgia",750,282,175,175,575,301
1500000US130690107004,130690107004,"Block Group 4, Census Tract 107, Coffee County, Georgia",3138,535,1614,572,1524,528
1500000US130690108011,130690108011,"Block Group 1, Census Tract 108.01, Coffee County, Georgia",2158,359,1849,387,309,205
1500000US130690108012,130690108012,"Block Group 2, Census Tract 108.01, Coffee County, Georgia",2695,631,1790,626,905,385
1500000US130690108013,130690108013,"Block Group 3, Census Tract 108.01, Coffee County, Georgia",827,327,187,138,640,302
1500000US130690108021,130690108021,"Block Group 1, Census Tract 108.02, Coffee County, Georgia",1004,338,682,263,322,230
1500000US130690108022,130690108022,"Block Group 2, Census Tract 108.02, Coffee County, Georgia",1980,378,735,242,1245,384
1500000US130690108023,130690108023,"Block Group 3, Census Tract 108.02, Coffee County, Georgia",1515,459,744,475,771,429
1500000US130719701001,130719701001,"Block Group 1, Census Tract 9701, Colquitt County, Georgia",2317,522,1807,498,510,235
1500000US130719701002,130719701002,"Block Group 2, Census Tract 9701, Colquitt County, Georgia",2955,493,1883,376,1072,370
1500000US130719702001,130719702001,"Block Group 1, Census Tract 9702, Colquitt County, Georgia",1554,345,984,289,570,222
1500000US130719702002,130719702002,"Block Group 2, Census Tract 9702, Colquitt County, Georgia",1366,280,1088,284,278,142
1500000US130719703001,130719703001,"Block Group 1, Census Tract 9703, Colquitt County, Georgia",1294,409,1016,451,278,254
1500000US130719703002,130719703002,"Block Group 2, Census Tract 9703, Colquitt County, Georgia",1406,540,770,329,636,484
1500000US130719703003,130719703003,"Block Group 3, Census Tract 9703, Colquitt County, Georgia",819,360,66,72,753,355
1500000US130719703004,130719703004,"Block Group 4, Census Tract 9703, Colquitt County, Georgia",521,342,103,71,418,340
1500000US130719703005,130719703005,"Block Group 5, Census Tract 9703, Colquitt County, Georgia",1095,422,454,237,641,398
1500000US130719704001,130719704001,"Block Group 1, Census Tract 9704, Colquitt County, Georgia",1313,359,855,307,458,255
1500000US130719704002,130719704002,"Block Group 2, Census Tract 9704, Colquitt County, Georgia",1059,308,648,304,411,226
1500000US130719704003,130719704003,"Block Group 3, Census Tract 9704, Colquitt County, Georgia",743,289,285,139,458,288
1500000US130719705001,130719705001,"Block Group 1, Census Tract 9705, Colquitt County, Georgia",1524,345,1282,328,242,210
1500000US130719705002,130719705002,"Block Group 2, Census Tract 9705, Colquitt County, Georgia",1651,345,1366,308,285,137
1500000US130719706001,130719706001,"Block Group 1, Census Tract 9706, Colquitt County, Georgia",2115,606,1952,635,163,120
1500000US130719706002,130719706002,"Block Group 2, Census Tract 9706, Colquitt County, Georgia",2078,539,1747,481,331,229
1500000US130719706003,130719706003,"Block Group 3, Census Tract 9706, Colquitt County, Georgia",2252,337,2030,331,222,226
1500000US130719707011,130719707011,"Block Group 1, Census Tract 9707.01, Colquitt County, Georgia",1252,378,596,293,656,302
1500000US130719707012,130719707012,"Block Group 2, Census Tract 9707.01, Colquitt County, Georgia",1338,511,911,465,427,335
1500000US130719707013,130719707013,"Block Group 3, Census Tract 9707.01, Colquitt County, Georgia",3028,710,1843,733,1185,443
1500000US130719707014,130719707014,"Block Group 4, Census Tract 9707.01, Colquitt County, Georgia",1121,388,158,153,963,357
1500000US130719707021,130719707021,"Block Group 1, Census Tract 9707.02, Colquitt County, Georgia",2282,366,860,356,1422,308
1500000US130719708001,130719708001,"Block Group 1, Census Tract 9708, Colquitt County, Georgia",1650,398,1023,379,627,380
1500000US130719708002,130719708002,"Block Group 2, Census Tract 9708, Colquitt County, Georgia",763,234,412,185,351,229
1500000US130719708003,130719708003,"Block Group 3, Census Tract 9708, Colquitt County, Georgia",475,313,77,72,398,327
1500000US130719708004,130719708004,"Block Group 4, Census Tract 9708, Colquitt County, Georgia",368,119,168,98,200,99
1500000US130719709001,130719709001,"Block Group 1, Census Tract 9709, Colquitt County, Georgia",1962,654,1353,434,609,452
1500000US130719709002,130719709002,"Block Group 2, Census Tract 9709, Colquitt County, Georgia",1177,472,1119,482,58,66
1500000US130719709003,130719709003,"Block Group 3, Census Tract 9709, Colquitt County, Georgia",2146,535,1339,386,807,541
1500000US130719709004,130719709004,"Block Group 4, Census Tract 9709, Colquitt County, Georgia",1387,379,1198,418,189,131
1500000US130730301021,130730301021,"Block Group 1, Census Tract 301.02, Columbia County, Georgia",965,340,965,340,0,13
1500000US130730301022,130730301022,"Block Group 2, Census Tract 301.02, Columbia County, Georgia",2139,368,1951,358,188,121
1500000US130730301023,130730301023,"Block Group 3, Census Tract 301.02, Columbia County, Georgia",2195,394,2059,397,136,135
1500000US130730301024,130730301024,"Block Group 4, Census Tract 301.02, Columbia County, Georgia",2591,511,2591,511,0,13
1500000US130730301025,130730301025,"Block Group 5, Census Tract 301.02, Columbia County, Georgia",2036,464,1572,412,464,425
1500000US130730301031,130730301031,"Block Group 1, Census Tract 301.03, Columbia County, Georgia",3362,318,2765,339,597,211
1500000US130730301051,130730301051,"Block Group 1, Census Tract 301.05, Columbia County, Georgia",1554,502,1225,446,329,276
1500000US130730301052,130730301052,"Block Group 2, Census Tract 301.05, Columbia County, Georgia",3243,569,1996,500,1247,636
1500000US130730301053,130730301053,"Block Group 3, Census Tract 301.05, Columbia County, Georgia",727,250,602,234,125,133
1500000US130730301061,130730301061,"Block Group 1, Census Tract 301.06, Columbia County, Georgia",2572,485,1724,426,848,356
1500000US130730301062,130730301062,"Block Group 2, Census Tract 301.06, Columbia County, Georgia",1270,333,862,311,408,213
1500000US130730302011,130730302011,"Block Group 1, Census Tract 302.01, Columbia County, Georgia",2202,618,1632,458,570,374
1500000US130730302012,130730302012,"Block Group 2, Census Tract 302.01, Columbia County, Georgia",3312,749,2889,703,423,337
1500000US130730302013,130730302013,"Block Group 3, Census Tract 302.01, Columbia County, Georgia",615,173,359,171,256,99
1500000US130730302021,130730302021,"Block Group 1, Census Tract 302.02, Columbia County, Georgia",3245,366,2138,313,1107,358
1500000US130730302031,130730302031,"Block Group 1, Census Tract 302.03, Columbia County, Georgia",1456,357,1415,359,41,69
1500000US130730302032,130730302032,"Block Group 2, Census Tract 302.03, Columbia County, Georgia",1417,425,1208,400,209,170
1500000US130730302033,130730302033,"Block Group 3, Census Tract 302.03, Columbia County, Georgia",778,296,45,59,733,290
1500000US130730302034,130730302034,"Block Group 4, Census Tract 302.03, Columbia County, Georgia",2665,426,2183,398,482,332
1500000US130730303021,130730303021,"Block Group 1, Census Tract 303.02, Columbia County, Georgia",1299,305,1093,322,206,134
1500000US130730303022,130730303022,"Block Group 2, Census Tract 303.02, Columbia County, Georgia",3518,614,2829,475,689,444
1500000US130730303023,130730303023,"Block Group 3, Census Tract 303.02, Columbia County, Georgia",941,244,896,243,45,56
1500000US130730303024,130730303024,"Block Group 4, Census Tract 303.02, Columbia County, Georgia",1758,328,1758,328,0,13
1500000US130730303025,130730303025,"Block Group 5, Census Tract 303.02, Columbia County, Georgia",3007,615,2346,553,661,408
1500000US130730303041,130730303041,"Block Group 1, Census Tract 303.04, Columbia County, Georgia",1724,406,1374,436,350,278
1500000US130730303042,130730303042,"Block Group 2, Census Tract 303.04, Columbia County, Georgia",5469,623,4712,566,757,430
1500000US130730303061,130730303061,"Block Group 1, Census Tract 303.06, Columbia County, Georgia",3610,447,3107,482,503,237
1500000US130730303062,130730303062,"Block Group 2, Census Tract 303.06, Columbia County, Georgia",1977,716,1382,615,595,412
1500000US130730303071,130730303071,"Block Group 1, Census Tract 303.07, Columbia County, Georgia",1432,299,1263,296,169,163
1500000US130730303072,130730303072,"Block Group 2, Census Tract 303.07, Columbia County, Georgia",1556,393,1524,397,32,50
1500000US130730303073,130730303073,"Block Group 3, Census Tract 303.07, Columbia County, Georgia",2619,709,2591,706,28,44
1500000US130730303074,130730303074,"Block Group 4, Census Tract 303.07, Columbia County, Georgia",1316,323,568,205,748,319
1500000US130730303081,130730303081,"Block Group 1, Census Tract 303.08, Columbia County, Georgia",3320,542,3071,635,249,277
1500000US130730303082,130730303082,"Block Group 2, Census Tract 303.08, Columbia County, Georgia",6402,666,5128,765,1274,417
1500000US130730303091,130730303091,"Block Group 1, Census Tract 303.09, Columbia County, Georgia",4409,622,3330,678,1079,608
1500000US130730303092,130730303092,"Block Group 2, Census Tract 303.09, Columbia County, Georgia",1740,594,1177,359,563,518
1500000US130730303093,130730303093,"Block Group 3, Census Tract 303.09, Columbia County, Georgia",2061,677,1065,579,996,394
1500000US130730303094,130730303094,"Block Group 4, Census Tract 303.09, Columbia County, Georgia",2780,528,2606,546,174,147
1500000US130730304011,130730304011,"Block Group 1, Census Tract 304.01, Columbia County, Georgia",1267,220,941,211,326,185
1500000US130730304012,130730304012,"Block Group 2, Census Tract 304.01, Columbia County, Georgia",934,300,895,286,39,54
1500000US130730304021,130730304021,"Block Group 1, Census Tract 304.02, Columbia County, Georgia",1935,605,1810,602,125,114
1500000US130730304022,130730304022,"Block Group 2, Census Tract 304.02, Columbia County, Georgia",5668,854,4045,750,1623,629
1500000US130730304023,130730304023,"Block Group 3, Census Tract 304.02, Columbia County, Georgia",2060,434,1614,378,446,269
1500000US130730305031,130730305031,"Block Group 1, Census Tract 305.03, Columbia County, Georgia",2541,677,2009,564,532,404
1500000US130730305032,130730305032,"Block Group 2, Census Tract 305.03, Columbia County, Georgia",2419,581,1420,330,999,515
1500000US130730305033,130730305033,"Block Group 3, Census Tract 305.03, Columbia County, Georgia",2805,629,2516,598,289,335
1500000US130730305041,130730305041,"Block Group 1, Census Tract 305.04, Columbia County, Georgia",2141,289,1648,321,493,172
1500000US130730305042,130730305042,"Block Group 2, Census Tract 305.04, Columbia County, Georgia",1184,279,1113,281,71,65
1500000US130730305051,130730305051,"Block Group 1, Census Tract 305.05, Columbia County, Georgia",6922,881,4771,783,2151,680
1500000US130730305061,130730305061,"Block Group 1, Census Tract 305.06, Columbia County, Georgia",4864,1067,4332,982,532,436
1500000US130730305062,130730305062,"Block Group 2, Census Tract 305.06, Columbia County, Georgia",975,476,395,245,580,458
1500000US130730305063,130730305063,"Block Group 3, Census Tract 305.06, Columbia County, Georgia",2516,675,1437,575,1079,565
1500000US130730305064,130730305064,"Block Group 4, Census Tract 305.06, Columbia County, Georgia",3166,1006,2299,1142,867,681
1500000US130730306031,130730306031,"Block Group 1, Census Tract 306.03, Columbia County, Georgia",2791,504,1844,512,947,443
1500000US130730306032,130730306032,"Block Group 2, Census Tract 306.03, Columbia County, Georgia",2219,476,688,232,1531,480
1500000US130759601001,130759601001,"Block Group 1, Census Tract 9601, Cook County, Georgia",1359,188,953,143,406,152
1500000US130759601002,130759601002,"Block Group 2, Census Tract 9601, Cook County, Georgia",776,161,694,152,82,56
1500000US130759602001,130759602001,"Block Group 1, Census Tract 9602, Cook County, Georgia",538,151,374,107,164,121
1500000US130759602002,130759602002,"Block Group 2, Census Tract 9602, Cook County, Georgia",1137,266,742,215,395,217
1500000US130759602003,130759602003,"Block Group 3, Census Tract 9602, Cook County, Georgia",865,205,518,149,347,181
1500000US130759602004,130759602004,"Block Group 4, Census Tract 9602, Cook County, Georgia",730,250,250,110,480,238
1500000US130759602005,130759602005,"Block Group 5, Census Tract 9602, Cook County, Georgia",601,218,235,120,366,201
1500000US130759603001,130759603001,"Block Group 1, Census Tract 9603, Cook County, Georgia",1633,377,1063,353,570,262
1500000US130759603002,130759603002,"Block Group 2, Census Tract 9603, Cook County, Georgia",1317,297,1203,298,114,114
1500000US130759603003,130759603003,"Block Group 3, Census Tract 9603, Cook County, Georgia",1435,295,1054,242,381,221
1500000US130759603004,130759603004,"Block Group 4, Census Tract 9603, Cook County, Georgia",764,255,459,213,305,239
1500000US130759603005,130759603005,"Block Group 5, Census Tract 9603, Cook County, Georgia",775,228,411,171,364,204
1500000US130759604001,130759604001,"Block Group 1, Census Tract 9604, Cook County, Georgia",2415,400,1588,341,827,331
1500000US130759604002,130759604002,"Block Group 2, Census Tract 9604, Cook County, Georgia",1748,243,1160,229,588,266
1500000US130759604003,130759604003,"Block Group 3, Census Tract 9604, Cook County, Georgia",775,242,364,175,411,194
1500000US130771701001,130771701001,"Block Group 1, Census Tract 1701, Coweta County, Georgia",2152,556,1523,363,629,452
1500000US130771701002,130771701002,"Block Group 2, Census Tract 1701, Coweta County, Georgia",3769,686,2738,538,1031,505
1500000US130771701003,130771701003,"Block Group 3, Census Tract 1701, Coweta County, Georgia",1695,509,1504,490,191,206
1500000US130771702001,130771702001,"Block Group 1, Census Tract 1702, Coweta County, Georgia",3404,641,2560,633,844,543
1500000US130771702002,130771702002,"Block Group 2, Census Tract 1702, Coweta County, Georgia",1389,580,917,521,472,318
1500000US130771702003,130771702003,"Block Group 3, Census Tract 1702, Coweta County, Georgia",685,217,318,137,367,226
1500000US130771702004,130771702004,"Block Group 4, Census Tract 1702, Coweta County, Georgia",1483,452,1020,365,463,303
1500000US130771703031,130771703031,"Block Group 1, Census Tract 1703.03, Coweta County, Georgia",5214,322,4965,315,249,144
1500000US130771703041,130771703041,"Block Group 1, Census Tract 1703.04, Coweta County, Georgia",1248,401,961,293,287,379
1500000US130771703042,130771703042,"Block Group 2, Census Tract 1703.04, Coweta County, Georgia",3378,525,2002,421,1376,536
1500000US130771703043,130771703043,"Block Group 3, Census Tract 1703.04, Coweta County, Georgia",2056,480,1491,429,565,386
1500000US130771703051,130771703051,"Block Group 1, Census Tract 1703.05, Coweta County, Georgia",2920,807,991,402,1929,743
1500000US130771703052,130771703052,"Block Group 2, Census Tract 1703.05, Coweta County, Georgia",5466,788,984,498,4482,799
1500000US130771703053,130771703053,"Block Group 3, Census Tract 1703.05, Coweta County, Georgia",1878,843,1515,867,363,229
1500000US130771703061,130771703061,"Block Group 1, Census Tract 1703.06, Coweta County, Georgia",578,216,534,212,44,58
1500000US130771703062,130771703062,"Block Group 2, Census Tract 1703.06, Coweta County, Georgia",3631,616,2552,489,1079,505
1500000US130771703063,130771703063,"Block Group 3, Census Tract 1703.06, Coweta County, Georgia",3968,671,1938,468,2030,673
1500000US130771704021,130771704021,"Block Group 1, Census Tract 1704.02, Coweta County, Georgia",1623,525,951,620,672,375
1500000US130771704022,130771704022,"Block Group 2, Census Tract 1704.02, Coweta County, Georgia",4600,613,3982,583,618,374
1500000US130771704023,130771704023,"Block Group 3, Census Tract 1704.02, Coweta County, Georgia",3554,612,2918,600,636,374
1500000US130771704031,130771704031,"Block Group 1, Census Tract 1704.03, Coweta County, Georgia",1065,248,976,251,89,90
1500000US130771704032,130771704032,"Block Group 2, Census Tract 1704.03, Coweta County, Georgia",3407,376,3011,381,396,262
1500000US130771704041,130771704041,"Block Group 1, Census Tract 1704.04, Coweta County, Georgia",2130,458,2054,481,76,97
1500000US130771704042,130771704042,"Block Group 2, Census Tract 1704.04, Coweta County, Georgia",2216,481,1950,463,266,258
1500000US130771704043,130771704043,"Block Group 3, Census Tract 1704.04, Coweta County, Georgia",1485,353,1427,349,58,93
1500000US130771704051,130771704051,"Block Group 1, Census Tract 1704.05, Coweta County, Georgia",2765,502,2555,501,210,245
1500000US130771704052,130771704052,"Block Group 2, Census Tract 1704.05, Coweta County, Georgia",2384,502,2231,503,153,146
1500000US130771704053,130771704053,"Block Group 3, Census Tract 1704.05, Coweta County, Georgia",2219,493,1317,347,902,536
1500000US130771704061,130771704061,"Block Group 1, Census Tract 1704.06, Coweta County, Georgia",3634,292,3358,287,276,204
1500000US130771705011,130771705011,"Block Group 1, Census Tract 1705.01, Coweta County, Georgia",2426,586,1836,473,590,417
1500000US130771705012,130771705012,"Block Group 2, Census Tract 1705.01, Coweta County, Georgia",2025,456,1737,441,288,148
1500000US130771705013,130771705013,"Block Group 3, Census Tract 1705.01, Coweta County, Georgia",2462,577,2241,581,221,163
1500000US130771705021,130771705021,"Block Group 1, Census Tract 1705.02, Coweta County, Georgia",2313,550,1844,523,469,263
1500000US130771705022,130771705022,"Block Group 2, Census Tract 1705.02, Coweta County, Georgia",2286,389,2020,382,266,222
1500000US130771705023,130771705023,"Block Group 3, Census Tract 1705.02, Coweta County, Georgia",1407,340,1308,345,99,92
1500000US130771705031,130771705031,"Block Group 1, Census Tract 1705.03, Coweta County, Georgia",1994,329,1442,310,552,262
1500000US130771705032,130771705032,"Block Group 2, Census Tract 1705.03, Coweta County, Georgia",2212,347,1795,336,417,280
1500000US130771705033,130771705033,"Block Group 3, Census Tract 1705.03, Coweta County, Georgia",1609,383,1193,366,416,298
1500000US130771706011,130771706011,"Block Group 1, Census Tract 1706.01, Coweta County, Georgia",2644,845,879,638,1765,669
1500000US130771706012,130771706012,"Block Group 2, Census Tract 1706.01, Coweta County, Georgia",1453,431,735,282,718,444
1500000US130771706013,130771706013,"Block Group 3, Census Tract 1706.01, Coweta County, Georgia",1981,662,288,199,1693,642
1500000US130771706014,130771706014,"Block Group 4, Census Tract 1706.01, Coweta County, Georgia",1420,423,836,288,584,326
1500000US130771706021,130771706021,"Block Group 1, Census Tract 1706.02, Coweta County, Georgia",2349,515,1938,503,411,207
1500000US130771706022,130771706022,"Block Group 2, Census Tract 1706.02, Coweta County, Georgia",2006,606,1848,673,158,240
1500000US130771706023,130771706023,"Block Group 3, Census Tract 1706.02, Coweta County, Georgia",2936,538,2334,499,602,364
1500000US130771706024,130771706024,"Block Group 4, Census Tract 1706.02, Coweta County, Georgia",1442,397,1189,403,253,229
1500000US130771706031,130771706031,"Block Group 1, Census Tract 1706.03, Coweta County, Georgia",1235,418,1043,386,192,181
1500000US130771706032,130771706032,"Block Group 2, Census Tract 1706.03, Coweta County, Georgia",3889,473,3394,395,495,354
1500000US130771707001,130771707001,"Block Group 1, Census Tract 1707, Coweta County, Georgia",1315,361,819,329,496,245
1500000US130771707002,130771707002,"Block Group 2, Census Tract 1707, Coweta County, Georgia",2069,450,1603,385,466,325
1500000US130771707003,130771707003,"Block Group 3, Census Tract 1707, Coweta County, Georgia",2032,465,1084,420,948,428
1500000US130771707004,130771707004,"Block Group 4, Census Tract 1707, Coweta County, Georgia",843,290,334,167,509,282
1500000US130771707005,130771707005,"Block Group 5, Census Tract 1707, Coweta County, Georgia",573,204,302,132,271,182
1500000US130771708011,130771708011,"Block Group 1, Census Tract 1708.01, Coweta County, Georgia",2524,464,2113,423,411,285
1500000US130771708012,130771708012,"Block Group 2, Census Tract 1708.01, Coweta County, Georgia",3074,396,1841,475,1233,281
1500000US130771708021,130771708021,"Block Group 1, Census Tract 1708.02, Coweta County, Georgia",1798,367,1546,339,252,214
1500000US130771708022,130771708022,"Block Group 2, Census Tract 1708.02, Coweta County, Georgia",2625,301,2062,317,563,247
1500000US130790701001,130790701001,"Block Group 1, Census Tract 701, Crawford County, Georgia",1532,324,1209,284,323,132
1500000US130790701002,130790701002,"Block Group 2, Census Tract 701, Crawford County, Georgia",1323,377,1060,345,263,137
1500000US130790701003,130790701003,"Block Group 3, Census Tract 701, Crawford County, Georgia",1027,301,751,275,276,141
1500000US130790702011,130790702011,"Block Group 1, Census Tract 702.01, Crawford County, Georgia",1423,325,1238,305,185,151
1500000US130790702012,130790702012,"Block Group 2, Census Tract 702.01, Crawford County, Georgia",1276,319,987,313,289,218
1500000US130790702013,130790702013,"Block Group 3, Census Tract 702.01, Crawford County, Georgia",2501,319,1720,411,781,390
1500000US130790702021,130790702021,"Block Group 1, Census Tract 702.02, Crawford County, Georgia",1587,350,1460,336,127,122
1500000US130790702022,130790702022,"Block Group 2, Census Tract 702.02, Crawford County, Georgia",1692,274,1491,295,201,171
1500000US130810101001,130810101001,"Block Group 1, Census Tract 101, Crisp County, Georgia",1765,342,1458,349,307,163
1500000US130810101002,130810101002,"Block Group 2, Census Tract 101, Crisp County, Georgia",1612,403,470,227,1142,334
1500000US130810101003,130810101003,"Block Group 3, Census Tract 101, Crisp County, Georgia",1040,416,240,145,800,390
1500000US130810102011,130810102011,"Block Group 1, Census Tract 102.01, Crisp County, Georgia",1820,384,1557,366,263,313
1500000US130810102012,130810102012,"Block Group 2, Census Tract 102.01, Crisp County, Georgia",861,274,699,257,162,127
1500000US130810102013,130810102013,"Block Group 3, Census Tract 102.01, Crisp County, Georgia",872,364,431,251,441,340
1500000US130810102014,130810102014,"Block Group 4, Census Tract 102.01, Crisp County, Georgia",1126,466,214,163,912,496
1500000US130810102021,130810102021,"Block Group 1, Census Tract 102.02, Crisp County, Georgia",1238,397,1018,374,220,218
1500000US130810102022,130810102022,"Block Group 2, Census Tract 102.02, Crisp County, Georgia",967,329,198,177,769,314
1500000US130810102023,130810102023,"Block Group 3, Census Tract 102.02, Crisp County, Georgia",596,296,101,111,495,292
1500000US130810103001,130810103001,"Block Group 1, Census Tract 103, Crisp County, Georgia",1049,287,515,204,534,287
1500000US130810103002,130810103002,"Block Group 2, Census Tract 103, Crisp County, Georgia",2056,367,1592,329,464,219
1500000US130810103003,130810103003,"Block Group 3, Census Tract 103, Crisp County, Georgia",827,544,83,92,744,547
1500000US130810104001,130810104001,"Block Group 1, Census Tract 104, Crisp County, Georgia",1449,480,823,274,626,485
1500000US130810104002,130810104002,"Block Group 2, Census Tract 104, Crisp County, Georgia",995,352,413,218,582,285
1500000US130810104003,130810104003,"Block Group 3, Census Tract 104, Crisp County, Georgia",712,425,239,154,473,409
1500000US130810104004,130810104004,"Block Group 4, Census Tract 104, Crisp County, Georgia",1726,480,1202,359,524,341
1500000US130810104005,130810104005,"Block Group 5, Census Tract 104, Crisp County, Georgia",592,335,216,143,376,315
1500000US130810105001,130810105001,"Block Group 1, Census Tract 105, Crisp County, Georgia",874,161,685,138,189,90
1500000US130810105002,130810105002,"Block Group 2, Census Tract 105, Crisp County, Georgia",669,179,459,123,210,131
1500000US130830401011,130830401011,"Block Group 1, Census Tract 401.01, Dade County, Georgia",2484,443,2128,435,356,242
1500000US130830401012,130830401012,"Block Group 2, Census Tract 401.01, Dade County, Georgia",1996,391,1510,367,486,230
1500000US130830401021,130830401021,"Block Group 1, Census Tract 401.02, Dade County, Georgia",1006,202,400,150,606,166
1500000US130830401022,130830401022,"Block Group 2, Census Tract 401.02, Dade County, Georgia",2511,324,2014,322,497,230
1500000US130830402001,130830402001,"Block Group 1, Census Tract 402, Dade County, Georgia",1964,293,1661,316,303,183
1500000US130830402002,130830402002,"Block Group 2, Census Tract 402, Dade County, Georgia",2146,337,1730,361,416,268
1500000US130830403001,130830403001,"Block Group 1, Census Tract 403, Dade County, Georgia",1293,288,1167,250,126,141
1500000US130830403002,130830403002,"Block Group 2, Census Tract 403, Dade County, Georgia",1786,409,1447,447,339,158
1500000US130859701001,130859701001,"Block Group 1, Census Tract 9701, Dawson County, Georgia",2698,558,1865,568,833,404
1500000US130859701002,130859701002,"Block Group 2, Census Tract 9701, Dawson County, Georgia",3236,328,2304,332,932,198
1500000US130859701003,130859701003,"Block Group 3, Census Tract 9701, Dawson County, Georgia",1846,331,1755,354,91,139
1500000US130859702011,130859702011,"Block Group 1, Census Tract 9702.01, Dawson County, Georgia",1571,446,1089,311,482,366
1500000US130859702012,130859702012,"Block Group 2, Census Tract 9702.01, Dawson County, Georgia",2246,672,1457,491,789,541
1500000US130859702013,130859702013,"Block Group 3, Census Tract 9702.01, Dawson County, Georgia",1124,395,370,190,754,373
1500000US130859702014,130859702014,"Block Group 4, Census Tract 9702.01, Dawson County, Georgia",2240,418,1835,417,405,292
1500000US130859702021,130859702021,"Block Group 1, Census Tract 9702.02, Dawson County, Georgia",2750,637,1681,473,1069,530
1500000US130859702022,130859702022,"Block Group 2, Census Tract 9702.02, Dawson County, Georgia",1277,512,1080,468,197,167
1500000US130859702023,130859702023,"Block Group 3, Census Tract 9702.02, Dawson County, Georgia",3492,908,2622,728,870,773
1500000US130879701001,130879701001,"Block Group 1, Census Tract 9701, Decatur County, Georgia",588,172,501,180,87,75
1500000US130879701002,130879701002,"Block Group 2, Census Tract 9701, Decatur County, Georgia",1429,307,1189,315,240,130
1500000US130879701003,130879701003,"Block Group 3, Census Tract 9701, Decatur County, Georgia",1398,227,1286,222,112,81
1500000US130879702001,130879702001,"Block Group 1, Census Tract 9702, Decatur County, Georgia",1239,338,679,250,560,300
1500000US130879702002,130879702002,"Block Group 2, Census Tract 9702, Decatur County, Georgia",1648,407,802,235,846,362
1500000US130879703001,130879703001,"Block Group 1, Census Tract 9703, Decatur County, Georgia",1383,348,836,182,547,319
1500000US130879703002,130879703002,"Block Group 2, Census Tract 9703, Decatur County, Georgia",1710,552,1072,445,638,392
1500000US130879703003,130879703003,"Block Group 3, Census Tract 9703, Decatur County, Georgia",1381,432,349,198,1032,403
1500000US130879703004,130879703004,"Block Group 4, Census Tract 9703, Decatur County, Georgia",1185,371,840,306,345,276
1500000US130879704001,130879704001,"Block Group 1, Census Tract 9704, Decatur County, Georgia",1186,314,478,221,708,283
1500000US130879704002,130879704002,"Block Group 2, Census Tract 9704, Decatur County, Georgia",937,296,663,238,274,209
1500000US130879704003,130879704003,"Block Group 3, Census Tract 9704, Decatur County, Georgia",1481,378,623,215,858,352
1500000US130879704004,130879704004,"Block Group 4, Census Tract 9704, Decatur County, Georgia",1063,278,336,135,727,283
1500000US130879706001,130879706001,"Block Group 1, Census Tract 9706, Decatur County, Georgia",458,262,352,257,106,104
1500000US130879706002,130879706002,"Block Group 2, Census Tract 9706, Decatur County, Georgia",757,229,251,118,506,254
1500000US130879706003,130879706003,"Block Group 3, Census Tract 9706, Decatur County, Georgia",1731,420,443,166,1288,416
1500000US130879706004,130879706004,"Block Group 4, Census Tract 9706, Decatur County, Georgia",1969,378,1769,368,200,198
1500000US130879707001,130879707001,"Block Group 1, Census Tract 9707, Decatur County, Georgia",1154,267,696,142,458,300
1500000US130879707002,130879707002,"Block Group 2, Census Tract 9707, Decatur County, Georgia",651,118,534,104,117,78
1500000US130879708001,130879708001,"Block Group 1, Census Tract 9708, Decatur County, Georgia",1497,289,1114,317,383,184
1500000US130879708002,130879708002,"Block Group 2, Census Tract 9708, Decatur County, Georgia",1244,287,608,178,636,272
1500000US130890201001,130890201001,"Block Group 1, Census Tract 201, DeKalb County, Georgia",1908,124,1531,127,377,107
1500000US130890202001,130890202001,"Block Group 1, Census Tract 202, DeKalb County, Georgia",901,155,800,163,101,62
1500000US130890202002,130890202002,"Block Group 2, Census Tract 202, DeKalb County, Georgia",1152,208,508,118,644,210
1500000US130890203001,130890203001,"Block Group 1, Census Tract 203, DeKalb County, Georgia",840,206,660,182,180,130
1500000US130890203002,130890203002,"Block Group 2, Census Tract 203, DeKalb County, Georgia",1049,199,707,192,342,144
1500000US130890203003,130890203003,"Block Group 3, Census Tract 203, DeKalb County, Georgia",1883,273,1310,245,573,195
1500000US130890204001,130890204001,"Block Group 1, Census Tract 204, DeKalb County, Georgia",1684,202,1018,190,666,179
1500000US130890204002,130890204002,"Block Group 2, Census Tract 204, DeKalb County, Georgia",901,144,673,167,228,87
1500000US130890205001,130890205001,"Block Group 1, Census Tract 205, DeKalb County, Georgia",1193,273,604,240,589,151
1500000US130890205002,130890205002,"Block Group 2, Census Tract 205, DeKalb County, Georgia",1704,256,1074,296,630,241
1500000US130890206001,130890206001,"Block Group 1, Census Tract 206, DeKalb County, Georgia",616,186,346,170,270,99
1500000US130890206002,130890206002,"Block Group 2, Census Tract 206, DeKalb County, Georgia",1433,252,509,134,924,235
1500000US130890207001,130890207001,"Block Group 1, Census Tract 207, DeKalb County, Georgia",1717,249,963,217,754,235
1500000US130890207002,130890207002,"Block Group 2, Census Tract 207, DeKalb County, Georgia",528,111,386,113,142,46
1500000US130890208011,130890208011,"Block Group 1, Census Tract 208.01, DeKalb County, Georgia",1041,236,938,231,103,94
1500000US130890208012,130890208012,"Block Group 2, Census Tract 208.01, DeKalb County, Georgia",1544,249,1383,238,161,104
1500000US130890208021,130890208021,"Block Group 1, Census Tract 208.02, DeKalb County, Georgia",713,176,635,182,78,67
1500000US130890208022,130890208022,"Block Group 2, Census Tract 208.02, DeKalb County, Georgia",1720,266,707,234,1013,258
1500000US130890208023,130890208023,"Block Group 3, Census Tract 208.02, DeKalb County, Georgia",951,247,787,230,164,171
1500000US130890208024,130890208024,"Block Group 4, Census Tract 208.02, DeKalb County, Georgia",867,258,699,249,168,130
1500000US130890209001,130890209001,"Block Group 1, Census Tract 209, DeKalb County, Georgia",1525,318,1222,306,303,141
1500000US130890209002,130890209002,"Block Group 2, Census Tract 209, DeKalb County, Georgia",1235,413,850,361,385,261
1500000US130890209003,130890209003,"Block Group 3, Census Tract 209, DeKalb County, Georgia",1776,641,995,457,781,670
1500000US130890209004,130890209004,"Block Group 4, Census Tract 209, DeKalb County, Georgia",1164,562,621,317,543,477
1500000US130890211011,130890211011,"Block Group 1, Census Tract 211.01, DeKalb County, Georgia",3779,220,3441,222,338,152
1500000US130890211021,130890211021,"Block Group 1, Census Tract 211.02, DeKalb County, Georgia",209,100,0,13,209,100
1500000US130890211022,130890211022,"Block Group 2, Census Tract 211.02, DeKalb County, Georgia",1757,287,1693,286,64,66
1500000US130890211023,130890211023,"Block Group 3, Census Tract 211.02, DeKalb County, Georgia",527,187,49,51,478,196
1500000US130890211024,130890211024,"Block Group 4, Census Tract 211.02, DeKalb County, Georgia",2203,385,1069,243,1134,305
1500000US130890212021,130890212021,"Block Group 1, Census Tract 212.02, DeKalb County, Georgia",3004,480,2421,469,583,187
1500000US130890212022,130890212022,"Block Group 2, Census Tract 212.02, DeKalb County, Georgia",1914,465,1776,467,138,136
1500000US130890212023,130890212023,"Block Group 3, Census Tract 212.02, DeKalb County, Georgia",2240,509,1843,529,397,179
1500000US130890212041,130890212041,"Block Group 1, Census Tract 212.04, DeKalb County, Georgia",1253,356,0,13,1253,356
1500000US130890212042,130890212042,"Block Group 2, Census Tract 212.04, DeKalb County, Georgia",1763,446,42,65,1721,436
1500000US130890212043,130890212043,"Block Group 3, Census Tract 212.04, DeKalb County, Georgia",989,292,120,94,869,277
1500000US130890212081,130890212081,"Block Group 1, Census Tract 212.08, DeKalb County, Georgia",2432,392,930,164,1502,400
1500000US130890212082,130890212082,"Block Group 2, Census Tract 212.08, DeKalb County, Georgia",1600,240,1354,240,246,147
1500000US130890212091,130890212091,"Block Group 1, Census Tract 212.09, DeKalb County, Georgia",1167,337,303,138,864,318
1500000US130890212092,130890212092,"Block Group 2, Census Tract 212.09, DeKalb County, Georgia",1516,299,729,224,787,266
1500000US130890212093,130890212093,"Block Group 3, Census Tract 212.09, DeKalb County, Georgia",1901,296,1069,249,832,260
1500000US130890212094,130890212094,"Block Group 4, Census Tract 212.09, DeKalb County, Georgia",1173,232,969,236,204,137
1500000US130890212101,130890212101,"Block Group 1, Census Tract 212.10, DeKalb County, Georgia",1813,285,1537,240,276,174
1500000US130890212102,130890212102,"Block Group 2, Census Tract 212.10, DeKalb County, Georgia",1207,284,1175,283,32,36
1500000US130890212103,130890212103,"Block Group 3, Census Tract 212.10, DeKalb County, Georgia",2493,319,2453,319,40,45
1500000US130890212111,130890212111,"Block Group 1, Census Tract 212.11, DeKalb County, Georgia",1323,219,1247,211,76,73
1500000US130890212112,130890212112,"Block Group 2, Census Tract 212.11, DeKalb County, Georgia",2110,380,1963,393,147,120
1500000US130890212113,130890212113,"Block Group 3, Census Tract 212.11, DeKalb County, Georgia",1349,216,1269,219,80,73
1500000US130890212131,130890212131,"Block Group 1, Census Tract 212.13, DeKalb County, Georgia",1076,179,1010,184,66,65
1500000US130890212132,130890212132,"Block Group 2, Census Tract 212.13, DeKalb County, Georgia",2379,180,2269,171,110,124
1500000US130890212141,130890212141,"Block Group 1, Census Tract 212.14, DeKalb County, Georgia",1801,492,1571,325,230,363
1500000US130890212142,130890212142,"Block Group 2, Census Tract 212.14, DeKalb County, Georgia",3002,408,2898,409,104,119
1500000US130890212143,130890212143,"Block Group 3, Census Tract 212.14, DeKalb County, Georgia",1529,345,1461,360,68,113
1500000US130890212151,130890212151,"Block Group 1, Census Tract 212.15, DeKalb County, Georgia",3401,533,1024,305,2377,581
1500000US130890212152,130890212152,"Block Group 2, Census Tract 212.15, DeKalb County, Georgia",2544,456,636,278,1908,446
1500000US130890212161,130890212161,"Block Group 1, Census Tract 212.16, DeKalb County, Georgia",1876,512,1876,512,0,13
1500000US130890212162,130890212162,"Block Group 2, Census Tract 212.16, DeKalb County, Georgia",3807,766,844,382,2963,687
1500000US130890212163,130890212163,"Block Group 3, Census Tract 212.16, DeKalb County, Georgia",2728,543,240,205,2488,523
1500000US130890212171,130890212171,"Block Group 1, Census Tract 212.17, DeKalb County, Georgia",2466,284,1836,317,630,179
1500000US130890212181,130890212181,"Block Group 1, Census Tract 212.18, DeKalb County, Georgia",1266,339,105,80,1161,340
1500000US130890212182,130890212182,"Block Group 2, Census Tract 212.18, DeKalb County, Georgia",2239,510,429,200,1810,545
1500000US130890212183,130890212183,"Block Group 3, Census Tract 212.18, DeKalb County, Georgia",1319,364,763,269,556,341
1500000US130890213011,130890213011,"Block Group 1, Census Tract 213.01, DeKalb County, Georgia",1084,405,232,117,852,383
1500000US130890213012,130890213012,"Block Group 2, Census Tract 213.01, DeKalb County, Georgia",2898,489,514,227,2384,529
1500000US130890213031,130890213031,"Block Group 1, Census Tract 213.03, DeKalb County, Georgia",3051,457,1280,298,1771,384
1500000US130890213032,130890213032,"Block Group 2, Census Tract 213.03, DeKalb County, Georgia",1314,309,717,238,597,270
1500000US130890213033,130890213033,"Block Group 3, Census Tract 213.03, DeKalb County, Georgia",2131,432,227,140,1904,443
1500000US130890213051,130890213051,"Block Group 1, Census Tract 213.05, DeKalb County, Georgia",928,298,739,227,189,196
1500000US130890213052,130890213052,"Block Group 2, Census Tract 213.05, DeKalb County, Georgia",4256,548,750,156,3506,516
1500000US130890213061,130890213061,"Block Group 1, Census Tract 213.06, DeKalb County, Georgia",2570,579,874,300,1696,535
1500000US130890213062,130890213062,"Block Group 2, Census Tract 213.06, DeKalb County, Georgia",667,222,382,163,285,180
1500000US130890213063,130890213063,"Block Group 3, Census Tract 213.06, DeKalb County, Georgia",1885,389,112,93,1773,392
1500000US130890213071,130890213071,"Block Group 1, Census Tract 213.07, DeKalb County, Georgia",1430,429,875,255,555,420
1500000US130890213072,130890213072,"Block Group 2, Census Tract 213.07, DeKalb County, Georgia",2946,418,1285,321,1661,378
1500000US130890213081,130890213081,"Block Group 1, Census Tract 213.08, DeKalb County, Georgia",1643,457,853,258,790,450
1500000US130890213082,130890213082,"Block Group 2, Census Tract 213.08, DeKalb County, Georgia",525,202,486,194,39,40
1500000US130890213083,130890213083,"Block Group 3, Census Tract 213.08, DeKalb County, Georgia",1926,498,439,225,1487,525
1500000US130890214051,130890214051,"Block Group 1, Census Tract 214.05, DeKalb County, Georgia",1029,202,773,177,256,134
1500000US130890214052,130890214052,"Block Group 2, Census Tract 214.05, DeKalb County, Georgia",1850,462,980,245,870,436
1500000US130890214053,130890214053,"Block Group 3, Census Tract 214.05, DeKalb County, Georgia",1367,298,1193,285,174,158
1500000US130890214091,130890214091,"Block Group 1, Census Tract 214.09, DeKalb County, Georgia",2694,410,37,39,2657,415
1500000US130890214092,130890214092,"Block Group 2, Census Tract 214.09, DeKalb County, Georgia",975,501,211,97,764,500
1500000US130890214101,130890214101,"Block Group 1, Census Tract 214.10, DeKalb County, Georgia",1964,501,663,197,1301,476
1500000US130890214102,130890214102,"Block Group 2, Census Tract 214.10, DeKalb County, Georgia",1757,501,8,12,1749,499
1500000US130890214103,130890214103,"Block Group 3, Census Tract 214.10, DeKalb County, Georgia",1633,296,639,172,994,272
1500000US130890214111,130890214111,"Block Group 1, Census Tract 214.11, DeKalb County, Georgia",1832,225,971,190,861,170
1500000US130890214112,130890214112,"Block Group 2, Census Tract 214.11, DeKalb County, Georgia",1718,219,538,162,1180,229
1500000US130890214121,130890214121,"Block Group 1, Census Tract 214.12, DeKalb County, Georgia",1167,237,1073,252,94,78
1500000US130890214122,130890214122,"Block Group 2, Census Tract 214.12, DeKalb County, Georgia",1480,294,807,204,673,316
1500000US130890214123,130890214123,"Block Group 3, Census Tract 214.12, DeKalb County, Georgia",1227,246,815,232,412,205
1500000US130890214131,130890214131,"Block Group 1, Census Tract 214.13, DeKalb County, Georgia",3030,545,489,141,2541,516
1500000US130890214132,130890214132,"Block Group 2, Census Tract 214.13, DeKalb County, Georgia",1451,408,141,113,1310,397
1500000US130890214141,130890214141,"Block Group 1, Census Tract 214.14, DeKalb County, Georgia",3022,382,62,34,2960,383
1500000US130890214142,130890214142,"Block Group 2, Census Tract 214.14, DeKalb County, Georgia",947,220,110,64,837,222
1500000US130890214151,130890214151,"Block Group 1, Census Tract 214.15, DeKalb County, Georgia",1082,212,600,145,482,197
1500000US130890214152,130890214152,"Block Group 2, Census Tract 214.15, DeKalb County, Georgia",1229,203,442,143,787,166
1500000US130890214153,130890214153,"Block Group 3, Census Tract 214.15, DeKalb County, Georgia",1846,408,1026,223,820,354
1500000US130890214161,130890214161,"Block Group 1, Census Tract 214.16, DeKalb County, Georgia",1978,401,541,185,1437,391
1500000US130890214162,130890214162,"Block Group 2, Census Tract 214.16, DeKalb County, Georgia",614,165,410,132,204,133
1500000US130890214171,130890214171,"Block Group 1, Census Tract 214.17, DeKalb County, Georgia",1117,284,289,133,828,250
1500000US130890214172,130890214172,"Block Group 2, Census Tract 214.17, DeKalb County, Georgia",1231,486,138,202,1093,494
1500000US130890214173,130890214173,"Block Group 3, Census Tract 214.17, DeKalb County, Georgia",2793,597,198,198,2595,591
1500000US130890215021,130890215021,"Block Group 1, Census Tract 215.02, DeKalb County, Georgia",1298,237,358,172,940,176
1500000US130890215022,130890215022,"Block Group 2, Census Tract 215.02, DeKalb County, Georgia",1445,483,1045,274,400,411
1500000US130890215023,130890215023,"Block Group 3, Census Tract 215.02, DeKalb County, Georgia",1839,341,1284,337,555,220
1500000US130890215031,130890215031,"Block Group 1, Census Tract 215.03, DeKalb County, Georgia",1478,324,734,154,744,295
1500000US130890215032,130890215032,"Block Group 2, Census Tract 215.03, DeKalb County, Georgia",908,251,601,213,307,206
1500000US130890215033,130890215033,"Block Group 3, Census Tract 215.03, DeKalb County, Georgia",1741,482,75,52,1666,479
1500000US130890215041,130890215041,"Block Group 1, Census Tract 215.04, DeKalb County, Georgia",1619,384,307,230,1312,384
1500000US130890215042,130890215042,"Block Group 2, Census Tract 215.04, DeKalb County, Georgia",1952,365,739,247,1213,337
1500000US130890215043,130890215043,"Block Group 3, Census Tract 215.04, DeKalb County, Georgia",1190,255,561,169,629,213
1500000US130890216021,130890216021,"Block Group 1, Census Tract 216.02, DeKalb County, Georgia",1605,334,217,113,1388,324
1500000US130890216022,130890216022,"Block Group 2, Census Tract 216.02, DeKalb County, Georgia",2399,258,2224,259,175,156
1500000US130890216031,130890216031,"Block Group 1, Census Tract 216.03, DeKalb County, Georgia",1665,257,920,243,745,229
1500000US130890216032,130890216032,"Block Group 2, Census Tract 216.03, DeKalb County, Georgia",1653,282,667,209,986,234
1500000US130890216033,130890216033,"Block Group 3, Census Tract 216.03, DeKalb County, Georgia",1200,239,319,105,881,240
1500000US130890216041,130890216041,"Block Group 1, Census Tract 216.04, DeKalb County, Georgia",2046,207,1915,224,131,117
1500000US130890216042,130890216042,"Block Group 2, Census Tract 216.04, DeKalb County, Georgia",1091,198,1030,198,61,58
1500000US130890216051,130890216051,"Block Group 1, Census Tract 216.05, DeKalb County, Georgia",1652,286,1351,292,301,141
1500000US130890216052,130890216052,"Block Group 2, Census Tract 216.05, DeKalb County, Georgia",1035,252,956,244,79,94
1500000US130890216053,130890216053,"Block Group 3, Census Tract 216.05, DeKalb County, Georgia",2805,625,175,124,2630,627
1500000US130890217031,130890217031,"Block Group 1, Census Tract 217.03, DeKalb County, Georgia",2305,249,2136,235,169,87
1500000US130890217032,130890217032,"Block Group 2, Census Tract 217.03, DeKalb County, Georgia",2479,243,2425,249,54,46
1500000US130890217041,130890217041,"Block Group 1, Census Tract 217.04, DeKalb County, Georgia",1577,440,948,330,629,389
1500000US130890217042,130890217042,"Block Group 2, Census Tract 217.04, DeKalb County, Georgia",1118,356,544,171,574,392
1500000US130890217043,130890217043,"Block Group 3, Census Tract 217.04, DeKalb County, Georgia",2877,306,2812,308,65,81
1500000US130890217051,130890217051,"Block Group 1, Census Tract 217.05, DeKalb County, Georgia",2147,476,674,231,1473,444
1500000US130890217052,130890217052,"Block Group 2, Census Tract 217.05, DeKalb County, Georgia",1262,319,659,227,603,284
1500000US130890217053,130890217053,"Block Group 3, Census Tract 217.05, DeKalb County, Georgia",1152,316,173,141,979,288
1500000US130890217061,130890217061,"Block Group 1, Census Tract 217.06, DeKalb County, Georgia",787,207,774,208,13,21
1500000US130890217062,130890217062,"Block Group 2, Census Tract 217.06, DeKalb County, Georgia",2192,402,863,311,1329,363
1500000US130890217063,130890217063,"Block Group 3, Census Tract 217.06, DeKalb County, Georgia",1065,267,977,283,88,104
1500000US130890217064,130890217064,"Block Group 4, Census Tract 217.06, DeKalb County, Georgia",1530,274,1275,269,255,176
1500000US130890218051,130890218051,"Block Group 1, Census Tract 218.05, DeKalb County, Georgia",1831,426,1652,416,179,123
1500000US130890218052,130890218052,"Block Group 2, Census Tract 218.05, DeKalb County, Georgia",1876,467,980,264,896,437
1500000US130890218053,130890218053,"Block Group 3, Census Tract 218.05, DeKalb County, Georgia",2665,578,1544,455,1121,391
1500000US130890218061,130890218061,"Block Group 1, Census Tract 218.06, DeKalb County, Georgia",2374,579,454,220,1920,577
1500000US130890218062,130890218062,"Block Group 2, Census Tract 218.06, DeKalb County, Georgia",1074,255,990,222,84,135
1500000US130890218063,130890218063,"Block Group 3, Census Tract 218.06, DeKalb County, Georgia",2228,509,718,318,1510,525
1500000US130890218081,130890218081,"Block Group 1, Census Tract 218.08, DeKalb County, Georgia",1706,335,1332,295,374,192
1500000US130890218082,130890218082,"Block Group 2, Census Tract 218.08, DeKalb County, Georgia",3293,426,1760,272,1533,424
1500000US130890218091,130890218091,"Block Group 1, Census Tract 218.09, DeKalb County, Georgia",532,192,514,199,18,28
1500000US130890218092,130890218092,"Block Group 2, Census Tract 218.09, DeKalb County, Georgia",1678,390,1629,393,49,44
1500000US130890218093,130890218093,"Block Group 3, Census Tract 218.09, DeKalb County, Georgia",1888,293,1850,300,38,60
1500000US130890218094,130890218094,"Block Group 4, Census Tract 218.09, DeKalb County, Georgia",1206,345,886,263,320,300
1500000US130890218095,130890218095,"Block Group 5, Census Tract 218.09, DeKalb County, Georgia",1210,244,1200,241,10,68
1500000US130890218101,130890218101,"Block Group 1, Census Tract 218.10, DeKalb County, Georgia",2190,430,684,201,1506,429
1500000US130890218102,130890218102,"Block Group 2, Census Tract 218.10, DeKalb County, Georgia",1319,306,1299,308,20,42
1500000US130890218103,130890218103,"Block Group 3, Census Tract 218.10, DeKalb County, Georgia",1627,312,1445,284,182,135
1500000US130890218121,130890218121,"Block Group 1, Census Tract 218.12, DeKalb County, Georgia",983,156,523,109,460,162
1500000US130890218122,130890218122,"Block Group 2, Census Tract 218.12, DeKalb County, Georgia",1291,194,704,115,587,195
1500000US130890218131,130890218131,"Block Group 1, Census Tract 218.13, DeKalb County, Georgia",2859,485,10,15,2849,485
1500000US130890218141,130890218141,"Block Group 1, Census Tract 218.14, DeKalb County, Georgia",1045,372,790,337,255,173
1500000US130890218142,130890218142,"Block Group 2, Census Tract 218.14, DeKalb County, Georgia",1382,452,359,131,1023,464
1500000US130890218143,130890218143,"Block Group 3, Census Tract 218.14, DeKalb County, Georgia",1339,420,112,112,1227,405
1500000US130890218144,130890218144,"Block Group 4, Census Tract 218.14, DeKalb County, Georgia",1870,447,105,71,1765,452
1500000US130890219061,130890219061,"Block Group 1, Census Tract 219.06, DeKalb County, Georgia",1644,368,1145,358,499,249
1500000US130890219062,130890219062,"Block Group 2, Census Tract 219.06, DeKalb County, Georgia",758,255,455,189,303,182
1500000US130890219063,130890219063,"Block Group 3, Census Tract 219.06, DeKalb County, Georgia",2818,549,1855,472,963,383
1500000US130890219071,130890219071,"Block Group 1, Census Tract 219.07, DeKalb County, Georgia",4793,543,3821,512,972,507
1500000US130890219072,130890219072,"Block Group 2, Census Tract 219.07, DeKalb County, Georgia",2209,519,1751,450,458,365
1500000US130890219073,130890219073,"Block Group 3, Census Tract 219.07, DeKalb County, Georgia",1883,458,595,242,1288,492
1500000US130890219081,130890219081,"Block Group 1, Census Tract 219.08, DeKalb County, Georgia",1943,720,1431,642,512,348
1500000US130890219082,130890219082,"Block Group 2, Census Tract 219.08, DeKalb County, Georgia",4168,624,592,346,3576,578
1500000US130890219091,130890219091,"Block Group 1, Census Tract 219.09, DeKalb County, Georgia",2234,564,179,58,2055,562
1500000US130890219092,130890219092,"Block Group 2, Census Tract 219.09, DeKalb County, Georgia",1609,503,1474,507,135,112
1500000US130890219093,130890219093,"Block Group 3, Census Tract 219.09, DeKalb County, Georgia",1013,563,66,61,947,566
1500000US130890219094,130890219094,"Block Group 4, Census Tract 219.09, DeKalb County, Georgia",1750,655,681,270,1069,642
1500000US130890219101,130890219101,"Block Group 1, Census Tract 219.10, DeKalb County, Georgia",1341,549,606,482,735,409
1500000US130890219102,130890219102,"Block Group 2, Census Tract 219.10, DeKalb County, Georgia",1787,434,1614,377,173,180
1500000US130890219103,130890219103,"Block Group 3, Census Tract 219.10, DeKalb County, Georgia",1683,451,1058,336,625,339
1500000US130890219111,130890219111,"Block Group 1, Census Tract 219.11, DeKalb County, Georgia",816,526,0,13,816,526
1500000US130890219112,130890219112,"Block Group 2, Census Tract 219.11, DeKalb County, Georgia",1373,504,320,224,1053,534
1500000US130890219121,130890219121,"Block Group 1, Census Tract 219.12, DeKalb County, Georgia",1451,299,1422,293,29,70
1500000US130890219122,130890219122,"Block Group 2, Census Tract 219.12, DeKalb County, Georgia",1364,261,1292,262,72,60
1500000US130890219123,130890219123,"Block Group 3, Census Tract 219.12, DeKalb County, Georgia",644,153,644,153,0,13
1500000US130890219131,130890219131,"Block Group 1, Census Tract 219.13, DeKalb County, Georgia",2422,621,63,42,2359,623
1500000US130890219132,130890219132,"Block Group 2, Census Tract 219.13, DeKalb County, Georgia",848,294,0,13,848,294
1500000US130890219133,130890219133,"Block Group 3, Census Tract 219.13, DeKalb County, Georgia",1243,574,684,551,559,275
1500000US130890220011,130890220011,"Block Group 1, Census Tract 220.01, DeKalb County, Georgia",2013,508,1031,268,982,496
1500000US130890220012,130890220012,"Block Group 2, Census Tract 220.01, DeKalb County, Georgia",2321,361,1980,323,341,167
1500000US130890220041,130890220041,"Block Group 1, Census Tract 220.04, DeKalb County, Georgia",2663,538,1998,431,665,354
1500000US130890220042,130890220042,"Block Group 2, Census Tract 220.04, DeKalb County, Georgia",1381,474,1302,498,79,104
1500000US130890220043,130890220043,"Block Group 3, Census Tract 220.04, DeKalb County, Georgia",1977,498,1384,325,593,367
1500000US130890220051,130890220051,"Block Group 1, Census Tract 220.05, DeKalb County, Georgia",1727,546,223,118,1504,560
1500000US130890220052,130890220052,"Block Group 2, Census Tract 220.05, DeKalb County, Georgia",1117,264,555,213,562,242
1500000US130890220053,130890220053,"Block Group 3, Census Tract 220.05, DeKalb County, Georgia",1736,318,631,205,1105,275
1500000US130890220071,130890220071,"Block Group 1, Census Tract 220.07, DeKalb County, Georgia",2254,470,73,94,2181,474
1500000US130890220072,130890220072,"Block Group 2, Census Tract 220.07, DeKalb County, Georgia",1833,341,197,143,1636,348
1500000US130890220081,130890220081,"Block Group 1, Census Tract 220.08, DeKalb County, Georgia",1057,394,496,228,561,339
1500000US130890220082,130890220082,"Block Group 2, Census Tract 220.08, DeKalb County, Georgia",2580,712,128,172,2452,708
1500000US130890220083,130890220083,"Block Group 3, Census Tract 220.08, DeKalb County, Georgia",3693,774,327,141,3366,785
1500000US130890220084,130890220084,"Block Group 4, Census Tract 220.08, DeKalb County, Georgia",1037,468,124,140,913,455
1500000US130890220091,130890220091,"Block Group 1, Census Tract 220.09, DeKalb County, Georgia",1844,490,204,118,1640,507
1500000US130890220092,130890220092,"Block Group 2, Census Tract 220.09, DeKalb County, Georgia",1905,439,163,115,1742,445
1500000US130890220093,130890220093,"Block Group 3, Census Tract 220.09, DeKalb County, Georgia",1341,353,0,13,1341,353
1500000US130890220101,130890220101,"Block Group 1, Census Tract 220.10, DeKalb County, Georgia",2659,316,1082,206,1577,360
1500000US130890221001,130890221001,"Block Group 1, Census Tract 221, DeKalb County, Georgia",2090,511,939,455,1151,383
1500000US130890221002,130890221002,"Block Group 2, Census Tract 221, DeKalb County, Georgia",1511,296,653,182,858,292
1500000US130890222031,130890222031,"Block Group 1, Census Tract 222.03, DeKalb County, Georgia",2051,231,394,168,1657,253
1500000US130890222041,130890222041,"Block Group 1, Census Tract 222.04, DeKalb County, Georgia",3732,985,1047,306,2685,1012
1500000US130890222042,130890222042,"Block Group 2, Census Tract 222.04, DeKalb County, Georgia",765,310,342,158,423,294
1500000US130890222043,130890222043,"Block Group 3, Census Tract 222.04, DeKalb County, Georgia",1509,494,0,13,1509,494
1500000US130890222044,130890222044,"Block Group 4, Census Tract 222.04, DeKalb County, Georgia",898,467,185,141,713,483
1500000US130890223011,130890223011,"Block Group 1, Census Tract 223.01, DeKalb County, Georgia",1306,278,860,193,446,259
1500000US130890223012,130890223012,"Block Group 2, Census Tract 223.01, DeKalb County, Georgia",498,124,231,88,267,91
1500000US130890223013,130890223013,"Block Group 3, Census Tract 223.01, DeKalb County, Georgia",909,202,808,220,101,88
1500000US130890223014,130890223014,"Block Group 4, Census Tract 223.01, DeKalb County, Georgia",1376,224,1026,217,350,206
1500000US130890223015,130890223015,"Block Group 5, Census Tract 223.01, DeKalb County, Georgia",1801,370,315,157,1486,365
1500000US130890223021,130890223021,"Block Group 1, Census Tract 223.02, DeKalb County, Georgia",1562,282,1258,278,304,144
1500000US130890223022,130890223022,"Block Group 2, Census Tract 223.02, DeKalb County, Georgia",1274,300,531,170,743,294
1500000US130890223023,130890223023,"Block Group 3, Census Tract 223.02, DeKalb County, Georgia",1728,332,610,317,1118,278
1500000US130890224011,130890224011,"Block Group 1, Census Tract 224.01, DeKalb County, Georgia",1862,305,740,271,1122,276
1500000US130890224012,130890224012,"Block Group 2, Census Tract 224.01, DeKalb County, Georgia",924,209,689,202,235,115
1500000US130890224013,130890224013,"Block Group 3, Census Tract 224.01, DeKalb County, Georgia",973,240,826,211,147,119
1500000US130890224021,130890224021,"Block Group 1, Census Tract 224.02, DeKalb County, Georgia",778,118,377,89,401,119
1500000US130890224022,130890224022,"Block Group 2, Census Tract 224.02, DeKalb County, Georgia",467,116,23,16,444,115
1500000US130890224031,130890224031,"Block Group 1, Census Tract 224.03, DeKalb County, Georgia",1304,189,1194,179,110,104
1500000US130890224032,130890224032,"Block Group 2, Census Tract 224.03, DeKalb County, Georgia",1619,279,1246,295,373,143
1500000US130890224033,130890224033,"Block Group 3, Census Tract 224.03, DeKalb County, Georgia",1065,190,1039,189,26,32
1500000US130890225001,130890225001,"Block Group 1, Census Tract 225, DeKalb County, Georgia",1992,869,326,156,1666,886
1500000US130890225002,130890225002,"Block Group 2, Census Tract 225, DeKalb County, Georgia",1052,293,814,230,238,241
1500000US130890225003,130890225003,"Block Group 3, Census Tract 225, DeKalb County, Georgia",1425,299,1176,301,249,173
1500000US130890225004,130890225004,"Block Group 4, Census Tract 225, DeKalb County, Georgia",1784,309,1378,309,406,192
1500000US130890226001,130890226001,"Block Group 1, Census Tract 226, DeKalb County, Georgia",1756,351,1366,324,390,204
1500000US130890226002,130890226002,"Block Group 2, Census Tract 226, DeKalb County, Georgia",1960,322,1018,265,942,277
1500000US130890226003,130890226003,"Block Group 3, Census Tract 226, DeKalb County, Georgia",1883,304,1193,268,690,288
1500000US130890227001,130890227001,"Block Group 1, Census Tract 227, DeKalb County, Georgia",1882,298,1520,290,362,187
1500000US130890227002,130890227002,"Block Group 2, Census Tract 227, DeKalb County, Georgia",964,200,819,180,145,125
1500000US130890227003,130890227003,"Block Group 3, Census Tract 227, DeKalb County, Georgia",1446,245,1024,225,422,159
1500000US130890228001,130890228001,"Block Group 1, Census Tract 228, DeKalb County, Georgia",534,199,354,167,180,115
1500000US130890228002,130890228002,"Block Group 2, Census Tract 228, DeKalb County, Georgia",1689,311,1447,294,242,160
1500000US130890228003,130890228003,"Block Group 3, Census Tract 228, DeKalb County, Georgia",960,176,818,166,142,84
1500000US130890229001,130890229001,"Block Group 1, Census Tract 229, DeKalb County, Georgia",1511,283,879,216,632,262
1500000US130890229002,130890229002,"Block Group 2, Census Tract 229, DeKalb County, Georgia",151,51,151,51,0,13
1500000US130890229003,130890229003,"Block Group 3, Census Tract 229, DeKalb County, Georgia",1980,272,1528,256,452,195
1500000US130890230001,130890230001,"Block Group 1, Census Tract 230, DeKalb County, Georgia",2096,162,1653,157,443,98
1500000US130890231011,130890231011,"Block Group 1, Census Tract 231.01, DeKalb County, Georgia",638,248,496,218,142,123
1500000US130890231012,130890231012,"Block Group 2, Census Tract 231.01, DeKalb County, Georgia",1657,391,1064,363,593,249
1500000US130890231013,130890231013,"Block Group 3, Census Tract 231.01, DeKalb County, Georgia",833,308,501,272,332,206
1500000US130890231014,130890231014,"Block Group 4, Census Tract 231.01, DeKalb County, Georgia",1455,372,894,313,561,295
1500000US130890231021,130890231021,"Block Group 1, Census Tract 231.02, DeKalb County, Georgia",1443,217,964,142,479,182
1500000US130890231022,130890231022,"Block Group 2, Census Tract 231.02, DeKalb County, Georgia",1768,317,421,115,1347,315
1500000US130890231071,130890231071,"Block Group 1, Census Tract 231.07, DeKalb County, Georgia",1788,418,1035,315,753,369
1500000US130890231072,130890231072,"Block Group 2, Census Tract 231.07, DeKalb County, Georgia",1320,451,323,157,997,436
1500000US130890231073,130890231073,"Block Group 3, Census Tract 231.07, DeKalb County, Georgia",1388,323,749,294,639,293
1500000US130890231081,130890231081,"Block Group 1, Census Tract 231.08, DeKalb County, Georgia",1629,427,541,135,1088,429
1500000US130890231082,130890231082,"Block Group 2, Census Tract 231.08, DeKalb County, Georgia",1238,300,714,250,524,258
1500000US130890231083,130890231083,"Block Group 3, Census Tract 231.08, DeKalb County, Georgia",1854,442,544,206,1310,416
1500000US130890231111,130890231111,"Block Group 1, Census Tract 231.11, DeKalb County, Georgia",2048,239,1127,245,921,276
1500000US130890231121,130890231121,"Block Group 1, Census Tract 231.12, DeKalb County, Georgia",1390,280,0,13,1390,280
1500000US130890231122,130890231122,"Block Group 2, Census Tract 231.12, DeKalb County, Georgia",2334,406,430,221,1904,442
1500000US130890231123,130890231123,"Block Group 3, Census Tract 231.12, DeKalb County, Georgia",541,209,92,67,449,198
1500000US130890231131,130890231131,"Block Group 1, Census Tract 231.13, DeKalb County, Georgia",2059,379,493,184,1566,396
1500000US130890231132,130890231132,"Block Group 2, Census Tract 231.13, DeKalb County, Georgia",1338,290,324,113,1014,276
1500000US130890231141,130890231141,"Block Group 1, Census Tract 231.14, DeKalb County, Georgia",1094,242,870,226,224,147
1500000US130890231142,130890231142,"Block Group 2, Census Tract 231.14, DeKalb County, Georgia",1331,263,978,230,353,173
1500000US130890231151,130890231151,"Block Group 1, Census Tract 231.15, DeKalb County, Georgia",0,13,0,13,0,13
1500000US130890232041,130890232041,"Block Group 1, Census Tract 232.04, DeKalb County, Georgia",2653,631,1187,483,1466,678
1500000US130890232042,130890232042,"Block Group 2, Census Tract 232.04, DeKalb County, Georgia",2562,829,1752,545,810,752
1500000US130890232043,130890232043,"Block Group 3, Census Tract 232.04, DeKalb County, Georgia",1915,630,1407,425,508,594
1500000US130890232061,130890232061,"Block Group 1, Census Tract 232.06, DeKalb County, Georgia",2956,628,1810,563,1146,446
1500000US130890232062,130890232062,"Block Group 2, Census Tract 232.06, DeKalb County, Georgia",3179,868,2232,708,947,708
1500000US130890232063,130890232063,"Block Group 3, Census Tract 232.06, DeKalb County, Georgia",1507,506,533,231,974,530
1500000US130890232081,130890232081,"Block Group 1, Census Tract 232.08, DeKalb County, Georgia",2542,700,1888,604,654,491
1500000US130890232082,130890232082,"Block Group 2, Census Tract 232.08, DeKalb County, Georgia",1318,445,948,282,370,358
1500000US130890232083,130890232083,"Block Group 3, Census Tract 232.08, DeKalb County, Georgia",3168,725,932,385,2236,710
1500000US130890232091,130890232091,"Block Group 1, Census Tract 232.09, DeKalb County, Georgia",1485,527,750,386,735,403
1500000US130890232092,130890232092,"Block Group 2, Census Tract 232.09, DeKalb County, Georgia",2528,590,2235,601,293,211
1500000US130890232093,130890232093,"Block Group 3, Census Tract 232.09, DeKalb County, Georgia",1607,397,1120,311,487,261
1500000US130890232101,130890232101,"Block Group 1, Census Tract 232.10, DeKalb County, Georgia",1247,452,1194,456,53,91
1500000US130890232102,130890232102,"Block Group 2, Census Tract 232.10, DeKalb County, Georgia",753,471,270,186,483,434
1500000US130890232103,130890232103,"Block Group 3, Census Tract 232.10, DeKalb County, Georgia",1792,647,1069,470,723,538
1500000US130890232104,130890232104,"Block Group 4, Census Tract 232.10, DeKalb County, Georgia",644,351,359,274,285,195
1500000US130890232105,130890232105,"Block Group 5, Census Tract 232.10, DeKalb County, Georgia",2029,517,209,132,1820,519
1500000US130890232111,130890232111,"Block Group 1, Census Tract 232.11, DeKalb County, Georgia",1483,339,1091,347,392,259
1500000US130890232112,130890232112,"Block Group 2, Census Tract 232.11, DeKalb County, Georgia",1528,287,763,257,765,255
1500000US130890232121,130890232121,"Block Group 1, Census Tract 232.12, DeKalb County, Georgia",1499,377,1084,274,415,347
1500000US130890232122,130890232122,"Block Group 2, Census Tract 232.12, DeKalb County, Georgia",2095,314,1218,271,877,262
1500000US130890232131,130890232131,"Block Group 1, Census Tract 232.13, DeKalb County, Georgia",1226,539,886,514,340,263
1500000US130890232132,130890232132,"Block Group 2, Census Tract 232.13, DeKalb County, Georgia",1502,581,1355,586,147,96
1500000US130890232133,130890232133,"Block Group 3, Census Tract 232.13, DeKalb County, Georgia",3186,716,1329,595,1857,732
1500000US130890232141,130890232141,"Block Group 1, Census Tract 232.14, DeKalb County, Georgia",3199,494,1609,455,1590,315
1500000US130890232142,130890232142,"Block Group 2, Census Tract 232.14, DeKalb County, Georgia",2887,676,1054,407,1833,667
1500000US130890233031,130890233031,"Block Group 1, Census Tract 233.03, DeKalb County, Georgia",3472,651,2582,508,890,571
1500000US130890233032,130890233032,"Block Group 2, Census Tract 233.03, DeKalb County, Georgia",809,266,458,189,351,199
1500000US130890233033,130890233033,"Block Group 3, Census Tract 233.03, DeKalb County, Georgia",960,346,357,200,603,281
1500000US130890233034,130890233034,"Block Group 4, Census Tract 233.03, DeKalb County, Georgia",1563,372,398,152,1165,354
1500000US130890233061,130890233061,"Block Group 1, Census Tract 233.06, DeKalb County, Georgia",2635,794,2155,787,480,388
1500000US130890233062,130890233062,"Block Group 2, Census Tract 233.06, DeKalb County, Georgia",2006,699,1547,673,459,441
1500000US130890233063,130890233063,"Block Group 3, Census Tract 233.06, DeKalb County, Georgia",2306,619,2082,640,224,170
1500000US130890233091,130890233091,"Block Group 1, Census Tract 233.09, DeKalb County, Georgia",1212,363,604,313,608,220
1500000US130890233092,130890233092,"Block Group 2, Census Tract 233.09, DeKalb County, Georgia",1890,562,1416,440,474,417
1500000US130890233093,130890233093,"Block Group 3, Census Tract 233.09, DeKalb County, Georgia",4417,836,2397,725,2020,755
1500000US130890233094,130890233094,"Block Group 4, Census Tract 233.09, DeKalb County, Georgia",1911,565,1434,553,477,278
1500000US130890233101,130890233101,"Block Group 1, Census Tract 233.10, DeKalb County, Georgia",2315,699,635,301,1680,660
1500000US130890233102,130890233102,"Block Group 2, Census Tract 233.10, DeKalb County, Georgia",3920,836,792,357,3128,787
1500000US130890233103,130890233103,"Block Group 3, Census Tract 233.10, DeKalb County, Georgia",1788,605,0,13,1788,605
1500000US130890233104,130890233104,"Block Group 4, Census Tract 233.10, DeKalb County, Georgia",1339,407,543,313,796,307
1500000US130890233111,130890233111,"Block Group 1, Census Tract 233.11, DeKalb County, Georgia",3090,479,2495,479,595,504
1500000US130890233112,130890233112,"Block Group 2, Census Tract 233.11, DeKalb County, Georgia",1899,538,840,280,1059,574
1500000US130890233121,130890233121,"Block Group 1, Census Tract 233.12, DeKalb County, Georgia",3860,697,3343,694,517,400
1500000US130890233122,130890233122,"Block Group 2, Census Tract 233.12, DeKalb County, Georgia",2905,813,2198,557,707,639
1500000US130890233123,130890233123,"Block Group 3, Census Tract 233.12, DeKalb County, Georgia",2397,807,1440,575,957,718
1500000US130890233131,130890233131,"Block Group 1, Census Tract 233.13, DeKalb County, Georgia",1918,347,1204,317,714,251
1500000US130890233132,130890233132,"Block Group 2, Census Tract 233.13, DeKalb County, Georgia",3001,503,2395,489,606,404
1500000US130890233141,130890233141,"Block Group 1, Census Tract 233.14, DeKalb County, Georgia",1630,456,1169,357,461,430
1500000US130890233142,130890233142,"Block Group 2, Census Tract 233.14, DeKalb County, Georgia",2020,441,1439,435,581,340
1500000US130890233143,130890233143,"Block Group 3, Census Tract 233.14, DeKalb County, Georgia",1419,399,1037,384,382,249
1500000US130890233151,130890233151,"Block Group 1, Census Tract 233.15, DeKalb County, Georgia",3177,460,2815,482,362,266
1500000US130890233152,130890233152,"Block Group 2, Census Tract 233.15, DeKalb County, Georgia",1538,518,1312,499,226,206
1500000US130890233161,130890233161,"Block Group 1, Census Tract 233.16, DeKalb County, Georgia",2897,552,2563,481,334,424
1500000US130890233162,130890233162,"Block Group 2, Census Tract 233.16, DeKalb County, Georgia",3482,908,2408,749,1074,601
1500000US130890233163,130890233163,"Block Group 3, Census Tract 233.16, DeKalb County, Georgia",1652,602,1053,524,599,426
1500000US130890234101,130890234101,"Block Group 1, Census Tract 234.10, DeKalb County, Georgia",1417,304,85,82,1332,287
1500000US130890234102,130890234102,"Block Group 2, Census Tract 234.10, DeKalb County, Georgia",1715,325,984,306,731,231
1500000US130890234111,130890234111,"Block Group 1, Census Tract 234.11, DeKalb County, Georgia",1916,452,1236,318,680,374
1500000US130890234112,130890234112,"Block Group 2, Census Tract 234.11, DeKalb County, Georgia",2031,327,1324,324,707,223
1500000US130890234121,130890234121,"Block Group 1, Census Tract 234.12, DeKalb County, Georgia",2013,690,953,398,1060,621
1500000US130890234122,130890234122,"Block Group 2, Census Tract 234.12, DeKalb County, Georgia",1803,578,1250,310,553,630
1500000US130890234123,130890234123,"Block Group 3, Census Tract 234.12, DeKalb County, Georgia",2646,864,2161,708,485,601
1500000US130890234131,130890234131,"Block Group 1, Census Tract 234.13, DeKalb County, Georgia",1703,473,1531,468,172,95
1500000US130890234132,130890234132,"Block Group 2, Census Tract 234.13, DeKalb County, Georgia",1699,258,1414,279,285,206
1500000US130890234141,130890234141,"Block Group 1, Census Tract 234.14, DeKalb County, Georgia",2144,705,1032,532,1112,506
1500000US130890234142,130890234142,"Block Group 2, Census Tract 234.14, DeKalb County, Georgia",1221,419,1097,412,124,169
1500000US130890234143,130890234143,"Block Group 3, Census Tract 234.14, DeKalb County, Georgia",3084,704,2555,538,529,529
1500000US130890234161,130890234161,"Block Group 1, Census Tract 234.16, DeKalb County, Georgia",1974,652,562,361,1412,615
1500000US130890234162,130890234162,"Block Group 2, Census Tract 234.16, DeKalb County, Georgia",2798,645,1715,589,1083,619
1500000US130890234163,130890234163,"Block Group 3, Census Tract 234.16, DeKalb County, Georgia",1563,465,1229,454,334,223
1500000US130890234164,130890234164,"Block Group 4, Census Tract 234.16, DeKalb County, Georgia",1555,402,1372,388,183,265
1500000US130890234181,130890234181,"Block Group 1, Census Tract 234.18, DeKalb County, Georgia",6274,1681,1859,1337,4415,1393
1500000US130890234182,130890234182,"Block Group 2, Census Tract 234.18, DeKalb County, Georgia",3318,1164,3019,1155,299,280
1500000US130890234183,130890234183,"Block Group 3, Census Tract 234.18, DeKalb County, Georgia",3741,1554,3016,1161,725,1024
1500000US130890234184,130890234184,"Block Group 4, Census Tract 234.18, DeKalb County, Georgia",5964,1780,4090,1444,1874,1809
1500000US130890234191,130890234191,"Block Group 1, Census Tract 234.19, DeKalb County, Georgia",6061,1013,5135,1026,926,533
1500000US130890234192,130890234192,"Block Group 2, Census Tract 234.19, DeKalb County, Georgia",1448,465,1362,459,86,100
1500000US130890234193,130890234193,"Block Group 3, Census Tract 234.19, DeKalb County, Georgia",1960,682,1567,755,393,365
1500000US130890234211,130890234211,"Block Group 1, Census Tract 234.21, DeKalb County, Georgia",3051,732,461,358,2590,678
1500000US130890234212,130890234212,"Block Group 2, Census Tract 234.21, DeKalb County, Georgia",1167,476,817,449,350,275
1500000US130890234213,130890234213,"Block Group 3, Census Tract 234.21, DeKalb County, Georgia",3567,690,1671,417,1896,634
1500000US130890234221,130890234221,"Block Group 1, Census Tract 234.22, DeKalb County, Georgia",1762,431,1639,405,123,177
1500000US130890234222,130890234222,"Block Group 2, Census Tract 234.22, DeKalb County, Georgia",3171,488,2439,468,732,293
1500000US130890234231,130890234231,"Block Group 1, Census Tract 234.23, DeKalb County, Georgia",2794,550,2738,550,56,68
1500000US130890234232,130890234232,"Block Group 2, Census Tract 234.23, DeKalb County, Georgia",1325,520,1148,486,177,281
1500000US130890234233,130890234233,"Block Group 3, Census Tract 234.23, DeKalb County, Georgia",3337,619,2273,543,1064,515
1500000US130890234241,130890234241,"Block Group 1, Census Tract 234.24, DeKalb County, Georgia",4005,619,3517,625,488,394
1500000US130890234242,130890234242,"Block Group 2, Census Tract 234.24, DeKalb County, Georgia",1884,539,1275,473,609,373
1500000US130890234251,130890234251,"Block Group 1, Census Tract 234.25, DeKalb County, Georgia",2349,524,2058,549,291,312
1500000US130890234252,130890234252,"Block Group 2, Census Tract 234.25, DeKalb County, Georgia",3424,754,2255,637,1169,517
1500000US130890234261,130890234261,"Block Group 1, Census Tract 234.26, DeKalb County, Georgia",2614,407,2243,410,371,285
1500000US130890234262,130890234262,"Block Group 2, Census Tract 234.26, DeKalb County, Georgia",2206,439,1640,530,566,347
1500000US130890234271,130890234271,"Block Group 1, Census Tract 234.27, DeKalb County, Georgia",2099,311,1615,336,484,277
1500000US130890234272,130890234272,"Block Group 2, Census Tract 234.27, DeKalb County, Georgia",732,197,655,186,77,86
1500000US130890234281,130890234281,"Block Group 1, Census Tract 234.28, DeKalb County, Georgia",831,427,125,92,706,443
1500000US130890234282,130890234282,"Block Group 2, Census Tract 234.28, DeKalb County, Georgia",2659,652,758,417,1901,636
1500000US130890234283,130890234283,"Block Group 3, Census Tract 234.28, DeKalb County, Georgia",4534,789,1186,443,3348,741
1500000US130890234284,130890234284,"Block Group 4, Census Tract 234.28, DeKalb County, Georgia",1675,607,429,307,1246,588
1500000US130890235011,130890235011,"Block Group 1, Census Tract 235.01, DeKalb County, Georgia",1472,574,530,215,942,547
1500000US130890235012,130890235012,"Block Group 2, Census Tract 235.01, DeKalb County, Georgia",1786,347,586,172,1200,338
1500000US130890235041,130890235041,"Block Group 1, Census Tract 235.04, DeKalb County, Georgia",782,246,573,234,209,112
1500000US130890235042,130890235042,"Block Group 2, Census Tract 235.04, DeKalb County, Georgia",687,172,249,145,438,188
1500000US130890235043,130890235043,"Block Group 3, Census Tract 235.04, DeKalb County, Georgia",1555,460,137,93,1418,469
1500000US130890235051,130890235051,"Block Group 1, Census Tract 235.05, DeKalb County, Georgia",1278,219,750,190,528,231
1500000US130890235052,130890235052,"Block Group 2, Census Tract 235.05, DeKalb County, Georgia",1188,294,934,222,254,163
1500000US130890235061,130890235061,"Block Group 1, Census Tract 235.06, DeKalb County, Georgia",2137,545,805,325,1332,573
1500000US130890235062,130890235062,"Block Group 2, Census Tract 235.06, DeKalb County, Georgia",1831,462,1424,464,407,280
1500000US130890235063,130890235063,"Block Group 3, Census Tract 235.06, DeKalb County, Georgia",1767,509,1385,400,382,406
1500000US130890235071,130890235071,"Block Group 1, Census Tract 235.07, DeKalb County, Georgia",1109,297,400,116,709,318
1500000US130890235072,130890235072,"Block Group 2, Census Tract 235.07, DeKalb County, Georgia",1018,316,787,320,231,160
1500000US130890235073,130890235073,"Block Group 3, Census Tract 235.07, DeKalb County, Georgia",1738,357,1463,295,275,239
1500000US130890236011,130890236011,"Block Group 1, Census Tract 236.01, DeKalb County, Georgia",1018,237,706,232,312,188
1500000US130890236012,130890236012,"Block Group 2, Census Tract 236.01, DeKalb County, Georgia",1208,301,896,334,312,203
1500000US130890236013,130890236013,"Block Group 3, Census Tract 236.01, DeKalb County, Georgia",873,352,470,280,403,299
1500000US130890236021,130890236021,"Block Group 1, Census Tract 236.02, DeKalb County, Georgia",1000,261,645,149,355,241
1500000US130890236022,130890236022,"Block Group 2, Census Tract 236.02, DeKalb County, Georgia",1591,280,942,173,649,267
1500000US130890236031,130890236031,"Block Group 1, Census Tract 236.03, DeKalb County, Georgia",1622,427,995,251,627,346
1500000US130890236032,130890236032,"Block Group 2, Census Tract 236.03, DeKalb County, Georgia",1747,334,754,232,993,314
1500000US130890237001,130890237001,"Block Group 1, Census Tract 237, DeKalb County, Georgia",1736,422,552,208,1184,439
1500000US130890237002,130890237002,"Block Group 2, Census Tract 237, DeKalb County, Georgia",1343,452,848,349,495,353
1500000US130890237003,130890237003,"Block Group 3, Census Tract 237, DeKalb County, Georgia",1469,485,310,138,1159,488
1500000US130890237004,130890237004,"Block Group 4, Census Tract 237, DeKalb County, Georgia",1147,501,332,173,815,512
1500000US130890238011,130890238011,"Block Group 1, Census Tract 238.01, DeKalb County, Georgia",675,224,551,201,124,90
1500000US130890238012,130890238012,"Block Group 2, Census Tract 238.01, DeKalb County, Georgia",1642,335,960,315,682,249
1500000US130890238013,130890238013,"Block Group 3, Census Tract 238.01, DeKalb County, Georgia",1261,277,1021,218,240,193
1500000US130890238021,130890238021,"Block Group 1, Census Tract 238.02, DeKalb County, Georgia",1309,471,530,368,779,293
1500000US130890238022,130890238022,"Block Group 2, Census Tract 238.02, DeKalb County, Georgia",2413,446,895,308,1518,423
1500000US130890238031,130890238031,"Block Group 1, Census Tract 238.03, DeKalb County, Georgia",1131,338,757,283,374,198
1500000US130890238032,130890238032,"Block Group 2, Census Tract 238.03, DeKalb County, Georgia",804,305,520,255,284,202
1500000US130890238033,130890238033,"Block Group 3, Census Tract 238.03, DeKalb County, Georgia",1672,396,1046,301,626,309
1500000US130890238034,130890238034,"Block Group 4, Census Tract 238.03, DeKalb County, Georgia",1708,385,1257,355,451,314
1500000US130899800001,130899800001,"Block Group 1, Census Tract 9800, DeKalb County, Georgia",0,13,0,13,0,13
1500000US130919601001,130919601001,"Block Group 1, Census Tract 9601, Dodge County, Georgia",1097,193,769,163,328,113
1500000US130919601002,130919601002,"Block Group 2, Census Tract 9601, Dodge County, Georgia",874,194,741,160,133,109
1500000US130919602001,130919602001,"Block Group 1, Census Tract 9602, Dodge County, Georgia",1736,284,1260,255,476,253
1500000US130919602002,130919602002,"Block Group 2, Census Tract 9602, Dodge County, Georgia",805,310,506,215,299,261
1500000US130919602003,130919602003,"Block Group 3, Census Tract 9602, Dodge County, Georgia",577,239,284,134,293,215
1500000US130919603001,130919603001,"Block Group 1, Census Tract 9603, Dodge County, Georgia",1583,375,1163,358,420,260
1500000US130919603002,130919603002,"Block Group 2, Census Tract 9603, Dodge County, Georgia",1463,461,719,257,744,428
1500000US130919603003,130919603003,"Block Group 3, Census Tract 9603, Dodge County, Georgia",890,346,581,274,309,246
1500000US130919603004,130919603004,"Block Group 4, Census Tract 9603, Dodge County, Georgia",1059,391,1059,391,0,13
1500000US130919603005,130919603005,"Block Group 5, Census Tract 9603, Dodge County, Georgia",1261,385,649,319,612,292
1500000US130919604001,130919604001,"Block Group 1, Census Tract 9604, Dodge County, Georgia",872,247,372,154,500,235
1500000US130919604002,130919604002,"Block Group 2, Census Tract 9604, Dodge County, Georgia",1365,271,779,268,586,190
1500000US130919604003,130919604003,"Block Group 3, Census Tract 9604, Dodge County, Georgia",1280,305,577,273,703,256
1500000US130919605001,130919605001,"Block Group 1, Census Tract 9605, Dodge County, Georgia",1046,213,762,188,284,137
1500000US130919605002,130919605002,"Block Group 2, Census Tract 9605, Dodge County, Georgia",1128,203,880,203,248,105
1500000US130919606001,130919606001,"Block Group 1, Census Tract 9606, Dodge County, Georgia",1031,187,745,172,286,155
1500000US130919606002,130919606002,"Block Group 2, Census Tract 9606, Dodge County, Georgia",913,205,716,193,197,87
1500000US130939701001,130939701001,"Block Group 1, Census Tract 9701, Dooly County, Georgia",1667,450,1304,395,363,238
1500000US130939701002,130939701002,"Block Group 2, Census Tract 9701, Dooly County, Georgia",1732,381,947,289,785,304
1500000US130939701003,130939701003,"Block Group 3, Census Tract 9701, Dooly County, Georgia",681,170,544,163,137,82
1500000US130939702001,130939702001,"Block Group 1, Census Tract 9702, Dooly County, Georgia",790,183,469,159,321,136
1500000US130939702002,130939702002,"Block Group 2, Census Tract 9702, Dooly County, Georgia",1244,268,1048,238,196,80
1500000US130939703001,130939703001,"Block Group 1, Census Tract 9703, Dooly County, Georgia",1994,436,1215,337,779,315
1500000US130939703002,130939703002,"Block Group 2, Census Tract 9703, Dooly County, Georgia",1611,434,793,292,818,413
1500000US130939703003,130939703003,"Block Group 3, Census Tract 9703, Dooly County, Georgia",2021,541,1426,477,595,305
1500000US130939703004,130939703004,"Block Group 4, Census Tract 9703, Dooly County, Georgia",879,451,379,181,500,429
1500000US130950001001,130950001001,"Block Group 1, Census Tract 1, Dougherty County, Georgia",878,419,674,391,204,205
1500000US130950001002,130950001002,"Block Group 2, Census Tract 1, Dougherty County, Georgia",366,216,130,135,236,177
1500000US130950001003,130950001003,"Block Group 3, Census Tract 1, Dougherty County, Georgia",970,419,186,120,784,407
1500000US130950001004,130950001004,"Block Group 4, Census Tract 1, Dougherty County, Georgia",1421,400,229,210,1192,384
1500000US130950001005,130950001005,"Block Group 5, Census Tract 1, Dougherty County, Georgia",895,403,442,307,453,280
1500000US130950002001,130950002001,"Block Group 1, Census Tract 2, Dougherty County, Georgia",785,332,163,130,622,317
1500000US130950002002,130950002002,"Block Group 2, Census Tract 2, Dougherty County, Georgia",291,158,96,78,195,136
1500000US130950002003,130950002003,"Block Group 3, Census Tract 2, Dougherty County, Georgia",1328,418,441,259,887,371
1500000US130950002004,130950002004,"Block Group 4, Census Tract 2, Dougherty County, Georgia",540,291,133,90,407,286
1500000US130950004001,130950004001,"Block Group 1, Census Tract 4, Dougherty County, Georgia",1354,407,349,146,1005,392
1500000US130950004002,130950004002,"Block Group 2, Census Tract 4, Dougherty County, Georgia",2320,568,574,162,1746,547
1500000US130950004003,130950004003,"Block Group 3, Census Tract 4, Dougherty County, Georgia",2324,467,410,132,1914,485
1500000US130950005011,130950005011,"Block Group 1, Census Tract 5.01, Dougherty County, Georgia",3564,573,1743,433,1821,525
1500000US130950005012,130950005012,"Block Group 2, Census Tract 5.01, Dougherty County, Georgia",1511,241,682,197,829,187
1500000US130950005021,130950005021,"Block Group 1, Census Tract 5.02, Dougherty County, Georgia",1752,293,1025,207,727,238
1500000US130950005022,130950005022,"Block Group 2, Census Tract 5.02, Dougherty County, Georgia",1500,316,1224,248,276,238
1500000US130950005023,130950005023,"Block Group 3, Census Tract 5.02, Dougherty County, Georgia",677,278,653,276,24,36
1500000US130950005024,130950005024,"Block Group 4, Census Tract 5.02, Dougherty County, Georgia",969,189,838,184,131,110
1500000US130950006001,130950006001,"Block Group 1, Census Tract 6, Dougherty County, Georgia",1284,333,660,210,624,316
1500000US130950006002,130950006002,"Block Group 2, Census Tract 6, Dougherty County, Georgia",1661,344,207,97,1454,347
1500000US130950007001,130950007001,"Block Group 1, Census Tract 7, Dougherty County, Georgia",1903,244,819,183,1084,276
1500000US130950008001,130950008001,"Block Group 1, Census Tract 8, Dougherty County, Georgia",889,218,55,36,834,220
1500000US130950008002,130950008002,"Block Group 2, Census Tract 8, Dougherty County, Georgia",541,133,96,61,445,137
1500000US130950009001,130950009001,"Block Group 1, Census Tract 9, Dougherty County, Georgia",1030,198,308,151,722,171
1500000US130950009002,130950009002,"Block Group 2, Census Tract 9, Dougherty County, Georgia",1020,193,282,102,738,190
1500000US130950010001,130950010001,"Block Group 1, Census Tract 10, Dougherty County, Georgia",512,209,148,67,364,214
1500000US130950010002,130950010002,"Block Group 2, Census Tract 10, Dougherty County, Georgia",1567,301,286,140,1281,286
1500000US130950011001,130950011001,"Block Group 1, Census Tract 11, Dougherty County, Georgia",1513,547,40,76,1473,541
1500000US130950011002,130950011002,"Block Group 2, Census Tract 11, Dougherty County, Georgia",1110,643,488,248,622,585
1500000US130950011003,130950011003,"Block Group 3, Census Tract 11, Dougherty County, Georgia",907,293,370,269,537,261
1500000US130950011004,130950011004,"Block Group 4, Census Tract 11, Dougherty County, Georgia",1086,301,403,165,683,302
1500000US130950011005,130950011005,"Block Group 5, Census Tract 11, Dougherty County, Georgia",1501,527,873,320,628,464
1500000US130950014031,130950014031,"Block Group 1, Census Tract 14.03, Dougherty County, Georgia",1081,244,158,134,923,229
1500000US130950014032,130950014032,"Block Group 2, Census Tract 14.03, Dougherty County, Georgia",1399,315,483,184,916,310
1500000US130950015001,130950015001,"Block Group 1, Census Tract 15, Dougherty County, Georgia",693,373,110,68,583,364
1500000US130950015002,130950015002,"Block Group 2, Census Tract 15, Dougherty County, Georgia",1164,371,447,182,717,345
1500000US130950015003,130950015003,"Block Group 3, Census Tract 15, Dougherty County, Georgia",920,315,111,113,809,298
1500000US130950103021,130950103021,"Block Group 1, Census Tract 103.02, Dougherty County, Georgia",805,277,385,164,420,285
1500000US130950103022,130950103022,"Block Group 2, Census Tract 103.02, Dougherty County, Georgia",1092,305,160,94,932,296
1500000US130950103023,130950103023,"Block Group 3, Census Tract 103.02, Dougherty County, Georgia",758,309,504,299,254,153
1500000US130950103024,130950103024,"Block Group 4, Census Tract 103.02, Dougherty County, Georgia",712,207,349,147,363,221
1500000US130950103025,130950103025,"Block Group 5, Census Tract 103.02, Dougherty County, Georgia",1579,446,190,87,1389,455
1500000US130950104011,130950104011,"Block Group 1, Census Tract 104.01, Dougherty County, Georgia",2220,338,1884,358,336,240
1500000US130950104012,130950104012,"Block Group 2, Census Tract 104.01, Dougherty County, Georgia",3110,615,2117,462,993,469
1500000US130950104013,130950104013,"Block Group 3, Census Tract 104.01, Dougherty County, Georgia",2071,512,2017,535,54,76
1500000US130950104021,130950104021,"Block Group 1, Census Tract 104.02, Dougherty County, Georgia",3026,352,1731,369,1295,289
1500000US130950104031,130950104031,"Block Group 1, Census Tract 104.03, Dougherty County, Georgia",1581,185,1230,156,351,143
1500000US130950105001,130950105001,"Block Group 1, Census Tract 105, Dougherty County, Georgia",1579,307,1058,223,521,258
1500000US130950105002,130950105002,"Block Group 2, Census Tract 105, Dougherty County, Georgia",754,179,704,176,50,53
1500000US130950106011,130950106011,"Block Group 1, Census Tract 106.01, Dougherty County, Georgia",1181,250,293,109,888,251
1500000US130950106012,130950106012,"Block Group 2, Census Tract 106.01, Dougherty County, Georgia",1270,254,269,97,1001,244
1500000US130950106021,130950106021,"Block Group 1, Census Tract 106.02, Dougherty County, Georgia",2050,402,1196,260,854,409
1500000US130950106022,130950106022,"Block Group 2, Census Tract 106.02, Dougherty County, Georgia",1942,331,1102,272,840,304
1500000US130950107001,130950107001,"Block Group 1, Census Tract 107, Dougherty County, Georgia",3135,649,755,351,2380,648
1500000US130950107002,130950107002,"Block Group 2, Census Tract 107, Dougherty County, Georgia",949,350,264,137,685,317
1500000US130950107003,130950107003,"Block Group 3, Census Tract 107, Dougherty County, Georgia",1243,413,73,62,1170,417
1500000US130950109001,130950109001,"Block Group 1, Census Tract 109, Dougherty County, Georgia",1074,222,848,219,226,107
1500000US130950109002,130950109002,"Block Group 2, Census Tract 109, Dougherty County, Georgia",581,167,483,163,98,77
1500000US130950109003,130950109003,"Block Group 3, Census Tract 109, Dougherty County, Georgia",21,27,21,27,0,13
1500000US130950110001,130950110001,"Block Group 1, Census Tract 110, Dougherty County, Georgia",1294,247,1285,247,9,13
1500000US130950110002,130950110002,"Block Group 2, Census Tract 110, Dougherty County, Georgia",1225,200,1013,202,212,119
1500000US130950112001,130950112001,"Block Group 1, Census Tract 112, Dougherty County, Georgia",871,210,737,203,134,82
1500000US130950112002,130950112002,"Block Group 2, Census Tract 112, Dougherty County, Georgia",1344,394,613,184,731,351
1500000US130950112003,130950112003,"Block Group 3, Census Tract 112, Dougherty County, Georgia",1151,407,806,396,345,152
1500000US130950113001,130950113001,"Block Group 1, Census Tract 113, Dougherty County, Georgia",2151,260,700,192,1451,274
1500000US130950114001,130950114001,"Block Group 1, Census Tract 114, Dougherty County, Georgia",1260,220,301,114,959,221
1500000US130950114002,130950114002,"Block Group 2, Census Tract 114, Dougherty County, Georgia",168,58,26,33,142,52
1500000US130950116001,130950116001,"Block Group 1, Census Tract 116, Dougherty County, Georgia",1547,306,1290,296,257,173
1500000US130950116002,130950116002,"Block Group 2, Census Tract 116, Dougherty County, Georgia",417,250,65,86,352,238
1500000US130970801021,130970801021,"Block Group 1, Census Tract 801.02, Douglas County, Georgia",1889,650,1029,367,860,612
1500000US130970801022,130970801022,"Block Group 2, Census Tract 801.02, Douglas County, Georgia",5492,720,2039,720,3453,774
1500000US130970801031,130970801031,"Block Group 1, Census Tract 801.03, Douglas County, Georgia",1459,490,0,13,1459,490
1500000US130970801032,130970801032,"Block Group 2, Census Tract 801.03, Douglas County, Georgia",1623,541,1056,438,567,362
1500000US130970801033,130970801033,"Block Group 3, Census Tract 801.03, Douglas County, Georgia",1094,393,0,13,1094,393
1500000US130970801034,130970801034,"Block Group 4, Census Tract 801.03, Douglas County, Georgia",2769,789,1196,558,1573,783
1500000US130970802011,130970802011,"Block Group 1, Census Tract 802.01, Douglas County, Georgia",750,325,733,327,17,27
1500000US130970802012,130970802012,"Block Group 2, Census Tract 802.01, Douglas County, Georgia",3179,752,2221,605,958,521
1500000US130970802013,130970802013,"Block Group 3, Census Tract 802.01, Douglas County, Georgia",1873,567,1715,551,158,171
1500000US130970802021,130970802021,"Block Group 1, Census Tract 802.02, Douglas County, Georgia",846,295,660,278,186,145
1500000US130970802022,130970802022,"Block Group 2, Census Tract 802.02, Douglas County, Georgia",2596,750,1319,585,1277,594
1500000US130970802023,130970802023,"Block Group 3, Census Tract 802.02, Douglas County, Georgia",3964,763,2776,593,1188,563
1500000US130970802024,130970802024,"Block Group 4, Census Tract 802.02, Douglas County, Georgia",2840,793,1882,728,958,566
1500000US130970803011,130970803011,"Block Group 1, Census Tract 803.01, Douglas County, Georgia",3349,770,2436,686,913,553
1500000US130970803012,130970803012,"Block Group 2, Census Tract 803.01, Douglas County, Georgia",3464,819,1727,713,1737,811
1500000US130970803013,130970803013,"Block Group 3, Census Tract 803.01, Douglas County, Georgia",3691,1021,1866,771,1825,689
1500000US130970803014,130970803014,"Block Group 4, Census Tract 803.01, Douglas County, Georgia",1798,555,1429,554,369,314
1500000US130970803031,130970803031,"Block Group 1, Census Tract 803.03, Douglas County, Georgia",2909,490,1208,327,1701,396
1500000US130970803032,130970803032,"Block Group 2, Census Tract 803.03, Douglas County, Georgia",950,251,816,252,134,166
1500000US130970803041,130970803041,"Block Group 1, Census Tract 803.04, Douglas County, Georgia",1110,334,439,227,671,236
1500000US130970803042,130970803042,"Block Group 2, Census Tract 803.04, Douglas County, Georgia",3370,517,1283,385,2087,499
1500000US130970804021,130970804021,"Block Group 1, Census Tract 804.02, Douglas County, Georgia",1678,472,1447,388,231,315
1500000US130970804022,130970804022,"Block Group 2, Census Tract 804.02, Douglas County, Georgia",3139,546,3104,550,35,57
1500000US130970804023,130970804023,"Block Group 3, Census Tract 804.02, Douglas County, Georgia",3313,486,3051,526,262,175
1500000US130970804031,130970804031,"Block Group 1, Census Tract 804.03, Douglas County, Georgia",3515,480,3201,514,314,210
1500000US130970804032,130970804032,"Block Group 2, Census Tract 804.03, Douglas County, Georgia",1375,404,947,385,428,295
1500000US130970804041,130970804041,"Block Group 1, Census Tract 804.04, Douglas County, Georgia",2284,684,1625,631,659,506
1500000US130970804042,130970804042,"Block Group 2, Census Tract 804.04, Douglas County, Georgia",970,420,914,403,56,91
1500000US130970804043,130970804043,"Block Group 3, Census Tract 804.04, Douglas County, Georgia",5345,512,4268,595,1077,534
1500000US130970805051,130970805051,"Block Group 1, Census Tract 805.05, Douglas County, Georgia",3285,584,1846,554,1439,332
1500000US130970805052,130970805052,"Block Group 2, Census Tract 805.05, Douglas County, Georgia",1568,265,1270,274,298,176
1500000US130970805061,130970805061,"Block Group 1, Census Tract 805.06, Douglas County, Georgia",1249,353,743,278,506,379
1500000US130970805062,130970805062,"Block Group 2, Census Tract 805.06, Douglas County, Georgia",2091,410,1625,375,466,269
1500000US130970805063,130970805063,"Block Group 3, Census Tract 805.06, Douglas County, Georgia",1898,532,1686,518,212,204
1500000US130970805071,130970805071,"Block Group 1, Census Tract 805.07, Douglas County, Georgia",2699,285,1709,326,990,368
1500000US130970805072,130970805072,"Block Group 2, Census Tract 805.07, Douglas County, Georgia",976,247,846,235,130,139
1500000US130970805081,130970805081,"Block Group 1, Census Tract 805.08, Douglas County, Georgia",1607,483,1017,411,590,344
1500000US130970805082,130970805082,"Block Group 2, Census Tract 805.08, Douglas County, Georgia",2117,508,391,160,1726,490
1500000US130970805083,130970805083,"Block Group 3, Census Tract 805.08, Douglas County, Georgia",1485,428,953,405,532,327
1500000US130970805091,130970805091,"Block Group 1, Census Tract 805.09, Douglas County, Georgia",2040,466,1544,391,496,350
1500000US130970805092,130970805092,"Block Group 2, Census Tract 805.09, Douglas County, Georgia",2569,477,2320,490,249,194
1500000US130970805093,130970805093,"Block Group 3, Census Tract 805.09, Douglas County, Georgia",1141,408,823,386,318,263
1500000US130970805101,130970805101,"Block Group 1, Census Tract 805.10, Douglas County, Georgia",2247,611,2159,622,88,135
1500000US130970805102,130970805102,"Block Group 2, Census Tract 805.10, Douglas County, Georgia",3193,700,2302,581,891,497
1500000US130970805103,130970805103,"Block Group 3, Census Tract 805.10, Douglas County, Georgia",2265,570,2133,565,132,166
1500000US130970805111,130970805111,"Block Group 1, Census Tract 805.11, Douglas County, Georgia",3811,682,3562,681,249,191
1500000US130970805112,130970805112,"Block Group 2, Census Tract 805.11, Douglas County, Georgia",5071,537,4328,734,743,400
1500000US130970806021,130970806021,"Block Group 1, Census Tract 806.02, Douglas County, Georgia",3339,425,2825,399,514,294
1500000US130970806022,130970806022,"Block Group 2, Census Tract 806.02, Douglas County, Georgia",2241,418,1491,386,750,334
1500000US130970806031,130970806031,"Block Group 1, Census Tract 806.03, Douglas County, Georgia",3187,731,2541,590,646,535
1500000US130970806032,130970806032,"Block Group 2, Census Tract 806.03, Douglas County, Georgia",2794,799,1828,694,966,539
1500000US130970806041,130970806041,"Block Group 1, Census Tract 806.04, Douglas County, Georgia",825,349,628,283,197,229
1500000US130970806042,130970806042,"Block Group 2, Census Tract 806.04, Douglas County, Georgia",5482,740,4946,790,536,346
1500000US130970806043,130970806043,"Block Group 3, Census Tract 806.04, Douglas County, Georgia",1955,517,1350,458,605,336
1500000US130970806044,130970806044,"Block Group 4, Census Tract 806.04, Douglas County, Georgia",1444,585,1137,498,307,319
1500000US130990901001,130990901001,"Block Group 1, Census Tract 901, Early County, Georgia",578,162,412,123,166,93
1500000US130990901002,130990901002,"Block Group 2, Census Tract 901, Early County, Georgia",802,205,666,182,136,88
1500000US130990902001,130990902001,"Block Group 1, Census Tract 902, Early County, Georgia",629,267,270,157,359,221
1500000US130990902002,130990902002,"Block Group 2, Census Tract 902, Early County, Georgia",614,207,252,138,362,189
1500000US130990902003,130990902003,"Block Group 3, Census Tract 902, Early County, Georgia",746,212,555,206,191,123
1500000US130990902004,130990902004,"Block Group 4, Census Tract 902, Early County, Georgia",421,135,263,103,158,116
1500000US130990903001,130990903001,"Block Group 1, Census Tract 903, Early County, Georgia",905,164,627,137,278,117
1500000US130990903002,130990903002,"Block Group 2, Census Tract 903, Early County, Georgia",589,167,516,168,73,49
1500000US130990904001,130990904001,"Block Group 1, Census Tract 904, Early County, Georgia",1221,246,625,253,596,197
1500000US130990904002,130990904002,"Block Group 2, Census Tract 904, Early County, Georgia",1003,306,741,245,262,170
1500000US130990904003,130990904003,"Block Group 3, Census Tract 904, Early County, Georgia",1063,265,601,210,462,240
1500000US130990905001,130990905001,"Block Group 1, Census Tract 905, Early County, Georgia",702,151,686,148,16,18
1500000US130990905002,130990905002,"Block Group 2, Census Tract 905, Early County, Georgia",1147,188,645,183,502,167
1500000US131018801001,131018801001,"Block Group 1, Census Tract 8801, Echols County, Georgia",1662,197,1122,227,540,185
1500000US131018802001,131018802001,"Block Group 1, Census Tract 8802, Echols County, Georgia",820,231,400,133,420,202
1500000US131018802002,131018802002,"Block Group 2, Census Tract 8802, Echols County, Georgia",1566,264,1113,258,453,214
1500000US131030301001,131030301001,"Block Group 1, Census Tract 301, Effingham County, Georgia",1927,358,1436,320,491,376
1500000US131030301002,131030301002,"Block Group 2, Census Tract 301, Effingham County, Georgia",580,169,548,171,32,31
1500000US131030301003,131030301003,"Block Group 3, Census Tract 301, Effingham County, Georgia",907,289,654,226,253,201
1500000US131030302021,131030302021,"Block Group 1, Census Tract 302.02, Effingham County, Georgia",1732,414,1542,427,190,126
1500000US131030302022,131030302022,"Block Group 2, Census Tract 302.02, Effingham County, Georgia",4024,474,2961,460,1063,284
1500000US131030302031,131030302031,"Block Group 1, Census Tract 302.03, Effingham County, Georgia",792,315,589,293,203,122
1500000US131030302032,131030302032,"Block Group 2, Census Tract 302.03, Effingham County, Georgia",4667,595,3409,579,1258,392
1500000US131030302033,131030302033,"Block Group 3, Census Tract 302.03, Effingham County, Georgia",2309,479,1769,442,540,302
1500000US131030302041,131030302041,"Block Group 1, Census Tract 302.04, Effingham County, Georgia",2014,460,1138,354,876,493
1500000US131030302042,131030302042,"Block Group 2, Census Tract 302.04, Effingham County, Georgia",1933,301,1571,255,362,190
1500000US131030303011,131030303011,"Block Group 1, Census Tract 303.01, Effingham County, Georgia",2547,454,2526,456,21,32
1500000US131030303012,131030303012,"Block Group 2, Census Tract 303.01, Effingham County, Georgia",2086,384,1865,412,221,150
1500000US131030303031,131030303031,"Block Group 1, Census Tract 303.03, Effingham County, Georgia",2333,264,1743,350,590,253
1500000US131030303041,131030303041,"Block Group 1, Census Tract 303.04, Effingham County, Georgia",2875,669,2197,715,678,433
1500000US131030303042,131030303042,"Block Group 2, Census Tract 303.04, Effingham County, Georgia",2782,555,2146,532,636,318
1500000US131030303043,131030303043,"Block Group 3, Census Tract 303.04, Effingham County, Georgia",1694,533,802,299,892,486
1500000US131030303051,131030303051,"Block Group 1, Census Tract 303.05, Effingham County, Georgia",2762,771,1948,676,814,341
1500000US131030303052,131030303052,"Block Group 2, Census Tract 303.05, Effingham County, Georgia",5303,675,3791,745,1512,392
1500000US131030304011,131030304011,"Block Group 1, Census Tract 304.01, Effingham County, Georgia",2065,514,1915,516,150,108
1500000US131030304012,131030304012,"Block Group 2, Census Tract 304.01, Effingham County, Georgia",3017,581,2522,553,495,398
1500000US131030304021,131030304021,"Block Group 1, Census Tract 304.02, Effingham County, Georgia",3275,524,2813,499,462,300
1500000US131030304022,131030304022,"Block Group 2, Census Tract 304.02, Effingham County, Georgia",2759,415,2306,471,453,236
1500000US131050001001,131050001001,"Block Group 1, Census Tract 1, Elbert County, Georgia",926,236,741,230,185,98
1500000US131050001002,131050001002,"Block Group 2, Census Tract 1, Elbert County, Georgia",1199,308,1029,304,170,114
1500000US131050001003,131050001003,"Block Group 3, Census Tract 1, Elbert County, Georgia",1387,289,1017,247,370,161
1500000US131050002001,131050002001,"Block Group 1, Census Tract 2, Elbert County, Georgia",961,362,717,301,244,191
1500000US131050002002,131050002002,"Block Group 2, Census Tract 2, Elbert County, Georgia",898,294,819,288,79,78
1500000US131050002003,131050002003,"Block Group 3, Census Tract 2, Elbert County, Georgia",948,245,567,195,381,201
1500000US131050003001,131050003001,"Block Group 1, Census Tract 3, Elbert County, Georgia",998,330,598,188,400,260
1500000US131050003002,131050003002,"Block Group 2, Census Tract 3, Elbert County, Georgia",1032,351,528,273,504,251
1500000US131050003003,131050003003,"Block Group 3, Census Tract 3, Elbert County, Georgia",1660,349,1257,320,403,221
1500000US131050004001,131050004001,"Block Group 1, Census Tract 4, Elbert County, Georgia",945,257,604,215,341,195
1500000US131050004002,131050004002,"Block Group 2, Census Tract 4, Elbert County, Georgia",877,232,585,226,292,166
1500000US131050004003,131050004003,"Block Group 3, Census Tract 4, Elbert County, Georgia",990,251,480,219,510,189
1500000US131050004004,131050004004,"Block Group 4, Census Tract 4, Elbert County, Georgia",597,248,361,257,236,144
1500000US131050004005,131050004005,"Block Group 5, Census Tract 4, Elbert County, Georgia",682,200,340,112,342,169
1500000US131050005001,131050005001,"Block Group 1, Census Tract 5, Elbert County, Georgia",863,350,441,213,422,294
1500000US131050005002,131050005002,"Block Group 2, Census Tract 5, Elbert County, Georgia",1391,417,806,308,585,313
1500000US131050005003,131050005003,"Block Group 3, Census Tract 5, Elbert County, Georgia",791,263,619,249,172,135
1500000US131050005004,131050005004,"Block Group 4, Census Tract 5, Elbert County, Georgia",703,211,703,211,0,13
1500000US131050005005,131050005005,"Block Group 5, Census Tract 5, Elbert County, Georgia",972,324,901,318,71,88
1500000US131050005006,131050005006,"Block Group 6, Census Tract 5, Elbert County, Georgia",466,265,384,250,82,102
1500000US131079701001,131079701001,"Block Group 1, Census Tract 9701, Emanuel County, Georgia",1919,325,1470,273,449,177
1500000US131079701002,131079701002,"Block Group 2, Census Tract 9701, Emanuel County, Georgia",424,159,349,146,75,52
1500000US131079701003,131079701003,"Block Group 3, Census Tract 9701, Emanuel County, Georgia",1662,421,1015,358,647,285
1500000US131079701004,131079701004,"Block Group 4, Census Tract 9701, Emanuel County, Georgia",1290,291,752,225,538,184
1500000US131079702001,131079702001,"Block Group 1, Census Tract 9702, Emanuel County, Georgia",818,170,666,175,152,100
1500000US131079702002,131079702002,"Block Group 2, Census Tract 9702, Emanuel County, Georgia",803,169,595,144,208,113
1500000US131079703001,131079703001,"Block Group 1, Census Tract 9703, Emanuel County, Georgia",1315,301,1082,269,233,157
1500000US131079703002,131079703002,"Block Group 2, Census Tract 9703, Emanuel County, Georgia",1254,287,985,285,269,138
1500000US131079703003,131079703003,"Block Group 3, Census Tract 9703, Emanuel County, Georgia",1333,341,307,133,1026,333
1500000US131079704001,131079704001,"Block Group 1, Census Tract 9704, Emanuel County, Georgia",2018,438,1370,407,648,301
1500000US131079704002,131079704002,"Block Group 2, Census Tract 9704, Emanuel County, Georgia",1380,307,1041,327,339,165
1500000US131079704003,131079704003,"Block Group 3, Census Tract 9704, Emanuel County, Georgia",1162,395,89,90,1073,407
1500000US131079705001,131079705001,"Block Group 1, Census Tract 9705, Emanuel County, Georgia",510,140,380,136,130,74
1500000US131079705002,131079705002,"Block Group 2, Census Tract 9705, Emanuel County, Georgia",783,190,750,192,33,32
1500000US131079706001,131079706001,"Block Group 1, Census Tract 9706, Emanuel County, Georgia",1336,478,967,336,369,359
1500000US131079706002,131079706002,"Block Group 2, Census Tract 9706, Emanuel County, Georgia",1452,373,1155,359,297,157
1500000US131079706003,131079706003,"Block Group 3, Census Tract 9706, Emanuel County, Georgia",1019,360,790,398,229,221
1500000US131079706004,131079706004,"Block Group 4, Census Tract 9706, Emanuel County, Georgia",1394,397,570,285,824,392
1500000US131099701001,131099701001,"Block Group 1, Census Tract 9701, Evans County, Georgia",1501,363,1242,325,259,188
1500000US131099701002,131099701002,"Block Group 2, Census Tract 9701, Evans County, Georgia",1479,317,1099,234,380,232
1500000US131099702001,131099702001,"Block Group 1, Census Tract 9702, Evans County, Georgia",1047,260,597,197,450,169
1500000US131099702002,131099702002,"Block Group 2, Census Tract 9702, Evans County, Georgia",1019,231,574,156,445,158
1500000US131099702003,131099702003,"Block Group 3, Census Tract 9702, Evans County, Georgia",978,222,845,214,133,67
1500000US131099702004,131099702004,"Block Group 4, Census Tract 9702, Evans County, Georgia",700,264,579,262,121,69
1500000US131099703001,131099703001,"Block Group 1, Census Tract 9703, Evans County, Georgia",423,177,230,129,193,129
1500000US131099703002,131099703002,"Block Group 2, Census Tract 9703, Evans County, Georgia",1297,364,411,160,886,346
1500000US131099703003,131099703003,"Block Group 3, Census Tract 9703, Evans County, Georgia",934,273,361,172,573,269
1500000US131099703004,131099703004,"Block Group 4, Census Tract 9703, Evans County, Georgia",985,279,499,165,486,264
1500000US131110501001,131110501001,"Block Group 1, Census Tract 501, Fannin County, Georgia",2196,386,1934,361,262,192
1500000US131110501002,131110501002,"Block Group 2, Census Tract 501, Fannin County, Georgia",1386,313,1055,312,331,192
1500000US131110502001,131110502001,"Block Group 1, Census Tract 502, Fannin County, Georgia",1784,569,1516,568,268,152
1500000US131110502002,131110502002,"Block Group 2, Census Tract 502, Fannin County, Georgia",614,167,267,100,347,135
1500000US131110502003,131110502003,"Block Group 3, Census Tract 502, Fannin County, Georgia",810,251,465,204,345,158
1500000US131110502004,131110502004,"Block Group 4, Census Tract 502, Fannin County, Georgia",1665,367,1413,370,252,169
1500000US131110502005,131110502005,"Block Group 5, Census Tract 502, Fannin County, Georgia",1255,287,890,254,365,204
1500000US131110503001,131110503001,"Block Group 1, Census Tract 503, Fannin County, Georgia",1574,352,1157,330,417,234
1500000US131110503002,131110503002,"Block Group 2, Census Tract 503, Fannin County, Georgia",1188,295,944,260,244,187
1500000US131110504001,131110504001,"Block Group 1, Census Tract 504, Fannin County, Georgia",994,360,805,343,189,133
1500000US131110504002,131110504002,"Block Group 2, Census Tract 504, Fannin County, Georgia",1056,310,1011,304,45,68
1500000US131110504003,131110504003,"Block Group 3, Census Tract 504, Fannin County, Georgia",1974,594,1866,557,108,148
1500000US131110504004,131110504004,"Block Group 4, Census Tract 504, Fannin County, Georgia",1195,276,550,181,645,211
1500000US131110504005,131110504005,"Block Group 5, Census Tract 504, Fannin County, Georgia",1758,449,984,297,774,409
1500000US131110505001,131110505001,"Block Group 1, Census Tract 505, Fannin County, Georgia",444,228,444,228,0,13
1500000US131110505002,131110505002,"Block Group 2, Census Tract 505, Fannin County, Georgia",1752,518,1106,389,646,425
1500000US131110505003,131110505003,"Block Group 3, Census Tract 505, Fannin County, Georgia",1357,346,1313,344,44,41
1500000US131110505004,131110505004,"Block Group 4, Census Tract 505, Fannin County, Georgia",548,261,504,264,44,56
1500000US131131401011,131131401011,"Block Group 1, Census Tract 1401.01, Fayette County, Georgia",1940,443,1861,447,79,104
1500000US131131401012,131131401012,"Block Group 2, Census Tract 1401.01, Fayette County, Georgia",1318,287,1181,306,137,100
1500000US131131401013,131131401013,"Block Group 3, Census Tract 1401.01, Fayette County, Georgia",3530,643,3244,658,286,291
1500000US131131401021,131131401021,"Block Group 1, Census Tract 1401.02, Fayette County, Georgia",1066,328,1021,320,45,59
1500000US131131401022,131131401022,"Block Group 2, Census Tract 1401.02, Fayette County, Georgia",2303,524,2228,539,75,84
1500000US131131401023,131131401023,"Block Group 3, Census Tract 1401.02, Fayette County, Georgia",2252,477,1800,494,452,359
1500000US131131402031,131131402031,"Block Group 1, Census Tract 1402.03, Fayette County, Georgia",3683,486,3117,521,566,325
1500000US131131402032,131131402032,"Block Group 2, Census Tract 1402.03, Fayette County, Georgia",2073,386,1803,346,270,230
1500000US131131402041,131131402041,"Block Group 1, Census Tract 1402.04, Fayette County, Georgia",1127,431,741,401,386,211
1500000US131131402042,131131402042,"Block Group 2, Census Tract 1402.04, Fayette County, Georgia",2156,364,1967,325,189,192
1500000US131131402043,131131402043,"Block Group 3, Census Tract 1402.04, Fayette County, Georgia",2267,440,1850,381,417,355
1500000US131131402061,131131402061,"Block Group 1, Census Tract 1402.06, Fayette County, Georgia",2893,418,2467,325,426,365
1500000US131131402062,131131402062,"Block Group 2, Census Tract 1402.06, Fayette County, Georgia",1600,280,1288,209,312,184
1500000US131131402071,131131402071,"Block Group 1, Census Tract 1402.07, Fayette County, Georgia",1760,340,1011,305,749,250
1500000US131131402072,131131402072,"Block Group 2, Census Tract 1402.07, Fayette County, Georgia",930,195,871,204,59,49
1500000US131131402073,131131402073,"Block Group 3, Census Tract 1402.07, Fayette County, Georgia",2575,324,2349,316,226,185
1500000US131131402081,131131402081,"Block Group 1, Census Tract 1402.08, Fayette County, Georgia",4314,713,2872,644,1442,651
1500000US131131402082,131131402082,"Block Group 2, Census Tract 1402.08, Fayette County, Georgia",1195,316,905,327,290,189
1500000US131131402083,131131402083,"Block Group 3, Census Tract 1402.08, Fayette County, Georgia",2287,552,1568,483,719,417
1500000US131131403031,131131403031,"Block Group 1, Census Tract 1403.03, Fayette County, Georgia",1207,280,735,208,472,226
1500000US131131403032,131131403032,"Block Group 2, Census Tract 1403.03, Fayette County, Georgia",2041,339,1517,293,524,323
1500000US131131403033,131131403033,"Block Group 3, Census Tract 1403.03, Fayette County, Georgia",1339,284,1181,275,158,107
1500000US131131403041,131131403041,"Block Group 1, Census Tract 1403.04, Fayette County, Georgia",2277,509,1996,458,281,287
1500000US131131403042,131131403042,"Block Group 2, Census Tract 1403.04, Fayette County, Georgia",1208,314,1162,328,46,84
1500000US131131403043,131131403043,"Block Group 3, Census Tract 1403.04, Fayette County, Georgia",2270,430,1424,325,846,403
1500000US131131403051,131131403051,"Block Group 1, Census Tract 1403.05, Fayette County, Georgia",5319,378,4634,455,685,319
1500000US131131403061,131131403061,"Block Group 1, Census Tract 1403.06, Fayette County, Georgia",2753,430,2004,402,749,368
1500000US131131403062,131131403062,"Block Group 2, Census Tract 1403.06, Fayette County, Georgia",3023,473,1321,296,1702,472
1500000US131131403063,131131403063,"Block Group 3, Census Tract 1403.06, Fayette County, Georgia",1863,339,1307,273,556,342
1500000US131131403071,131131403071,"Block Group 1, Census Tract 1403.07, Fayette County, Georgia",3131,354,2948,364,183,131
1500000US131131403072,131131403072,"Block Group 2, Census Tract 1403.07, Fayette County, Georgia",1687,278,1635,273,52,82
1500000US131131404031,131131404031,"Block Group 1, Census Tract 1404.03, Fayette County, Georgia",895,197,784,196,111,85
1500000US131131404032,131131404032,"Block Group 2, Census Tract 1404.03, Fayette County, Georgia",925,232,735,212,190,166
1500000US131131404033,131131404033,"Block Group 3, Census Tract 1404.03, Fayette County, Georgia",3548,524,3269,508,279,196
1500000US131131404041,131131404041,"Block Group 1, Census Tract 1404.04, Fayette County, Georgia",1675,444,990,321,685,308
1500000US131131404042,131131404042,"Block Group 2, Census Tract 1404.04, Fayette County, Georgia",3921,643,3606,598,315,222
1500000US131131404051,131131404051,"Block Group 1, Census Tract 1404.05, Fayette County, Georgia",1394,279,1259,260,135,133
1500000US131131404052,131131404052,"Block Group 2, Census Tract 1404.05, Fayette County, Georgia",2303,374,1873,427,430,264
1500000US131131404061,131131404061,"Block Group 1, Census Tract 1404.06, Fayette County, Georgia",2292,386,1667,349,625,263
1500000US131131404062,131131404062,"Block Group 2, Census Tract 1404.06, Fayette County, Georgia",1462,299,968,278,494,231
1500000US131131404071,131131404071,"Block Group 1, Census Tract 1404.07, Fayette County, Georgia",1255,410,1255,410,0,13
1500000US131131404072,131131404072,"Block Group 2, Census Tract 1404.07, Fayette County, Georgia",3242,539,1271,374,1971,585
1500000US131131404073,131131404073,"Block Group 3, Census Tract 1404.07, Fayette County, Georgia",3174,590,3109,582,65,65
1500000US131131404081,131131404081,"Block Group 1, Census Tract 1404.08, Fayette County, Georgia",1343,282,1117,256,226,191
1500000US131131404082,131131404082,"Block Group 2, Census Tract 1404.08, Fayette County, Georgia",1705,291,1599,282,106,143
1500000US131131405011,131131405011,"Block Group 1, Census Tract 1405.01, Fayette County, Georgia",2950,375,2877,377,73,91
1500000US131131405012,131131405012,"Block Group 2, Census Tract 1405.01, Fayette County, Georgia",2965,406,2870,394,95,104
1500000US131131405021,131131405021,"Block Group 1, Census Tract 1405.02, Fayette County, Georgia",2495,271,2247,325,248,148
1500000US131131405022,131131405022,"Block Group 2, Census Tract 1405.02, Fayette County, Georgia",1107,388,1097,388,10,11
1500000US131150001001,131150001001,"Block Group 1, Census Tract 1, Floyd County, Georgia",2381,280,1979,331,402,192
1500000US131150001002,131150001002,"Block Group 2, Census Tract 1, Floyd County, Georgia",857,266,611,272,246,106
1500000US131150001003,131150001003,"Block Group 3, Census Tract 1, Floyd County, Georgia",1306,334,701,257,605,285
1500000US131150002011,131150002011,"Block Group 1, Census Tract 2.01, Floyd County, Georgia",1420,523,687,377,733,552
1500000US131150002012,131150002012,"Block Group 2, Census Tract 2.01, Floyd County, Georgia",2549,596,1302,403,1247,595
1500000US131150002013,131150002013,"Block Group 3, Census Tract 2.01, Floyd County, Georgia",2422,406,1927,371,495,263
1500000US131150002021,131150002021,"Block Group 1, Census Tract 2.02, Floyd County, Georgia",2012,398,1476,417,536,293
1500000US131150002022,131150002022,"Block Group 2, Census Tract 2.02, Floyd County, Georgia",1888,302,1505,317,383,272
1500000US131150003001,131150003001,"Block Group 1, Census Tract 3, Floyd County, Georgia",874,133,773,123,101,98
1500000US131150003002,131150003002,"Block Group 2, Census Tract 3, Floyd County, Georgia",388,145,0,13,388,145
1500000US131150004001,131150004001,"Block Group 1, Census Tract 4, Floyd County, Georgia",1604,345,1182,270,422,273
1500000US131150004002,131150004002,"Block Group 2, Census Tract 4, Floyd County, Georgia",2417,648,1958,560,459,250
1500000US131150004003,131150004003,"Block Group 3, Census Tract 4, Floyd County, Georgia",1312,455,678,307,634,395
1500000US131150004004,131150004004,"Block Group 4, Census Tract 4, Floyd County, Georgia",2173,754,1117,680,1056,572
1500000US131150005001,131150005001,"Block Group 1, Census Tract 5, Floyd County, Georgia",758,216,465,208,293,164
1500000US131150005002,131150005002,"Block Group 2, Census Tract 5, Floyd County, Georgia",1736,504,644,390,1092,409
1500000US131150005003,131150005003,"Block Group 3, Census Tract 5, Floyd County, Georgia",1403,500,668,399,735,348
1500000US131150006001,131150006001,"Block Group 1, Census Tract 6, Floyd County, Georgia",1347,444,312,193,1035,416
1500000US131150006002,131150006002,"Block Group 2, Census Tract 6, Floyd County, Georgia",1651,360,677,280,974,333
1500000US131150006003,131150006003,"Block Group 3, Census Tract 6, Floyd County, Georgia",1473,407,264,117,1209,393
1500000US131150007001,131150007001,"Block Group 1, Census Tract 7, Floyd County, Georgia",2111,385,1540,351,571,295
1500000US131150007002,131150007002,"Block Group 2, Census Tract 7, Floyd County, Georgia",2626,400,2054,411,572,397
1500000US131150008001,131150008001,"Block Group 1, Census Tract 8, Floyd County, Georgia",2358,371,1984,372,374,168
1500000US131150008002,131150008002,"Block Group 2, Census Tract 8, Floyd County, Georgia",2387,360,1614,349,773,330
1500000US131150009001,131150009001,"Block Group 1, Census Tract 9, Floyd County, Georgia",2500,323,1286,239,1214,351
1500000US131150011001,131150011001,"Block Group 1, Census Tract 11, Floyd County, Georgia",1289,347,435,211,854,315
1500000US131150011002,131150011002,"Block Group 2, Census Tract 11, Floyd County, Georgia",779,141,50,41,729,140
1500000US131150011003,131150011003,"Block Group 3, Census Tract 11, Floyd County, Georgia",507,159,341,154,166,58
1500000US131150012001,131150012001,"Block Group 1, Census Tract 12, Floyd County, Georgia",890,329,562,292,328,161
1500000US131150012002,131150012002,"Block Group 2, Census Tract 12, Floyd County, Georgia",1909,443,1448,423,461,303
1500000US131150012003,131150012003,"Block Group 3, Census Tract 12, Floyd County, Georgia",1559,467,668,274,891,426
1500000US131150013001,131150013001,"Block Group 1, Census Tract 13, Floyd County, Georgia",2198,547,1261,402,937,489
1500000US131150013002,131150013002,"Block Group 2, Census Tract 13, Floyd County, Georgia",1897,622,509,194,1388,671
1500000US131150013003,131150013003,"Block Group 3, Census Tract 13, Floyd County, Georgia",1965,477,998,347,967,409
1500000US131150014001,131150014001,"Block Group 1, Census Tract 14, Floyd County, Georgia",1927,644,1561,636,366,263
1500000US131150014002,131150014002,"Block Group 2, Census Tract 14, Floyd County, Georgia",2858,636,2706,678,152,136
1500000US131150014003,131150014003,"Block Group 3, Census Tract 14, Floyd County, Georgia",1871,484,1871,484,0,13
1500000US131150016001,131150016001,"Block Group 1, Census Tract 16, Floyd County, Georgia",1217,266,310,173,907,244
1500000US131150016002,131150016002,"Block Group 2, Census Tract 16, Floyd County, Georgia",936,287,121,91,815,274
1500000US131150016003,131150016003,"Block Group 3, Census Tract 16, Floyd County, Georgia",1314,291,311,187,1003,285
1500000US131150017011,131150017011,"Block Group 1, Census Tract 17.01, Floyd County, Georgia",2559,625,2275,640,284,218
1500000US131150017012,131150017012,"Block Group 2, Census Tract 17.01, Floyd County, Georgia",2457,420,1802,404,655,421
1500000US131150017013,131150017013,"Block Group 3, Census Tract 17.01, Floyd County, Georgia",1331,355,1078,341,253,166
1500000US131150017021,131150017021,"Block Group 1, Census Tract 17.02, Floyd County, Georgia",1571,467,1296,383,275,265
1500000US131150017022,131150017022,"Block Group 2, Census Tract 17.02, Floyd County, Georgia",2440,584,1907,586,533,249
1500000US131150017023,131150017023,"Block Group 3, Census Tract 17.02, Floyd County, Georgia",1265,376,217,103,1048,379
1500000US131150017024,131150017024,"Block Group 4, Census Tract 17.02, Floyd County, Georgia",1023,416,338,191,685,416
1500000US131150018001,131150018001,"Block Group 1, Census Tract 18, Floyd County, Georgia",1708,402,1155,362,553,238
1500000US131150018002,131150018002,"Block Group 2, Census Tract 18, Floyd County, Georgia",685,263,305,117,380,257
1500000US131150018003,131150018003,"Block Group 3, Census Tract 18, Floyd County, Georgia",2115,426,1414,398,701,262
1500000US131150020001,131150020001,"Block Group 1, Census Tract 20, Floyd County, Georgia",1743,259,1277,246,466,157
1500000US131150020002,131150020002,"Block Group 2, Census Tract 20, Floyd County, Georgia",1277,216,1012,217,265,153
1500000US131150020003,131150020003,"Block Group 3, Census Tract 20, Floyd County, Georgia",1003,224,837,185,166,136
1500000US131150021001,131150021001,"Block Group 1, Census Tract 21, Floyd County, Georgia",1597,326,1022,286,575,222
1500000US131150021002,131150021002,"Block Group 2, Census Tract 21, Floyd County, Georgia",1199,308,424,206,775,314
1500000US131150021003,131150021003,"Block Group 3, Census Tract 21, Floyd County, Georgia",1095,368,210,116,885,379
1500000US131171301011,131171301011,"Block Group 1, Census Tract 1301.01, Forsyth County, Georgia",2704,361,2203,336,501,339
1500000US131171301012,131171301012,"Block Group 2, Census Tract 1301.01, Forsyth County, Georgia",1393,430,1131,395,262,186
1500000US131171301021,131171301021,"Block Group 1, Census Tract 1301.02, Forsyth County, Georgia",2728,270,2420,318,308,203
1500000US131171301031,131171301031,"Block Group 1, Census Tract 1301.03, Forsyth County, Georgia",1439,440,1087,378,352,235
1500000US131171301032,131171301032,"Block Group 2, Census Tract 1301.03, Forsyth County, Georgia",1218,342,1135,340,83,134
1500000US131171301033,131171301033,"Block Group 3, Census Tract 1301.03, Forsyth County, Georgia",918,279,725,255,193,166
1500000US131171301041,131171301041,"Block Group 1, Census Tract 1301.04, Forsyth County, Georgia",1543,315,1370,344,173,155
1500000US131171301042,131171301042,"Block Group 2, Census Tract 1301.04, Forsyth County, Georgia",1512,339,1100,264,412,333
1500000US131171301043,131171301043,"Block Group 3, Census Tract 1301.04, Forsyth County, Georgia",915,261,717,257,198,125
1500000US131171301051,131171301051,"Block Group 1, Census Tract 1301.05, Forsyth County, Georgia",2571,374,1107,385,1464,298
1500000US131171302011,131171302011,"Block Group 1, Census Tract 1302.01, Forsyth County, Georgia",1602,371,1420,353,182,143
1500000US131171302012,131171302012,"Block Group 2, Census Tract 1302.01, Forsyth County, Georgia",1642,445,1613,452,29,40
1500000US131171302013,131171302013,"Block Group 3, Census Tract 1302.01, Forsyth County, Georgia",1565,384,1335,329,230,243
1500000US131171302021,131171302021,"Block Group 1, Census Tract 1302.02, Forsyth County, Georgia",1380,304,1308,309,72,87
1500000US131171302022,131171302022,"Block Group 2, Census Tract 1302.02, Forsyth County, Georgia",673,211,663,216,10,16
1500000US131171302023,131171302023,"Block Group 3, Census Tract 1302.02, Forsyth County, Georgia",1794,476,1721,501,73,122
1500000US131171302031,131171302031,"Block Group 1, Census Tract 1302.03, Forsyth County, Georgia",2835,660,1966,385,869,689
1500000US131171302032,131171302032,"Block Group 2, Census Tract 1302.03, Forsyth County, Georgia",2657,429,2146,420,511,237
1500000US131171302041,131171302041,"Block Group 1, Census Tract 1302.04, Forsyth County, Georgia",2293,516,1747,446,546,281
1500000US131171302042,131171302042,"Block Group 2, Census Tract 1302.04, Forsyth County, Georgia",1988,437,1741,407,247,182
1500000US131171302051,131171302051,"Block Group 1, Census Tract 1302.05, Forsyth County, Georgia",1467,446,979,384,488,262
1500000US131171302052,131171302052,"Block Group 2, Census Tract 1302.05, Forsyth County, Georgia",509,160,269,95,240,171
1500000US131171302053,131171302053,"Block Group 3, Census Tract 1302.05, Forsyth County, Georgia",556,291,358,115,198,263
1500000US131171303011,131171303011,"Block Group 1, Census Tract 1303.01, Forsyth County, Georgia",1993,405,1763,406,230,182
1500000US131171303012,131171303012,"Block Group 2, Census Tract 1303.01, Forsyth County, Georgia",3721,580,3127,476,594,512
1500000US131171303021,131171303021,"Block Group 1, Census Tract 1303.02, Forsyth County, Georgia",1101,356,995,344,106,115
1500000US131171303022,131171303022,"Block Group 2, Census Tract 1303.02, Forsyth County, Georgia",2179,589,2030,608,149,133
1500000US131171303023,131171303023,"Block Group 3, Census Tract 1303.02, Forsyth County, Georgia",2270,459,2115,455,155,136
1500000US131171303031,131171303031,"Block Group 1, Census Tract 1303.03, Forsyth County, Georgia",2773,778,2349,762,424,277
1500000US131171303032,131171303032,"Block Group 2, Census Tract 1303.03, Forsyth County, Georgia",1413,328,1403,329,10,16
1500000US131171303041,131171303041,"Block Group 1, Census Tract 1303.04, Forsyth County, Georgia",1864,495,1694,506,170,174
1500000US131171303042,131171303042,"Block Group 2, Census Tract 1303.04, Forsyth County, Georgia",2657,411,2153,359,504,318
1500000US131171303051,131171303051,"Block Group 1, Census Tract 1303.05, Forsyth County, Georgia",905,281,876,263,29,61
1500000US131171303052,131171303052,"Block Group 2, Census Tract 1303.05, Forsyth County, Georgia",3095,567,2513,589,582,291
1500000US131171303053,131171303053,"Block Group 3, Census Tract 1303.05, Forsyth County, Georgia",1679,296,1632,301,47,58
1500000US131171303061,131171303061,"Block Group 1, Census Tract 1303.06, Forsyth County, Georgia",2798,509,2719,520,79,72
1500000US131171303062,131171303062,"Block Group 2, Census Tract 1303.06, Forsyth County, Georgia",1812,307,1672,311,140,136
1500000US131171303071,131171303071,"Block Group 1, Census Tract 1303.07, Forsyth County, Georgia",2509,449,2286,429,223,165
1500000US131171303072,131171303072,"Block Group 2, Census Tract 1303.07, Forsyth County, Georgia",1762,317,1675,341,87,121
1500000US131171304031,131171304031,"Block Group 1, Census Tract 1304.03, Forsyth County, Georgia",783,310,444,175,339,276
1500000US131171304032,131171304032,"Block Group 2, Census Tract 1304.03, Forsyth County, Georgia",1488,451,1281,416,207,211
1500000US131171304033,131171304033,"Block Group 3, Census Tract 1304.03, Forsyth County, Georgia",1136,391,822,338,314,215
1500000US131171304034,131171304034,"Block Group 4, Census Tract 1304.03, Forsyth County, Georgia",2302,549,2302,549,0,13
1500000US131171304041,131171304041,"Block Group 1, Census Tract 1304.04, Forsyth County, Georgia",2074,409,1873,391,201,182
1500000US131171304042,131171304042,"Block Group 2, Census Tract 1304.04, Forsyth County, Georgia",2565,350,2270,416,295,277
1500000US131171304051,131171304051,"Block Group 1, Census Tract 1304.05, Forsyth County, Georgia",2153,608,1844,601,309,305
1500000US131171304052,131171304052,"Block Group 2, Census Tract 1304.05, Forsyth County, Georgia",1854,447,1562,390,292,281
1500000US131171304061,131171304061,"Block Group 1, Census Tract 1304.06, Forsyth County, Georgia",2165,458,1416,391,749,425
1500000US131171304062,131171304062,"Block Group 2, Census Tract 1304.06, Forsyth County, Georgia",2105,411,1610,429,495,315
1500000US131171304063,131171304063,"Block Group 3, Census Tract 1304.06, Forsyth County, Georgia",1242,348,880,263,362,284
1500000US131171304081,131171304081,"Block Group 1, Census Tract 1304.08, Forsyth County, Georgia",2352,422,1467,269,885,466
1500000US131171304082,131171304082,"Block Group 2, Census Tract 1304.08, Forsyth County, Georgia",1262,358,780,249,482,311
1500000US131171304091,131171304091,"Block Group 1, Census Tract 1304.09, Forsyth County, Georgia",645,252,350,185,295,216
1500000US131171304092,131171304092,"Block Group 2, Census Tract 1304.09, Forsyth County, Georgia",1810,318,1305,261,505,208
1500000US131171304101,131171304101,"Block Group 1, Census Tract 1304.10, Forsyth County, Georgia",725,186,564,211,161,90
1500000US131171304102,131171304102,"Block Group 2, Census Tract 1304.10, Forsyth County, Georgia",1481,337,105,73,1376,345
1500000US131171304103,131171304103,"Block Group 3, Census Tract 1304.10, Forsyth County, Georgia",1664,358,1238,352,426,221
1500000US131171305031,131171305031,"Block Group 1, Census Tract 1305.03, Forsyth County, Georgia",1604,228,1324,220,280,148
1500000US131171305032,131171305032,"Block Group 2, Census Tract 1305.03, Forsyth County, Georgia",1113,244,924,246,189,136
1500000US131171305041,131171305041,"Block Group 1, Census Tract 1305.04, Forsyth County, Georgia",1985,406,1302,425,683,280
1500000US131171305042,131171305042,"Block Group 2, Census Tract 1305.04, Forsyth County, Georgia",1755,392,1364,323,391,259
1500000US131171305051,131171305051,"Block Group 1, Census Tract 1305.05, Forsyth County, Georgia",1169,296,997,281,172,161
1500000US131171305052,131171305052,"Block Group 2, Census Tract 1305.05, Forsyth County, Georgia",1469,248,1438,255,31,39
1500000US131171305061,131171305061,"Block Group 1, Census Tract 1305.06, Forsyth County, Georgia",1092,298,985,291,107,100
1500000US131171305062,131171305062,"Block Group 2, Census Tract 1305.06, Forsyth County, Georgia",2380,293,1822,306,558,190
1500000US131171305071,131171305071,"Block Group 1, Census Tract 1305.07, Forsyth County, Georgia",873,220,720,197,153,92
1500000US131171305072,131171305072,"Block Group 2, Census Tract 1305.07, Forsyth County, Georgia",1442,409,1357,409,85,76
1500000US131171305081,131171305081,"Block Group 1, Census Tract 1305.08, Forsyth County, Georgia",2543,347,2432,363,111,104
1500000US131171305082,131171305082,"Block Group 2, Census Tract 1305.08, Forsyth County, Georgia",2687,413,2575,409,112,141
1500000US131171305091,131171305091,"Block Group 1, Census Tract 1305.09, Forsyth County, Georgia",1944,351,1790,355,154,122
1500000US131171305092,131171305092,"Block Group 2, Census Tract 1305.09, Forsyth County, Georgia",1442,359,1273,367,169,126
1500000US131171305101,131171305101,"Block Group 1, Census Tract 1305.10, Forsyth County, Georgia",2029,434,1922,413,107,140
1500000US131171305102,131171305102,"Block Group 2, Census Tract 1305.10, Forsyth County, Georgia",2332,465,1492,362,840,435
1500000US131171305103,131171305103,"Block Group 3, Census Tract 1305.10, Forsyth County, Georgia",2131,408,1767,410,364,263
1500000US131171306011,131171306011,"Block Group 1, Census Tract 1306.01, Forsyth County, Georgia",2605,606,1484,395,1121,584
1500000US131171306012,131171306012,"Block Group 2, Census Tract 1306.01, Forsyth County, Georgia",762,346,475,184,287,312
1500000US131171306013,131171306013,"Block Group 3, Census Tract 1306.01, Forsyth County, Georgia",1379,377,1233,396,146,133
1500000US131171306021,131171306021,"Block Group 1, Census Tract 1306.02, Forsyth County, Georgia",2721,695,1460,434,1261,642
1500000US131171306022,131171306022,"Block Group 2, Census Tract 1306.02, Forsyth County, Georgia",2761,465,2417,365,344,296
1500000US131171306031,131171306031,"Block Group 1, Census Tract 1306.03, Forsyth County, Georgia",2890,418,2652,437,238,255
1500000US131171306032,131171306032,"Block Group 2, Census Tract 1306.03, Forsyth County, Georgia",1312,414,987,303,325,300
1500000US131171306033,131171306033,"Block Group 3, Census Tract 1306.03, Forsyth County, Georgia",782,269,625,247,157,124
1500000US131171306041,131171306041,"Block Group 1, Census Tract 1306.04, Forsyth County, Georgia",2572,464,2188,438,384,315
1500000US131171306042,131171306042,"Block Group 2, Census Tract 1306.04, Forsyth County, Georgia",981,256,981,256,0,13
1500000US131171306043,131171306043,"Block Group 3, Census Tract 1306.04, Forsyth County, Georgia",1584,354,1550,352,34,53
1500000US131171306051,131171306051,"Block Group 1, Census Tract 1306.05, Forsyth County, Georgia",1326,336,1058,313,268,276
1500000US131171306052,131171306052,"Block Group 2, Census Tract 1306.05, Forsyth County, Georgia",2601,340,2415,361,186,161
1500000US131171306061,131171306061,"Block Group 1, Census Tract 1306.06, Forsyth County, Georgia",1790,298,1674,336,116,163
1500000US131171306062,131171306062,"Block Group 2, Census Tract 1306.06, Forsyth County, Georgia",2701,426,2141,417,560,187
1500000US131171306071,131171306071,"Block Group 1, Census Tract 1306.07, Forsyth County, Georgia",2210,321,1919,381,291,321
1500000US131171306072,131171306072,"Block Group 2, Census Tract 1306.07, Forsyth County, Georgia",662,154,546,176,116,75
1500000US131171306073,131171306073,"Block Group 3, Census Tract 1306.07, Forsyth County, Georgia",2694,418,2658,420,36,61
1500000US131171306081,131171306081,"Block Group 1, Census Tract 1306.08, Forsyth County, Georgia",2885,649,2536,600,349,275
1500000US131171306082,131171306082,"Block Group 2, Census Tract 1306.08, Forsyth County, Georgia",1881,384,1728,390,153,141
1500000US131171306083,131171306083,"Block Group 3, Census Tract 1306.08, Forsyth County, Georgia",813,275,775,264,38,70
1500000US131171306091,131171306091,"Block Group 1, Census Tract 1306.09, Forsyth County, Georgia",2954,443,2760,467,194,220
1500000US131171306092,131171306092,"Block Group 2, Census Tract 1306.09, Forsyth County, Georgia",1170,276,1141,275,29,46
1500000US131171306093,131171306093,"Block Group 3, Census Tract 1306.09, Forsyth County, Georgia",1274,402,1171,396,103,132
1500000US131171306101,131171306101,"Block Group 1, Census Tract 1306.10, Forsyth County, Georgia",1417,252,1417,252,0,13
1500000US131171306102,131171306102,"Block Group 2, Census Tract 1306.10, Forsyth County, Georgia",1801,401,1634,374,167,210
1500000US131171306103,131171306103,"Block Group 3, Census Tract 1306.10, Forsyth County, Georgia",1167,253,1167,253,0,13
1500000US131171306111,131171306111,"Block Group 1, Census Tract 1306.11, Forsyth County, Georgia",1334,377,1295,377,39,64
1500000US131171306112,131171306112,"Block Group 2, Census Tract 1306.11, Forsyth County, Georgia",2667,421,2544,433,123,145
1500000US131171306121,131171306121,"Block Group 1, Census Tract 1306.12, Forsyth County, Georgia",2065,460,1991,473,74,54
1500000US131171306122,131171306122,"Block Group 2, Census Tract 1306.12, Forsyth County, Georgia",845,246,652,232,193,149
1500000US131171306123,131171306123,"Block Group 3, Census Tract 1306.12, Forsyth County, Georgia",3666,455,3666,455,0,13
1500000US131171306131,131171306131,"Block Group 1, Census Tract 1306.13, Forsyth County, Georgia",1442,282,868,143,574,284
1500000US131171306132,131171306132,"Block Group 2, Census Tract 1306.13, Forsyth County, Georgia",1645,309,1551,300,94,64
1500000US131198901011,131198901011,"Block Group 1, Census Tract 8901.01, Franklin County, Georgia",899,212,499,150,400,148
1500000US131198901012,131198901012,"Block Group 2, Census Tract 8901.01, Franklin County, Georgia",1141,239,534,148,607,206
1500000US131198901013,131198901013,"Block Group 3, Census Tract 8901.01, Franklin County, Georgia",1807,333,1014,328,793,292
1500000US131198901021,131198901021,"Block Group 1, Census Tract 8901.02, Franklin County, Georgia",1152,293,948,264,204,158
1500000US131198901022,131198901022,"Block Group 2, Census Tract 8901.02, Franklin County, Georgia",1172,439,683,363,489,235
1500000US131198901023,131198901023,"Block Group 3, Census Tract 8901.02, Franklin County, Georgia",1738,393,1274,282,464,368
1500000US131198902001,131198902001,"Block Group 1, Census Tract 8902, Franklin County, Georgia",1758,497,1413,433,345,252
1500000US131198902002,131198902002,"Block Group 2, Census Tract 8902, Franklin County, Georgia",1567,502,1403,483,164,200
1500000US131198902003,131198902003,"Block Group 3, Census Tract 8902, Franklin County, Georgia",1272,333,975,264,297,169
1500000US131198902004,131198902004,"Block Group 4, Census Tract 8902, Franklin County, Georgia",1060,392,1045,393,15,23
1500000US131198903001,131198903001,"Block Group 1, Census Tract 8903, Franklin County, Georgia",1706,400,1137,378,569,279
1500000US131198903002,131198903002,"Block Group 2, Census Tract 8903, Franklin County, Georgia",1473,302,1137,294,336,246
1500000US131198904001,131198904001,"Block Group 1, Census Tract 8904, Franklin County, Georgia",1035,216,649,198,386,160
1500000US131198904002,131198904002,"Block Group 2, Census Tract 8904, Franklin County, Georgia",1003,312,723,245,280,268
1500000US131198904003,131198904003,"Block Group 3, Census Tract 8904, Franklin County, Georgia",594,185,429,170,165,81
1500000US131198904004,131198904004,"Block Group 4, Census Tract 8904, Franklin County, Georgia",2066,355,981,303,1085,284
1500000US131210001001,131210001001,"Block Group 1, Census Tract 1, Fulton County, Georgia",1051,237,861,192,190,162
1500000US131210001002,131210001002,"Block Group 2, Census Tract 1, Fulton County, Georgia",637,172,547,160,90,79
1500000US131210001003,131210001003,"Block Group 3, Census Tract 1, Fulton County, Georgia",1795,248,1601,277,194,123
1500000US131210001004,131210001004,"Block Group 4, Census Tract 1, Fulton County, Georgia",1150,269,1001,255,149,120
1500000US131210002001,131210002001,"Block Group 1, Census Tract 2, Fulton County, Georgia",1475,303,745,280,730,168
1500000US131210002002,131210002002,"Block Group 2, Census Tract 2, Fulton County, Georgia",1473,262,1205,278,268,141
1500000US131210002003,131210002003,"Block Group 3, Census Tract 2, Fulton County, Georgia",1016,228,786,203,230,154
1500000US131210002004,131210002004,"Block Group 4, Census Tract 2, Fulton County, Georgia",934,257,812,279,122,90
1500000US131210002005,131210002005,"Block Group 5, Census Tract 2, Fulton County, Georgia",1267,281,1167,300,100,100
1500000US131210004001,131210004001,"Block Group 1, Census Tract 4, Fulton County, Georgia",427,147,323,100,104,115
1500000US131210004002,131210004002,"Block Group 2, Census Tract 4, Fulton County, Georgia",1000,200,618,161,382,140
1500000US131210005001,131210005001,"Block Group 1, Census Tract 5, Fulton County, Georgia",3138,610,1170,355,1968,538
1500000US131210005002,131210005002,"Block Group 2, Census Tract 5, Fulton County, Georgia",1060,358,976,351,84,65
1500000US131210005003,131210005003,"Block Group 3, Census Tract 5, Fulton County, Georgia",905,339,749,375,156,151
1500000US131210006001,131210006001,"Block Group 1, Census Tract 6, Fulton County, Georgia",4617,635,673,350,3944,633
1500000US131210007001,131210007001,"Block Group 1, Census Tract 7, Fulton County, Georgia",0,13,0,13,0,13
1500000US131210007002,131210007002,"Block Group 2, Census Tract 7, Fulton County, Georgia",753,117,430,112,323,129
1500000US131210010011,131210010011,"Block Group 1, Census Tract 10.01, Fulton County, Georgia",367,119,98,58,269,110
1500000US131210010012,131210010012,"Block Group 2, Census Tract 10.01, Fulton County, Georgia",946,112,559,110,387,94
1500000US131210010021,131210010021,"Block Group 1, Census Tract 10.02, Fulton County, Georgia",860,125,4,6,856,125
1500000US131210011001,131210011001,"Block Group 1, Census Tract 11, Fulton County, Georgia",1021,201,604,157,417,155
1500000US131210011002,131210011002,"Block Group 2, Census Tract 11, Fulton County, Georgia",918,181,551,140,367,158
1500000US131210011003,131210011003,"Block Group 3, Census Tract 11, Fulton County, Georgia",2306,321,636,177,1670,335
1500000US131210012011,131210012011,"Block Group 1, Census Tract 12.01, Fulton County, Georgia",1780,287,884,193,896,275
1500000US131210012012,131210012012,"Block Group 2, Census Tract 12.01, Fulton County, Georgia",2123,466,722,378,1401,420
1500000US131210012021,131210012021,"Block Group 1, Census Tract 12.02, Fulton County, Georgia",2456,406,1654,374,802,234
1500000US131210012022,131210012022,"Block Group 2, Census Tract 12.02, Fulton County, Georgia",1442,337,96,68,1346,333
1500000US131210013001,131210013001,"Block Group 1, Census Tract 13, Fulton County, Georgia",2219,444,1002,260,1217,444
1500000US131210013002,131210013002,"Block Group 2, Census Tract 13, Fulton County, Georgia",1062,283,512,222,550,197
1500000US131210013003,131210013003,"Block Group 3, Census Tract 13, Fulton County, Georgia",869,214,256,168,613,218
1500000US131210014001,131210014001,"Block Group 1, Census Tract 14, Fulton County, Georgia",1411,217,559,169,852,211
1500000US131210014002,131210014002,"Block Group 2, Census Tract 14, Fulton County, Georgia",826,220,490,189,336,127
1500000US131210015001,131210015001,"Block Group 1, Census Tract 15, Fulton County, Georgia",1384,374,166,107,1218,367
1500000US131210015002,131210015002,"Block Group 2, Census Tract 15, Fulton County, Georgia",1308,378,840,237,468,328
1500000US131210015003,131210015003,"Block Group 3, Census Tract 15, Fulton County, Georgia",774,213,197,106,577,222
1500000US131210015004,131210015004,"Block Group 4, Census Tract 15, Fulton County, Georgia",849,261,306,209,543,203
1500000US131210016001,131210016001,"Block Group 1, Census Tract 16, Fulton County, Georgia",2090,267,556,180,1534,240
1500000US131210017001,131210017001,"Block Group 1, Census Tract 17, Fulton County, Georgia",2620,428,679,269,1941,313
1500000US131210017002,131210017002,"Block Group 2, Census Tract 17, Fulton County, Georgia",1111,249,254,158,857,213
1500000US131210018001,131210018001,"Block Group 1, Census Tract 18, Fulton County, Georgia",2684,479,941,331,1743,477
1500000US131210018002,131210018002,"Block Group 2, Census Tract 18, Fulton County, Georgia",763,305,34,57,729,329
1500000US131210018003,131210018003,"Block Group 3, Census Tract 18, Fulton County, Georgia",1082,268,280,149,802,236
1500000US131210019001,131210019001,"Block Group 1, Census Tract 19, Fulton County, Georgia",297,113,0,13,297,113
1500000US131210019002,131210019002,"Block Group 2, Census Tract 19, Fulton County, Georgia",1574,246,586,134,988,278
1500000US131210021001,131210021001,"Block Group 1, Census Tract 21, Fulton County, Georgia",2098,318,630,160,1468,291
1500000US131210023001,131210023001,"Block Group 1, Census Tract 23, Fulton County, Georgia",335,163,32,26,303,162
1500000US131210023002,131210023002,"Block Group 2, Census Tract 23, Fulton County, Georgia",462,192,125,77,337,206
1500000US131210023003,131210023003,"Block Group 3, Census Tract 23, Fulton County, Georgia",447,142,85,55,362,135
1500000US131210024001,131210024001,"Block Group 1, Census Tract 24, Fulton County, Georgia",1432,371,565,224,867,332
1500000US131210024002,131210024002,"Block Group 2, Census Tract 24, Fulton County, Georgia",935,241,424,153,511,219
1500000US131210025001,131210025001,"Block Group 1, Census Tract 25, Fulton County, Georgia",1541,258,156,69,1385,269
1500000US131210025002,131210025002,"Block Group 2, Census Tract 25, Fulton County, Georgia",559,211,196,128,363,171
1500000US131210026001,131210026001,"Block Group 1, Census Tract 26, Fulton County, Georgia",1205,175,90,67,1115,187
1500000US131210028001,131210028001,"Block Group 1, Census Tract 28, Fulton County, Georgia",1428,218,169,57,1259,206
1500000US131210028002,131210028002,"Block Group 2, Census Tract 28, Fulton County, Georgia",475,252,11,19,464,251
1500000US131210029001,131210029001,"Block Group 1, Census Tract 29, Fulton County, Georgia",2330,271,670,173,1660,287
1500000US131210030001,131210030001,"Block Group 1, Census Tract 30, Fulton County, Georgia",1472,214,562,139,910,211
1500000US131210030002,131210030002,"Block Group 2, Census Tract 30, Fulton County, Georgia",1605,296,1155,276,450,198
1500000US131210031001,131210031001,"Block Group 1, Census Tract 31, Fulton County, Georgia",971,160,609,142,362,135
1500000US131210031002,131210031002,"Block Group 2, Census Tract 31, Fulton County, Georgia",916,203,294,139,622,181
1500000US131210032001,131210032001,"Block Group 1, Census Tract 32, Fulton County, Georgia",2138,196,1162,151,976,234
1500000US131210035001,131210035001,"Block Group 1, Census Tract 35, Fulton County, Georgia",467,120,12,13,455,120
1500000US131210035002,131210035002,"Block Group 2, Census Tract 35, Fulton County, Georgia",439,93,332,85,107,52
1500000US131210036001,131210036001,"Block Group 1, Census Tract 36, Fulton County, Georgia",1294,172,314,109,980,182
1500000US131210037001,131210037001,"Block Group 1, Census Tract 37, Fulton County, Georgia",54,41,0,13,54,41
1500000US131210038001,131210038001,"Block Group 1, Census Tract 38, Fulton County, Georgia",359,100,62,45,297,98
1500000US131210039001,131210039001,"Block Group 1, Census Tract 39, Fulton County, Georgia",1172,296,527,199,645,219
1500000US131210039002,131210039002,"Block Group 2, Census Tract 39, Fulton County, Georgia",768,331,85,45,683,337
1500000US131210040001,131210040001,"Block Group 1, Census Tract 40, Fulton County, Georgia",1148,303,592,192,556,273
1500000US131210040002,131210040002,"Block Group 2, Census Tract 40, Fulton County, Georgia",635,222,282,135,353,190
1500000US131210040003,131210040003,"Block Group 3, Census Tract 40, Fulton County, Georgia",625,197,357,133,268,176
1500000US131210041001,131210041001,"Block Group 1, Census Tract 41, Fulton County, Georgia",486,264,54,47,432,258
1500000US131210041002,131210041002,"Block Group 2, Census Tract 41, Fulton County, Georgia",904,408,99,64,805,407
1500000US131210041003,131210041003,"Block Group 3, Census Tract 41, Fulton County, Georgia",499,167,243,108,256,141
1500000US131210042001,131210042001,"Block Group 1, Census Tract 42, Fulton County, Georgia",414,99,0,13,414,99
1500000US131210042002,131210042002,"Block Group 2, Census Tract 42, Fulton County, Georgia",1797,299,522,241,1275,215
1500000US131210043001,131210043001,"Block Group 1, Census Tract 43, Fulton County, Georgia",0,13,0,13,0,13
1500000US131210043002,131210043002,"Block Group 2, Census Tract 43, Fulton County, Georgia",1133,179,155,64,978,193
1500000US131210044001,131210044001,"Block Group 1, Census Tract 44, Fulton County, Georgia",2509,474,101,133,2408,464
1500000US131210048001,131210048001,"Block Group 1, Census Tract 48, Fulton County, Georgia",1048,154,72,83,976,160
1500000US131210049001,131210049001,"Block Group 1, Census Tract 49, Fulton County, Georgia",1494,332,525,154,969,330
1500000US131210049002,131210049002,"Block Group 2, Census Tract 49, Fulton County, Georgia",1397,215,1108,191,289,200
1500000US131210050001,131210050001,"Block Group 1, Census Tract 50, Fulton County, Georgia",1933,155,1164,174,769,161
1500000US131210052001,131210052001,"Block Group 1, Census Tract 52, Fulton County, Georgia",748,244,599,203,149,134
1500000US131210052002,131210052002,"Block Group 2, Census Tract 52, Fulton County, Georgia",1262,286,663,240,599,264
1500000US131210052003,131210052003,"Block Group 3, Census Tract 52, Fulton County, Georgia",2970,454,1855,398,1115,352
1500000US131210053001,131210053001,"Block Group 1, Census Tract 53, Fulton County, Georgia",1709,242,742,192,967,273
1500000US131210053002,131210053002,"Block Group 2, Census Tract 53, Fulton County, Georgia",1279,331,935,214,344,313
1500000US131210053003,131210053003,"Block Group 3, Census Tract 53, Fulton County, Georgia",688,198,611,203,77,61
1500000US131210055011,131210055011,"Block Group 1, Census Tract 55.01, Fulton County, Georgia",1050,260,425,178,625,236
1500000US131210055012,131210055012,"Block Group 2, Census Tract 55.01, Fulton County, Georgia",1483,289,399,136,1084,293
1500000US131210055021,131210055021,"Block Group 1, Census Tract 55.02, Fulton County, Georgia",2422,337,399,157,2023,343
1500000US131210057001,131210057001,"Block Group 1, Census Tract 57, Fulton County, Georgia",1655,239,195,117,1460,263
1500000US131210058001,131210058001,"Block Group 1, Census Tract 58, Fulton County, Georgia",2023,273,625,170,1398,301
1500000US131210060001,131210060001,"Block Group 1, Census Tract 60, Fulton County, Georgia",600,255,129,70,471,260
1500000US131210060002,131210060002,"Block Group 2, Census Tract 60, Fulton County, Georgia",1121,328,517,207,604,349
1500000US131210060003,131210060003,"Block Group 3, Census Tract 60, Fulton County, Georgia",785,285,220,94,565,293
1500000US131210060004,131210060004,"Block Group 4, Census Tract 60, Fulton County, Georgia",730,244,236,112,494,236
1500000US131210061001,131210061001,"Block Group 1, Census Tract 61, Fulton County, Georgia",580,219,265,160,315,171
1500000US131210061002,131210061002,"Block Group 2, Census Tract 61, Fulton County, Georgia",1295,329,714,344,581,269
1500000US131210061003,131210061003,"Block Group 3, Census Tract 61, Fulton County, Georgia",730,205,539,200,191,130
1500000US131210061004,131210061004,"Block Group 4, Census Tract 61, Fulton County, Georgia",1067,329,491,229,576,286
1500000US131210062001,131210062001,"Block Group 1, Census Tract 62, Fulton County, Georgia",943,194,413,157,530,171
1500000US131210062002,131210062002,"Block Group 2, Census Tract 62, Fulton County, Georgia",532,162,199,90,333,151
1500000US131210063001,131210063001,"Block Group 1, Census Tract 63, Fulton County, Georgia",1079,232,427,150,652,196
1500000US131210063002,131210063002,"Block Group 2, Census Tract 63, Fulton County, Georgia",571,231,120,69,451,219
1500000US131210064001,131210064001,"Block Group 1, Census Tract 64, Fulton County, Georgia",1156,161,367,125,789,160
1500000US131210065001,131210065001,"Block Group 1, Census Tract 65, Fulton County, Georgia",683,233,557,239,126,104
1500000US131210065002,131210065002,"Block Group 2, Census Tract 65, Fulton County, Georgia",1683,432,1135,396,548,276
1500000US131210065003,131210065003,"Block Group 3, Census Tract 65, Fulton County, Georgia",605,241,496,210,109,124
1500000US131210065004,131210065004,"Block Group 4, Census Tract 65, Fulton County, Georgia",1303,601,442,210,861,598
1500000US131210066011,131210066011,"Block Group 1, Census Tract 66.01, Fulton County, Georgia",848,238,450,174,398,186
1500000US131210066012,131210066012,"Block Group 2, Census Tract 66.01, Fulton County, Georgia",1364,333,606,207,758,312
1500000US131210066021,131210066021,"Block Group 1, Census Tract 66.02, Fulton County, Georgia",1363,212,278,115,1085,214
1500000US131210067001,131210067001,"Block Group 1, Census Tract 67, Fulton County, Georgia",833,438,255,156,578,412
1500000US131210067002,131210067002,"Block Group 2, Census Tract 67, Fulton County, Georgia",1560,419,493,180,1067,409
1500000US131210067003,131210067003,"Block Group 3, Census Tract 67, Fulton County, Georgia",1340,377,733,343,607,249
1500000US131210068011,131210068011,"Block Group 1, Census Tract 68.01, Fulton County, Georgia",0,13,0,13,0,13
1500000US131210068021,131210068021,"Block Group 1, Census Tract 68.02, Fulton County, Georgia",1992,284,150,57,1842,287
1500000US131210069001,131210069001,"Block Group 1, Census Tract 69, Fulton County, Georgia",974,264,315,118,659,283
1500000US131210069002,131210069002,"Block Group 2, Census Tract 69, Fulton County, Georgia",1335,352,426,183,909,308
1500000US131210069003,131210069003,"Block Group 3, Census Tract 69, Fulton County, Georgia",1242,238,812,210,430,192
1500000US131210070011,131210070011,"Block Group 1, Census Tract 70.01, Fulton County, Georgia",2382,597,558,208,1824,609
1500000US131210070012,131210070012,"Block Group 2, Census Tract 70.01, Fulton County, Georgia",1168,444,619,273,549,349
1500000US131210070013,131210070013,"Block Group 3, Census Tract 70.01, Fulton County, Georgia",1190,393,738,361,452,239
1500000US131210070021,131210070021,"Block Group 1, Census Tract 70.02, Fulton County, Georgia",860,297,267,164,593,323
1500000US131210070022,131210070022,"Block Group 2, Census Tract 70.02, Fulton County, Georgia",429,241,102,69,327,224
1500000US131210070023,131210070023,"Block Group 3, Census Tract 70.02, Fulton County, Georgia",297,131,153,112,144,103
1500000US131210070024,131210070024,"Block Group 4, Census Tract 70.02, Fulton County, Georgia",302,214,0,13,302,214
1500000US131210071001,131210071001,"Block Group 1, Census Tract 71, Fulton County, Georgia",858,223,368,134,490,175
1500000US131210071002,131210071002,"Block Group 2, Census Tract 71, Fulton County, Georgia",1151,294,482,175,669,295
1500000US131210072001,131210072001,"Block Group 1, Census Tract 72, Fulton County, Georgia",1682,322,597,183,1085,323
1500000US131210072002,131210072002,"Block Group 2, Census Tract 72, Fulton County, Georgia",342,144,166,74,176,134
1500000US131210073001,131210073001,"Block Group 1, Census Tract 73, Fulton County, Georgia",2638,724,956,511,1682,514
1500000US131210073002,131210073002,"Block Group 2, Census Tract 73, Fulton County, Georgia",3397,737,683,283,2714,759
1500000US131210073003,131210073003,"Block Group 3, Census Tract 73, Fulton County, Georgia",1909,589,175,217,1734,570
1500000US131210074001,131210074001,"Block Group 1, Census Tract 74, Fulton County, Georgia",1406,435,352,199,1054,387
1500000US131210074002,131210074002,"Block Group 2, Census Tract 74, Fulton County, Georgia",1260,338,157,124,1103,328
1500000US131210075001,131210075001,"Block Group 1, Census Tract 75, Fulton County, Georgia",902,250,217,183,685,236
1500000US131210075002,131210075002,"Block Group 2, Census Tract 75, Fulton County, Georgia",511,232,154,77,357,254
1500000US131210075003,131210075003,"Block Group 3, Census Tract 75, Fulton County, Georgia",800,165,285,136,515,120
1500000US131210075004,131210075004,"Block Group 4, Census Tract 75, Fulton County, Georgia",815,248,180,139,635,218
1500000US131210076021,131210076021,"Block Group 1, Census Tract 76.02, Fulton County, Georgia",595,171,202,144,393,171
1500000US131210076022,131210076022,"Block Group 2, Census Tract 76.02, Fulton County, Georgia",903,225,351,119,552,187
1500000US131210076023,131210076023,"Block Group 3, Census Tract 76.02, Fulton County, Georgia",1055,255,390,109,665,243
1500000US131210076031,131210076031,"Block Group 1, Census Tract 76.03, Fulton County, Georgia",1553,474,82,59,1471,494
1500000US131210076032,131210076032,"Block Group 2, Census Tract 76.03, Fulton County, Georgia",1630,409,14,23,1616,407
1500000US131210076033,131210076033,"Block Group 3, Census Tract 76.03, Fulton County, Georgia",1289,402,106,103,1183,409
1500000US131210076041,131210076041,"Block Group 1, Census Tract 76.04, Fulton County, Georgia",2331,490,400,183,1931,516
1500000US131210077031,131210077031,"Block Group 1, Census Tract 77.03, Fulton County, Georgia",1071,376,817,361,254,205
1500000US131210077032,131210077032,"Block Group 2, Census Tract 77.03, Fulton County, Georgia",1740,458,799,264,941,367
1500000US131210077033,131210077033,"Block Group 3, Census Tract 77.03, Fulton County, Georgia",1341,345,937,329,404,147
1500000US131210077041,131210077041,"Block Group 1, Census Tract 77.04, Fulton County, Georgia",817,310,234,234,583,267
1500000US131210077042,131210077042,"Block Group 2, Census Tract 77.04, Fulton County, Georgia",2156,434,663,297,1493,423
1500000US131210077043,131210077043,"Block Group 3, Census Tract 77.04, Fulton County, Georgia",2344,422,1488,276,856,401
1500000US131210077051,131210077051,"Block Group 1, Census Tract 77.05, Fulton County, Georgia",2517,696,451,269,2066,653
1500000US131210077052,131210077052,"Block Group 2, Census Tract 77.05, Fulton County, Georgia",2504,539,772,270,1732,512
1500000US131210077061,131210077061,"Block Group 1, Census Tract 77.06, Fulton County, Georgia",2820,946,503,277,2317,973
1500000US131210077062,131210077062,"Block Group 2, Census Tract 77.06, Fulton County, Georgia",2248,561,432,296,1816,487
1500000US131210077063,131210077063,"Block Group 3, Census Tract 77.06, Fulton County, Georgia",4422,970,1452,531,2970,989
1500000US131210078021,131210078021,"Block Group 1, Census Tract 78.02, Fulton County, Georgia",4140,877,1558,647,2582,654
1500000US131210078022,131210078022,"Block Group 2, Census Tract 78.02, Fulton County, Georgia",2852,734,2054,550,798,456
1500000US131210078023,131210078023,"Block Group 3, Census Tract 78.02, Fulton County, Georgia",1207,595,1148,590,59,76
1500000US131210078024,131210078024,"Block Group 4, Census Tract 78.02, Fulton County, Georgia",1815,618,1470,525,345,332
1500000US131210078051,131210078051,"Block Group 1, Census Tract 78.05, Fulton County, Georgia",1220,614,423,224,797,591
1500000US131210078052,131210078052,"Block Group 2, Census Tract 78.05, Fulton County, Georgia",1763,379,820,227,943,317
1500000US131210078061,131210078061,"Block Group 1, Census Tract 78.06, Fulton County, Georgia",1676,535,1118,476,558,388
1500000US131210078062,131210078062,"Block Group 2, Census Tract 78.06, Fulton County, Georgia",3863,799,962,556,2901,820
1500000US131210078063,131210078063,"Block Group 3, Census Tract 78.06, Fulton County, Georgia",1055,388,976,362,79,129
1500000US131210078071,131210078071,"Block Group 1, Census Tract 78.07, Fulton County, Georgia",2537,694,353,130,2184,714
1500000US131210078072,131210078072,"Block Group 2, Census Tract 78.07, Fulton County, Georgia",666,210,423,168,243,138
1500000US131210078081,131210078081,"Block Group 1, Census Tract 78.08, Fulton County, Georgia",1900,392,347,248,1553,340
1500000US131210078082,131210078082,"Block Group 2, Census Tract 78.08, Fulton County, Georgia",2587,481,12,19,2575,481
1500000US131210079001,131210079001,"Block Group 1, Census Tract 79, Fulton County, Georgia",1819,538,1604,586,215,174
1500000US131210079002,131210079002,"Block Group 2, Census Tract 79, Fulton County, Georgia",1231,379,915,300,316,336
1500000US131210079003,131210079003,"Block Group 3, Census Tract 79, Fulton County, Georgia",2673,674,1689,541,984,531
1500000US131210080001,131210080001,"Block Group 1, Census Tract 80, Fulton County, Georgia",1064,395,566,233,498,354
1500000US131210080002,131210080002,"Block Group 2, Census Tract 80, Fulton County, Georgia",1205,354,837,257,368,306
1500000US131210080003,131210080003,"Block Group 3, Census Tract 80, Fulton County, Georgia",496,178,189,82,307,156
1500000US131210080004,131210080004,"Block Group 4, Census Tract 80, Fulton County, Georgia",1255,406,628,263,627,347
1500000US131210080005,131210080005,"Block Group 5, Census Tract 80, Fulton County, Georgia",1399,315,758,262,641,286
1500000US131210081011,131210081011,"Block Group 1, Census Tract 81.01, Fulton County, Georgia",1138,148,805,112,333,142
1500000US131210081021,131210081021,"Block Group 1, Census Tract 81.02, Fulton County, Georgia",1278,508,665,484,613,299
1500000US131210081022,131210081022,"Block Group 2, Census Tract 81.02, Fulton County, Georgia",940,516,394,176,546,506
1500000US131210081023,131210081023,"Block Group 3, Census Tract 81.02, Fulton County, Georgia",2160,885,254,251,1906,853
1500000US131210081024,131210081024,"Block Group 4, Census Tract 81.02, Fulton County, Georgia",2653,800,685,540,1968,622
1500000US131210082011,131210082011,"Block Group 1, Census Tract 82.01, Fulton County, Georgia",1951,499,1417,422,534,314
1500000US131210082012,131210082012,"Block Group 2, Census Tract 82.01, Fulton County, Georgia",3083,741,1108,429,1975,721
1500000US131210082013,131210082013,"Block Group 3, Census Tract 82.01, Fulton County, Georgia",960,456,326,183,634,446
1500000US131210082021,131210082021,"Block Group 1, Census Tract 82.02, Fulton County, Georgia",948,223,431,194,517,227
1500000US131210082022,131210082022,"Block Group 2, Census Tract 82.02, Fulton County, Georgia",836,188,245,96,591,176
1500000US131210082023,131210082023,"Block Group 3, Census Tract 82.02, Fulton County, Georgia",257,106,31,25,226,101
1500000US131210082024,131210082024,"Block Group 4, Census Tract 82.02, Fulton County, Georgia",0,13,0,13,0,13
1500000US131210083011,131210083011,"Block Group 1, Census Tract 83.01, Fulton County, Georgia",1601,360,317,133,1284,363
1500000US131210083012,131210083012,"Block Group 2, Census Tract 83.01, Fulton County, Georgia",604,271,489,242,115,84
1500000US131210083021,131210083021,"Block Group 1, Census Tract 83.02, Fulton County, Georgia",793,181,233,106,560,174
1500000US131210083022,131210083022,"Block Group 2, Census Tract 83.02, Fulton County, Georgia",961,187,611,190,350,149
1500000US131210084001,131210084001,"Block Group 1, Census Tract 84, Fulton County, Georgia",1472,491,412,350,1060,417
1500000US131210084002,131210084002,"Block Group 2, Census Tract 84, Fulton County, Georgia",883,298,237,131,646,281
1500000US131210084003,131210084003,"Block Group 3, Census Tract 84, Fulton County, Georgia",599,217,195,99,404,200
1500000US131210085001,131210085001,"Block Group 1, Census Tract 85, Fulton County, Georgia",548,257,205,204,343,215
1500000US131210085002,131210085002,"Block Group 2, Census Tract 85, Fulton County, Georgia",1248,540,561,245,687,515
1500000US131210085003,131210085003,"Block Group 3, Census Tract 85, Fulton County, Georgia",1222,345,628,297,594,279
1500000US131210086011,131210086011,"Block Group 1, Census Tract 86.01, Fulton County, Georgia",1648,389,33,25,1615,389
1500000US131210086012,131210086012,"Block Group 2, Census Tract 86.01, Fulton County, Georgia",891,344,288,162,603,330
1500000US131210086013,131210086013,"Block Group 3, Census Tract 86.01, Fulton County, Georgia",1409,339,834,204,575,326
1500000US131210086014,131210086014,"Block Group 4, Census Tract 86.01, Fulton County, Georgia",348,109,133,84,215,89
1500000US131210086021,131210086021,"Block Group 1, Census Tract 86.02, Fulton County, Georgia",803,204,302,84,501,193
1500000US131210086022,131210086022,"Block Group 2, Census Tract 86.02, Fulton County, Georgia",260,122,96,90,164,101
1500000US131210087001,131210087001,"Block Group 1, Census Tract 87, Fulton County, Georgia",1009,337,248,112,761,355
1500000US131210087002,131210087002,"Block Group 2, Census Tract 87, Fulton County, Georgia",818,310,154,95,664,318
1500000US131210087003,131210087003,"Block Group 3, Census Tract 87, Fulton County, Georgia",969,246,281,127,688,224
1500000US131210087004,131210087004,"Block Group 4, Census Tract 87, Fulton County, Georgia",1562,334,389,153,1173,301
1500000US131210088001,131210088001,"Block Group 1, Census Tract 88, Fulton County, Georgia",2944,388,2284,490,660,329
1500000US131210088002,131210088002,"Block Group 2, Census Tract 88, Fulton County, Georgia",1625,420,1099,494,526,291
1500000US131210089021,131210089021,"Block Group 1, Census Tract 89.02, Fulton County, Georgia",1876,445,698,321,1178,290
1500000US131210089022,131210089022,"Block Group 2, Census Tract 89.02, Fulton County, Georgia",659,228,261,161,398,190
1500000US131210089023,131210089023,"Block Group 3, Census Tract 89.02, Fulton County, Georgia",1269,352,331,204,938,362
1500000US131210089024,131210089024,"Block Group 4, Census Tract 89.02, Fulton County, Georgia",2722,504,1089,273,1633,473
1500000US131210089031,131210089031,"Block Group 1, Census Tract 89.03, Fulton County, Georgia",1684,401,808,388,876,290
1500000US131210089041,131210089041,"Block Group 1, Census Tract 89.04, Fulton County, Georgia",1323,222,870,185,453,184
1500000US131210089042,131210089042,"Block Group 2, Census Tract 89.04, Fulton County, Georgia",1638,389,524,164,1114,368
1500000US131210089043,131210089043,"Block Group 3, Census Tract 89.04, Fulton County, Georgia",1611,298,1404,255,207,158
1500000US131210090001,131210090001,"Block Group 1, Census Tract 90, Fulton County, Georgia",1350,219,1200,229,150,143
1500000US131210090002,131210090002,"Block Group 2, Census Tract 90, Fulton County, Georgia",1769,263,1716,256,53,49
1500000US131210090003,131210090003,"Block Group 3, Census Tract 90, Fulton County, Georgia",1829,262,704,165,1125,227
1500000US131210091011,131210091011,"Block Group 1, Census Tract 91.01, Fulton County, Georgia",1369,300,628,187,741,273
1500000US131210091012,131210091012,"Block Group 2, Census Tract 91.01, Fulton County, Georgia",1565,367,619,221,946,246
1500000US131210091013,131210091013,"Block Group 3, Census Tract 91.01, Fulton County, Georgia",627,369,47,47,580,370
1500000US131210091014,131210091014,"Block Group 4, Census Tract 91.01, Fulton County, Georgia",1001,221,438,141,563,192
1500000US131210091021,131210091021,"Block Group 1, Census Tract 91.02, Fulton County, Georgia",443,171,443,171,0,13
1500000US131210091022,131210091022,"Block Group 2, Census Tract 91.02, Fulton County, Georgia",825,246,386,155,439,207
1500000US131210091023,131210091023,"Block Group 3, Census Tract 91.02, Fulton County, Georgia",1840,277,574,233,1266,276
1500000US131210092001,131210092001,"Block Group 1, Census Tract 92, Fulton County, Georgia",2404,338,700,240,1704,315
1500000US131210092002,131210092002,"Block Group 2, Census Tract 92, Fulton County, Georgia",2976,748,358,204,2618,783
1500000US131210092003,131210092003,"Block Group 3, Census Tract 92, Fulton County, Georgia",1703,332,539,225,1164,318
1500000US131210093001,131210093001,"Block Group 1, Census Tract 93, Fulton County, Georgia",1079,298,779,227,300,273
1500000US131210093002,131210093002,"Block Group 2, Census Tract 93, Fulton County, Georgia",1319,371,383,150,936,354
1500000US131210093003,131210093003,"Block Group 3, Census Tract 93, Fulton County, Georgia",1510,300,1234,292,276,138
1500000US131210093004,131210093004,"Block Group 4, Census Tract 93, Fulton County, Georgia",750,214,740,215,10,17
1500000US131210094021,131210094021,"Block Group 1, Census Tract 94.02, Fulton County, Georgia",2795,305,44,45,2751,310
1500000US131210094022,131210094022,"Block Group 2, Census Tract 94.02, Fulton County, Georgia",2227,461,358,123,1869,464
1500000US131210094031,131210094031,"Block Group 1, Census Tract 94.03, Fulton County, Georgia",2448,610,505,203,1943,611
1500000US131210094032,131210094032,"Block Group 2, Census Tract 94.03, Fulton County, Georgia",1245,363,182,92,1063,354
1500000US131210094033,131210094033,"Block Group 3, Census Tract 94.03, Fulton County, Georgia",1279,400,73,47,1206,403
1500000US131210094041,131210094041,"Block Group 1, Census Tract 94.04, Fulton County, Georgia",2515,439,1889,469,626,391
1500000US131210094042,131210094042,"Block Group 2, Census Tract 94.04, Fulton County, Georgia",1995,430,754,281,1241,395
1500000US131210094043,131210094043,"Block Group 3, Census Tract 94.04, Fulton County, Georgia",311,191,166,144,145,121
1500000US131210095011,131210095011,"Block Group 1, Census Tract 95.01, Fulton County, Georgia",470,204,259,127,211,183
1500000US131210095012,131210095012,"Block Group 2, Census Tract 95.01, Fulton County, Georgia",1736,301,1440,303,296,110
1500000US131210095013,131210095013,"Block Group 3, Census Tract 95.01, Fulton County, Georgia",1588,269,1525,274,63,74
1500000US131210095021,131210095021,"Block Group 1, Census Tract 95.02, Fulton County, Georgia",490,219,445,215,45,53
1500000US131210095022,131210095022,"Block Group 2, Census Tract 95.02, Fulton County, Georgia",297,167,164,87,133,154
1500000US131210095023,131210095023,"Block Group 3, Census Tract 95.02, Fulton County, Georgia",960,390,592,353,368,199
1500000US131210095024,131210095024,"Block Group 4, Census Tract 95.02, Fulton County, Georgia",1100,334,359,219,741,276
1500000US131210096011,131210096011,"Block Group 1, Census Tract 96.01, Fulton County, Georgia",1003,318,503,135,500,303
1500000US131210096012,131210096012,"Block Group 2, Census Tract 96.01, Fulton County, Georgia",1414,294,404,187,1010,267
1500000US131210096021,131210096021,"Block Group 1, Census Tract 96.02, Fulton County, Georgia",1234,247,478,174,756,228
1500000US131210096022,131210096022,"Block Group 2, Census Tract 96.02, Fulton County, Georgia",2131,321,925,278,1206,279
1500000US131210096023,131210096023,"Block Group 3, Census Tract 96.02, Fulton County, Georgia",1245,282,1202,286,43,53
1500000US131210096031,131210096031,"Block Group 1, Census Tract 96.03, Fulton County, Georgia",1086,236,396,176,690,187
1500000US131210096032,131210096032,"Block Group 2, Census Tract 96.03, Fulton County, Georgia",1374,358,844,293,530,207
1500000US131210096033,131210096033,"Block Group 3, Census Tract 96.03, Fulton County, Georgia",1734,447,758,306,976,442
1500000US131210097001,131210097001,"Block Group 1, Census Tract 97, Fulton County, Georgia",995,296,902,300,93,78
1500000US131210097002,131210097002,"Block Group 2, Census Tract 97, Fulton County, Georgia",1032,202,941,205,91,85
1500000US131210097003,131210097003,"Block Group 3, Census Tract 97, Fulton County, Georgia",1896,308,1716,299,180,169
1500000US131210098011,131210098011,"Block Group 1, Census Tract 98.01, Fulton County, Georgia",1737,227,1152,225,585,161
1500000US131210098012,131210098012,"Block Group 2, Census Tract 98.01, Fulton County, Georgia",1692,259,1641,252,51,66
1500000US131210098013,131210098013,"Block Group 3, Census Tract 98.01, Fulton County, Georgia",1375,362,1375,362,0,13
1500000US131210098021,131210098021,"Block Group 1, Census Tract 98.02, Fulton County, Georgia",1774,306,1688,318,86,97
1500000US131210098022,131210098022,"Block Group 2, Census Tract 98.02, Fulton County, Georgia",2710,364,1522,317,1188,249
1500000US131210099001,131210099001,"Block Group 1, Census Tract 99, Fulton County, Georgia",1579,278,828,251,751,196
1500000US131210099002,131210099002,"Block Group 2, Census Tract 99, Fulton County, Georgia",1190,366,1190,366,0,13
1500000US131210099003,131210099003,"Block Group 3, Census Tract 99, Fulton County, Georgia",1330,495,1330,495,0,13
1500000US131210099004,131210099004,"Block Group 4, Census Tract 99, Fulton County, Georgia",669,247,669,247,0,13
1500000US131210100011,131210100011,"Block Group 1, Census Tract 100.01, Fulton County, Georgia",1482,412,1223,402,259,131
1500000US131210100012,131210100012,"Block Group 2, Census Tract 100.01, Fulton County, Georgia",1076,466,803,277,273,392
1500000US131210100013,131210100013,"Block Group 3, Census Tract 100.01, Fulton County, Georgia",718,250,718,250,0,13
1500000US131210100014,131210100014,"Block Group 4, Census Tract 100.01, Fulton County, Georgia",1228,390,842,311,386,269
1500000US131210100021,131210100021,"Block Group 1, Census Tract 100.02, Fulton County, Georgia",1474,274,1474,274,0,13
1500000US131210100022,131210100022,"Block Group 2, Census Tract 100.02, Fulton County, Georgia",2041,462,2041,462,0,13
1500000US131210100023,131210100023,"Block Group 3, Census Tract 100.02, Fulton County, Georgia",3828,680,2122,539,1706,424
1500000US131210101061,131210101061,"Block Group 1, Census Tract 101.06, Fulton County, Georgia",2099,356,1188,255,911,228
1500000US131210101062,131210101062,"Block Group 2, Census Tract 101.06, Fulton County, Georgia",881,281,139,65,742,294
1500000US131210101063,131210101063,"Block Group 3, Census Tract 101.06, Fulton County, Georgia",1087,291,1087,291,0,13
1500000US131210101071,131210101071,"Block Group 1, Census Tract 101.07, Fulton County, Georgia",912,123,880,124,32,35
1500000US131210101072,131210101072,"Block Group 2, Census Tract 101.07, Fulton County, Georgia",986,162,839,127,147,117
1500000US131210101081,131210101081,"Block Group 1, Census Tract 101.08, Fulton County, Georgia",1266,215,1266,215,0,13
1500000US131210101082,131210101082,"Block Group 2, Census Tract 101.08, Fulton County, Georgia",2333,225,2134,226,199,74
1500000US131210101101,131210101101,"Block Group 1, Census Tract 101.10, Fulton County, Georgia",2609,430,1622,416,987,276
1500000US131210101102,131210101102,"Block Group 2, Census Tract 101.10, Fulton County, Georgia",1118,420,565,334,553,287
1500000US131210101103,131210101103,"Block Group 3, Census Tract 101.10, Fulton County, Georgia",1756,445,687,295,1069,407
1500000US131210101131,131210101131,"Block Group 1, Census Tract 101.13, Fulton County, Georgia",1749,369,419,223,1330,323
1500000US131210101132,131210101132,"Block Group 2, Census Tract 101.13, Fulton County, Georgia",3024,772,0,13,3024,772
1500000US131210101133,131210101133,"Block Group 3, Census Tract 101.13, Fulton County, Georgia",1975,701,719,461,1256,703
1500000US131210101141,131210101141,"Block Group 1, Census Tract 101.14, Fulton County, Georgia",1953,780,1438,820,515,197
1500000US131210101142,131210101142,"Block Group 2, Census Tract 101.14, Fulton County, Georgia",2988,853,1193,429,1795,700
1500000US131210101143,131210101143,"Block Group 3, Census Tract 101.14, Fulton County, Georgia",2408,588,1057,441,1351,460
1500000US131210101151,131210101151,"Block Group 1, Census Tract 101.15, Fulton County, Georgia",2126,323,1539,309,587,192
1500000US131210101171,131210101171,"Block Group 1, Census Tract 101.17, Fulton County, Georgia",2494,344,170,73,2324,356
1500000US131210101172,131210101172,"Block Group 2, Census Tract 101.17, Fulton County, Georgia",838,204,113,72,725,195
1500000US131210101181,131210101181,"Block Group 1, Census Tract 101.18, Fulton County, Georgia",3083,794,983,242,2100,749
1500000US131210101182,131210101182,"Block Group 2, Census Tract 101.18, Fulton County, Georgia",974,400,76,72,898,416
1500000US131210101183,131210101183,"Block Group 3, Census Tract 101.18, Fulton County, Georgia",1377,366,106,95,1271,357
1500000US131210101191,131210101191,"Block Group 1, Census Tract 101.19, Fulton County, Georgia",1387,409,203,129,1184,398
1500000US131210101192,131210101192,"Block Group 2, Census Tract 101.19, Fulton County, Georgia",1916,678,77,77,1839,670
1500000US131210101193,131210101193,"Block Group 3, Census Tract 101.19, Fulton County, Georgia",1678,533,211,147,1467,538
1500000US131210101201,131210101201,"Block Group 1, Census Tract 101.20, Fulton County, Georgia",2302,229,808,191,1494,291
1500000US131210101211,131210101211,"Block Group 1, Census Tract 101.21, Fulton County, Georgia",2199,191,1517,226,682,151
1500000US131210101221,131210101221,"Block Group 1, Census Tract 101.22, Fulton County, Georgia",2320,508,1243,298,1077,417
1500000US131210101222,131210101222,"Block Group 2, Census Tract 101.22, Fulton County, Georgia",1853,518,1042,475,811,296
1500000US131210101223,131210101223,"Block Group 3, Census Tract 101.22, Fulton County, Georgia",2096,365,42,68,2054,374
1500000US131210101231,131210101231,"Block Group 1, Census Tract 101.23, Fulton County, Georgia",2793,640,704,247,2089,654
1500000US131210101232,131210101232,"Block Group 2, Census Tract 101.23, Fulton County, Georgia",1396,480,1315,496,81,74
1500000US131210101233,131210101233,"Block Group 3, Census Tract 101.23, Fulton County, Georgia",1704,786,362,203,1342,786
1500000US131210102041,131210102041,"Block Group 1, Census Tract 102.04, Fulton County, Georgia",1056,273,1031,273,25,29
1500000US131210102042,131210102042,"Block Group 2, Census Tract 102.04, Fulton County, Georgia",1991,254,1907,265,84,91
1500000US131210102043,131210102043,"Block Group 3, Census Tract 102.04, Fulton County, Georgia",1242,230,1197,229,45,70
1500000US131210102044,131210102044,"Block Group 4, Census Tract 102.04, Fulton County, Georgia",607,131,591,134,16,26
1500000US131210102051,131210102051,"Block Group 1, Census Tract 102.05, Fulton County, Georgia",938,243,836,244,102,110
1500000US131210102052,131210102052,"Block Group 2, Census Tract 102.05, Fulton County, Georgia",1057,288,674,282,383,211
1500000US131210102053,131210102053,"Block Group 3, Census Tract 102.05, Fulton County, Georgia",1933,362,1814,349,119,134
1500000US131210102054,131210102054,"Block Group 4, Census Tract 102.05, Fulton County, Georgia",1050,274,775,221,275,172
1500000US131210102061,131210102061,"Block Group 1, Census Tract 102.06, Fulton County, Georgia",2365,396,2030,364,335,202
1500000US131210102062,131210102062,"Block Group 2, Census Tract 102.06, Fulton County, Georgia",1552,211,1466,208,86,82
1500000US131210102063,131210102063,"Block Group 3, Census Tract 102.06, Fulton County, Georgia",1343,259,1332,260,11,16
1500000US131210102081,131210102081,"Block Group 1, Census Tract 102.08, Fulton County, Georgia",1799,336,1053,221,746,281
1500000US131210102082,131210102082,"Block Group 2, Census Tract 102.08, Fulton County, Georgia",336,160,0,13,336,160
1500000US131210102083,131210102083,"Block Group 3, Census Tract 102.08, Fulton County, Georgia",2058,465,390,195,1668,434
1500000US131210102091,131210102091,"Block Group 1, Census Tract 102.09, Fulton County, Georgia",1206,333,352,143,854,323
1500000US131210102092,131210102092,"Block Group 2, Census Tract 102.09, Fulton County, Georgia",969,293,767,252,202,188
1500000US131210102093,131210102093,"Block Group 3, Census Tract 102.09, Fulton County, Georgia",3600,689,184,104,3416,691
1500000US131210102101,131210102101,"Block Group 1, Census Tract 102.10, Fulton County, Georgia",1534,408,874,355,660,278
1500000US131210102102,131210102102,"Block Group 2, Census Tract 102.10, Fulton County, Georgia",2304,447,1349,344,955,396
1500000US131210102103,131210102103,"Block Group 3, Census Tract 102.10, Fulton County, Georgia",1950,411,1303,308,647,300
1500000US131210102111,131210102111,"Block Group 1, Census Tract 102.11, Fulton County, Georgia",1227,260,1205,260,22,42
1500000US131210102112,131210102112,"Block Group 2, Census Tract 102.11, Fulton County, Georgia",2030,418,1528,421,502,230
1500000US131210102121,131210102121,"Block Group 1, Census Tract 102.12, Fulton County, Georgia",1999,549,413,322,1586,552
1500000US131210102122,131210102122,"Block Group 2, Census Tract 102.12, Fulton County, Georgia",773,265,669,222,104,124
1500000US131210102123,131210102123,"Block Group 3, Census Tract 102.12, Fulton County, Georgia",2256,525,824,201,1432,497
1500000US131210103011,131210103011,"Block Group 1, Census Tract 103.01, Fulton County, Georgia",9717,1593,7710,1458,2007,1036
1500000US131210103012,131210103012,"Block Group 2, Census Tract 103.01, Fulton County, Georgia",6419,1362,4964,1394,1455,641
1500000US131210103031,131210103031,"Block Group 1, Census Tract 103.03, Fulton County, Georgia",3102,656,2195,571,907,441
1500000US131210103032,131210103032,"Block Group 2, Census Tract 103.03, Fulton County, Georgia",6383,885,4165,753,2218,534
1500000US131210103041,131210103041,"Block Group 1, Census Tract 103.04, Fulton County, Georgia",4897,1192,4119,1128,778,508
1500000US131210103042,131210103042,"Block Group 2, Census Tract 103.04, Fulton County, Georgia",10474,1553,8311,1518,2163,1243
1500000US131210104001,131210104001,"Block Group 1, Census Tract 104, Fulton County, Georgia",1756,403,1492,358,264,210
1500000US131210104002,131210104002,"Block Group 2, Census Tract 104, Fulton County, Georgia",1443,289,1106,263,337,154
1500000US131210104003,131210104003,"Block Group 3, Census Tract 104, Fulton County, Georgia",3885,759,2899,626,986,673
1500000US131210104004,131210104004,"Block Group 4, Census Tract 104, Fulton County, Georgia",1297,405,807,273,490,303
1500000US131210105071,131210105071,"Block Group 1, Census Tract 105.07, Fulton County, Georgia",3119,873,1953,698,1166,660
1500000US131210105072,131210105072,"Block Group 2, Census Tract 105.07, Fulton County, Georgia",1055,535,637,516,418,197
1500000US131210105073,131210105073,"Block Group 3, Census Tract 105.07, Fulton County, Georgia",2146,708,494,280,1652,735
1500000US131210105074,131210105074,"Block Group 4, Census Tract 105.07, Fulton County, Georgia",2021,574,1226,523,795,481
1500000US131210105081,131210105081,"Block Group 1, Census Tract 105.08, Fulton County, Georgia",4002,597,2785,497,1217,530
1500000US131210105101,131210105101,"Block Group 1, Census Tract 105.10, Fulton County, Georgia",3030,951,1395,687,1635,837
1500000US131210105102,131210105102,"Block Group 2, Census Tract 105.10, Fulton County, Georgia",1265,786,208,156,1057,777
1500000US131210105103,131210105103,"Block Group 3, Census Tract 105.10, Fulton County, Georgia",9365,1510,4627,1341,4738,1507
1500000US131210105104,131210105104,"Block Group 4, Census Tract 105.10, Fulton County, Georgia",2141,920,1582,900,559,584
1500000US131210105111,131210105111,"Block Group 1, Census Tract 105.11, Fulton County, Georgia",1838,461,1076,346,762,348
1500000US131210105112,131210105112,"Block Group 2, Census Tract 105.11, Fulton County, Georgia",5839,957,4855,941,984,486
1500000US131210105113,131210105113,"Block Group 3, Census Tract 105.11, Fulton County, Georgia",611,243,480,243,131,130
1500000US131210105121,131210105121,"Block Group 1, Census Tract 105.12, Fulton County, Georgia",3387,763,441,229,2946,727
1500000US131210105122,131210105122,"Block Group 2, Census Tract 105.12, Fulton County, Georgia",1042,360,463,304,579,293
1500000US131210105123,131210105123,"Block Group 3, Census Tract 105.12, Fulton County, Georgia",2220,564,562,295,1658,480
1500000US131210105131,131210105131,"Block Group 1, Census Tract 105.13, Fulton County, Georgia",4628,1014,3759,930,869,575
1500000US131210105132,131210105132,"Block Group 2, Census Tract 105.13, Fulton County, Georgia",3191,982,1509,771,1682,717
1500000US131210105133,131210105133,"Block Group 3, Census Tract 105.13, Fulton County, Georgia",5198,888,3718,1005,1480,662
1500000US131210105141,131210105141,"Block Group 1, Census Tract 105.14, Fulton County, Georgia",4132,783,3700,739,432,388
1500000US131210105142,131210105142,"Block Group 2, Census Tract 105.14, Fulton County, Georgia",4389,832,3032,674,1357,773
1500000US131210105143,131210105143,"Block Group 3, Census Tract 105.14, Fulton County, Georgia",3185,982,1017,688,2168,877
1500000US131210105151,131210105151,"Block Group 1, Census Tract 105.15, Fulton County, Georgia",4809,670,2922,692,1887,722
1500000US131210105161,131210105161,"Block Group 1, Census Tract 105.16, Fulton County, Georgia",2711,831,1492,417,1219,745
1500000US131210105162,131210105162,"Block Group 2, Census Tract 105.16, Fulton County, Georgia",3823,1041,2641,757,1182,823
1500000US131210105163,131210105163,"Block Group 3, Census Tract 105.16, Fulton County, Georgia",2377,1093,1412,1006,965,691
1500000US131210106011,131210106011,"Block Group 1, Census Tract 106.01, Fulton County, Georgia",1242,332,757,338,485,151
1500000US131210106012,131210106012,"Block Group 2, Census Tract 106.01, Fulton County, Georgia",1078,300,184,110,894,282
1500000US131210106013,131210106013,"Block Group 3, Census Tract 106.01, Fulton County, Georgia",486,173,258,109,228,151
1500000US131210106014,131210106014,"Block Group 4, Census Tract 106.01, Fulton County, Georgia",781,246,258,119,523,270
1500000US131210106031,131210106031,"Block Group 1, Census Tract 106.03, Fulton County, Georgia",833,367,16,14,817,365
1500000US131210106032,131210106032,"Block Group 2, Census Tract 106.03, Fulton County, Georgia",2224,451,548,254,1676,432
1500000US131210106033,131210106033,"Block Group 3, Census Tract 106.03, Fulton County, Georgia",752,376,0,13,752,376
1500000US131210106041,131210106041,"Block Group 1, Census Tract 106.04, Fulton County, Georgia",639,186,0,13,639,186
1500000US131210106042,131210106042,"Block Group 2, Census Tract 106.04, Fulton County, Georgia",223,128,0,13,223,128
1500000US131210106043,131210106043,"Block Group 3, Census Tract 106.04, Fulton County, Georgia",1896,425,983,261,913,385
1500000US131210108001,131210108001,"Block Group 1, Census Tract 108, Fulton County, Georgia",537,366,118,131,419,372
1500000US131210108002,131210108002,"Block Group 2, Census Tract 108, Fulton County, Georgia",1002,472,678,423,324,388
1500000US131210108003,131210108003,"Block Group 3, Census Tract 108, Fulton County, Georgia",2013,572,440,336,1573,551
1500000US131210108004,131210108004,"Block Group 4, Census Tract 108, Fulton County, Georgia",1428,580,168,131,1260,590
1500000US131210108005,131210108005,"Block Group 5, Census Tract 108, Fulton County, Georgia",355,183,216,146,139,147
1500000US131210108006,131210108006,"Block Group 6, Census Tract 108, Fulton County, Georgia",1309,548,421,242,888,487
1500000US131210110001,131210110001,"Block Group 1, Census Tract 110, Fulton County, Georgia",682,260,289,179,393,206
1500000US131210110002,131210110002,"Block Group 2, Census Tract 110, Fulton County, Georgia",1050,281,181,109,869,268
1500000US131210110003,131210110003,"Block Group 3, Census Tract 110, Fulton County, Georgia",931,218,261,146,670,203
1500000US131210110004,131210110004,"Block Group 4, Census Tract 110, Fulton County, Georgia",408,214,102,54,306,214
1500000US131210111001,131210111001,"Block Group 1, Census Tract 111, Fulton County, Georgia",658,189,432,154,226,111
1500000US131210111002,131210111002,"Block Group 2, Census Tract 111, Fulton County, Georgia",1100,284,751,225,349,199
1500000US131210111003,131210111003,"Block Group 3, Census Tract 111, Fulton County, Georgia",551,165,342,140,209,161
1500000US131210112011,131210112011,"Block Group 1, Census Tract 112.01, Fulton County, Georgia",1422,366,379,206,1043,326
1500000US131210112012,131210112012,"Block Group 2, Census Tract 112.01, Fulton County, Georgia",1286,422,395,162,891,412
1500000US131210112013,131210112013,"Block Group 3, Census Tract 112.01, Fulton County, Georgia",1458,397,587,311,871,345
1500000US131210112021,131210112021,"Block Group 1, Census Tract 112.02, Fulton County, Georgia",388,144,282,112,106,103
1500000US131210112022,131210112022,"Block Group 2, Census Tract 112.02, Fulton County, Georgia",568,263,328,121,240,245
1500000US131210112023,131210112023,"Block Group 3, Census Tract 112.02, Fulton County, Georgia",979,407,410,273,569,344
1500000US131210112024,131210112024,"Block Group 4, Census Tract 112.02, Fulton County, Georgia",698,235,460,209,238,135
1500000US131210112025,131210112025,"Block Group 5, Census Tract 112.02, Fulton County, Georgia",1465,458,305,135,1160,463
1500000US131210112026,131210112026,"Block Group 6, Census Tract 112.02, Fulton County, Georgia",699,300,219,124,480,265
1500000US131210113011,131210113011,"Block Group 1, Census Tract 113.01, Fulton County, Georgia",733,241,575,216,158,130
1500000US131210113012,131210113012,"Block Group 2, Census Tract 113.01, Fulton County, Georgia",512,301,252,144,260,257
1500000US131210113013,131210113013,"Block Group 3, Census Tract 113.01, Fulton County, Georgia",296,152,239,119,57,93
1500000US131210113014,131210113014,"Block Group 4, Census Tract 113.01, Fulton County, Georgia",998,288,889,306,109,108
1500000US131210113015,131210113015,"Block Group 5, Census Tract 113.01, Fulton County, Georgia",701,280,550,268,151,122
1500000US131210113016,131210113016,"Block Group 6, Census Tract 113.01, Fulton County, Georgia",980,536,386,181,594,571
1500000US131210113031,131210113031,"Block Group 1, Census Tract 113.03, Fulton County, Georgia",3746,698,1986,604,1760,479
1500000US131210113032,131210113032,"Block Group 2, Census Tract 113.03, Fulton County, Georgia",1139,362,390,206,749,400
1500000US131210113033,131210113033,"Block Group 3, Census Tract 113.03, Fulton County, Georgia",495,243,390,248,105,96
1500000US131210113034,131210113034,"Block Group 4, Census Tract 113.03, Fulton County, Georgia",613,457,120,153,493,462
1500000US131210113035,131210113035,"Block Group 5, Census Tract 113.03, Fulton County, Georgia",3101,755,714,323,2387,743
1500000US131210113051,131210113051,"Block Group 1, Census Tract 113.05, Fulton County, Georgia",1129,296,377,164,752,279
1500000US131210113052,131210113052,"Block Group 2, Census Tract 113.05, Fulton County, Georgia",2369,456,246,168,2123,434
1500000US131210113053,131210113053,"Block Group 3, Census Tract 113.05, Fulton County, Georgia",1645,368,404,196,1241,332
1500000US131210113061,131210113061,"Block Group 1, Census Tract 113.06, Fulton County, Georgia",1307,411,49,43,1258,413
1500000US131210113062,131210113062,"Block Group 2, Census Tract 113.06, Fulton County, Georgia",1129,276,1009,278,120,108
1500000US131210114051,131210114051,"Block Group 1, Census Tract 114.05, Fulton County, Georgia",1751,421,1268,378,483,337
1500000US131210114052,131210114052,"Block Group 2, Census Tract 114.05, Fulton County, Georgia",1036,400,653,246,383,371
1500000US131210114053,131210114053,"Block Group 3, Census Tract 114.05, Fulton County, Georgia",2344,888,713,171,1631,912
1500000US131210114054,131210114054,"Block Group 4, Census Tract 114.05, Fulton County, Georgia",2735,702,238,162,2497,713
1500000US131210114101,131210114101,"Block Group 1, Census Tract 114.10, Fulton County, Georgia",2514,486,1675,418,839,379
1500000US131210114102,131210114102,"Block Group 2, Census Tract 114.10, Fulton County, Georgia",2106,348,1640,325,466,234
1500000US131210114103,131210114103,"Block Group 3, Census Tract 114.10, Fulton County, Georgia",2071,394,1966,411,105,113
1500000US131210114111,131210114111,"Block Group 1, Census Tract 114.11, Fulton County, Georgia",2605,595,1393,350,1212,503
1500000US131210114112,131210114112,"Block Group 2, Census Tract 114.11, Fulton County, Georgia",765,273,736,284,29,49
1500000US131210114113,131210114113,"Block Group 3, Census Tract 114.11, Fulton County, Georgia",2666,772,1221,358,1445,634
1500000US131210114114,131210114114,"Block Group 4, Census Tract 114.11, Fulton County, Georgia",1001,321,977,324,24,38
1500000US131210114115,131210114115,"Block Group 5, Census Tract 114.11, Fulton County, Georgia",1359,564,1265,579,94,89
1500000US131210114121,131210114121,"Block Group 1, Census Tract 114.12, Fulton County, Georgia",4063,532,2773,530,1290,397
1500000US131210114122,131210114122,"Block Group 2, Census Tract 114.12, Fulton County, Georgia",1924,392,1154,294,770,322
1500000US131210114123,131210114123,"Block Group 3, Census Tract 114.12, Fulton County, Georgia",3325,736,2380,496,945,470
1500000US131210114141,131210114141,"Block Group 1, Census Tract 114.14, Fulton County, Georgia",2174,588,443,310,1731,516
1500000US131210114142,131210114142,"Block Group 2, Census Tract 114.14, Fulton County, Georgia",1251,475,1251,475,0,13
1500000US131210114143,131210114143,"Block Group 3, Census Tract 114.14, Fulton County, Georgia",1970,471,1892,477,78,139
1500000US131210114144,131210114144,"Block Group 4, Census Tract 114.14, Fulton County, Georgia",2148,513,517,164,1631,502
1500000US131210114161,131210114161,"Block Group 1, Census Tract 114.16, Fulton County, Georgia",1981,422,1981,422,0,13
1500000US131210114162,131210114162,"Block Group 2, Census Tract 114.16, Fulton County, Georgia",2187,357,1947,370,240,199
1500000US131210114163,131210114163,"Block Group 3, Census Tract 114.16, Fulton County, Georgia",1060,326,947,325,113,57
1500000US131210114171,131210114171,"Block Group 1, Census Tract 114.17, Fulton County, Georgia",1021,229,960,241,61,66
1500000US131210114172,131210114172,"Block Group 2, Census Tract 114.17, Fulton County, Georgia",1527,242,913,216,614,183
1500000US131210114173,131210114173,"Block Group 3, Census Tract 114.17, Fulton County, Georgia",1620,296,1324,240,296,282
1500000US131210114174,131210114174,"Block Group 4, Census Tract 114.17, Fulton County, Georgia",609,113,577,117,32,50
1500000US131210114181,131210114181,"Block Group 1, Census Tract 114.18, Fulton County, Georgia",854,275,652,282,202,198
1500000US131210114182,131210114182,"Block Group 2, Census Tract 114.18, Fulton County, Georgia",511,180,437,145,74,118
1500000US131210114183,131210114183,"Block Group 3, Census Tract 114.18, Fulton County, Georgia",1134,332,1134,332,0,13
1500000US131210114184,131210114184,"Block Group 4, Census Tract 114.18, Fulton County, Georgia",3619,428,3324,492,295,283
1500000US131210114191,131210114191,"Block Group 1, Census Tract 114.19, Fulton County, Georgia",1445,426,1406,422,39,62
1500000US131210114192,131210114192,"Block Group 2, Census Tract 114.19, Fulton County, Georgia",1919,421,1779,426,140,110
1500000US131210114193,131210114193,"Block Group 3, Census Tract 114.19, Fulton County, Georgia",2235,393,1954,391,281,119
1500000US131210114201,131210114201,"Block Group 1, Census Tract 114.20, Fulton County, Georgia",1576,463,57,49,1519,458
1500000US131210114202,131210114202,"Block Group 2, Census Tract 114.20, Fulton County, Georgia",3989,762,158,92,3831,775
1500000US131210114203,131210114203,"Block Group 3, Census Tract 114.20, Fulton County, Georgia",2261,648,559,229,1702,589
1500000US131210114211,131210114211,"Block Group 1, Census Tract 114.21, Fulton County, Georgia",2274,317,625,163,1649,372
1500000US131210114212,131210114212,"Block Group 2, Census Tract 114.21, Fulton County, Georgia",1569,359,40,32,1529,356
1500000US131210114221,131210114221,"Block Group 1, Census Tract 114.22, Fulton County, Georgia",3039,484,1177,262,1862,531
1500000US131210114222,131210114222,"Block Group 2, Census Tract 114.22, Fulton County, Georgia",1043,320,875,263,168,156
1500000US131210114231,131210114231,"Block Group 1, Census Tract 114.23, Fulton County, Georgia",1110,291,939,252,171,172
1500000US131210114232,131210114232,"Block Group 2, Census Tract 114.23, Fulton County, Georgia",1495,283,1415,278,80,119
1500000US131210114233,131210114233,"Block Group 3, Census Tract 114.23, Fulton County, Georgia",1427,313,961,260,466,196
1500000US131210114234,131210114234,"Block Group 4, Census Tract 114.23, Fulton County, Georgia",957,362,757,283,200,272
1500000US131210114241,131210114241,"Block Group 1, Census Tract 114.24, Fulton County, Georgia",3680,509,3189,473,491,461
1500000US131210114242,131210114242,"Block Group 2, Census Tract 114.24, Fulton County, Georgia",1995,404,1498,359,497,343
1500000US131210114251,131210114251,"Block Group 1, Census Tract 114.25, Fulton County, Georgia",2279,496,2222,503,57,103
1500000US131210114252,131210114252,"Block Group 2, Census Tract 114.25, Fulton County, Georgia",3037,534,2523,492,514,303
1500000US131210114253,131210114253,"Block Group 3, Census Tract 114.25, Fulton County, Georgia",1922,494,1671,508,251,202
1500000US131210114261,131210114261,"Block Group 1, Census Tract 114.26, Fulton County, Georgia",2555,246,2056,370,499,296
1500000US131210114271,131210114271,"Block Group 1, Census Tract 114.27, Fulton County, Georgia",2468,422,2182,443,286,178
1500000US131210114272,131210114272,"Block Group 2, Census Tract 114.27, Fulton County, Georgia",3025,452,2782,438,243,235
1500000US131210114273,131210114273,"Block Group 3, Census Tract 114.27, Fulton County, Georgia",2287,385,2148,373,139,109
1500000US131210115031,131210115031,"Block Group 1, Census Tract 115.03, Fulton County, Georgia",2036,454,2018,458,18,31
1500000US131210115032,131210115032,"Block Group 2, Census Tract 115.03, Fulton County, Georgia",2095,653,2079,655,16,27
1500000US131210115033,131210115033,"Block Group 3, Census Tract 115.03, Fulton County, Georgia",5914,637,5221,707,693,418
1500000US131210115041,131210115041,"Block Group 1, Census Tract 115.04, Fulton County, Georgia",3411,483,3182,492,229,205
1500000US131210115042,131210115042,"Block Group 2, Census Tract 115.04, Fulton County, Georgia",2225,447,2225,447,0,13
1500000US131210115043,131210115043,"Block Group 3, Census Tract 115.04, Fulton County, Georgia",4255,830,3967,821,288,210
1500000US131210115044,131210115044,"Block Group 4, Census Tract 115.04, Fulton County, Georgia",2930,638,2371,453,559,518
1500000US131210115051,131210115051,"Block Group 1, Census Tract 115.05, Fulton County, Georgia",2564,345,2253,361,311,220
1500000US131210115052,131210115052,"Block Group 2, Census Tract 115.05, Fulton County, Georgia",1967,391,1887,390,80,115
1500000US131210115061,131210115061,"Block Group 1, Census Tract 115.06, Fulton County, Georgia",1953,321,1782,342,171,188
1500000US131210115062,131210115062,"Block Group 2, Census Tract 115.06, Fulton County, Georgia",2790,340,2637,342,153,88
1500000US131210115063,131210115063,"Block Group 3, Census Tract 115.06, Fulton County, Georgia",1594,291,1594,291,0,13
1500000US131210116101,131210116101,"Block Group 1, Census Tract 116.10, Fulton County, Georgia",2811,480,2595,462,216,172
1500000US131210116102,131210116102,"Block Group 2, Census Tract 116.10, Fulton County, Georgia",3028,509,1722,353,1306,454
1500000US131210116111,131210116111,"Block Group 1, Census Tract 116.11, Fulton County, Georgia",2665,616,752,257,1913,619
1500000US131210116112,131210116112,"Block Group 2, Census Tract 116.11, Fulton County, Georgia",1395,371,1128,378,267,211
1500000US131210116113,131210116113,"Block Group 3, Census Tract 116.11, Fulton County, Georgia",3108,700,719,388,2389,687
1500000US131210116121,131210116121,"Block Group 1, Census Tract 116.12, Fulton County, Georgia",2534,300,2338,281,196,137
1500000US131210116122,131210116122,"Block Group 2, Census Tract 116.12, Fulton County, Georgia",847,272,683,166,164,218
1500000US131210116131,131210116131,"Block Group 1, Census Tract 116.13, Fulton County, Georgia",3677,472,2662,439,1015,459
1500000US131210116132,131210116132,"Block Group 2, Census Tract 116.13, Fulton County, Georgia",3242,430,1891,423,1351,423
1500000US131210116141,131210116141,"Block Group 1, Census Tract 116.14, Fulton County, Georgia",2896,762,1031,490,1865,704
1500000US131210116142,131210116142,"Block Group 2, Census Tract 116.14, Fulton County, Georgia",5129,1213,2247,705,2882,1317
1500000US131210116143,131210116143,"Block Group 3, Census Tract 116.14, Fulton County, Georgia",6452,1029,2979,956,3473,879
1500000US131210116151,131210116151,"Block Group 1, Census Tract 116.15, Fulton County, Georgia",3881,575,3501,536,380,294
1500000US131210116152,131210116152,"Block Group 2, Census Tract 116.15, Fulton County, Georgia",2023,410,2023,410,0,13
1500000US131210116153,131210116153,"Block Group 3, Census Tract 116.15, Fulton County, Georgia",4069,664,2881,661,1188,552
1500000US131210116161,131210116161,"Block Group 1, Census Tract 116.16, Fulton County, Georgia",2068,527,842,421,1226,423
1500000US131210116162,131210116162,"Block Group 2, Census Tract 116.16, Fulton County, Georgia",1669,501,0,13,1669,501
1500000US131210116163,131210116163,"Block Group 3, Census Tract 116.16, Fulton County, Georgia",1180,413,591,292,589,312
1500000US131210116171,131210116171,"Block Group 1, Census Tract 116.17, Fulton County, Georgia",2625,480,2130,451,495,269
1500000US131210116172,131210116172,"Block Group 2, Census Tract 116.17, Fulton County, Georgia",2447,700,1808,541,639,514
1500000US131210116173,131210116173,"Block Group 3, Census Tract 116.17, Fulton County, Georgia",2606,450,2535,458,71,94
1500000US131210116181,131210116181,"Block Group 1, Census Tract 116.18, Fulton County, Georgia",4416,304,2912,450,1504,337
1500000US131210116191,131210116191,"Block Group 1, Census Tract 116.19, Fulton County, Georgia",2791,692,11,18,2780,692
1500000US131210116192,131210116192,"Block Group 2, Census Tract 116.19, Fulton County, Georgia",2382,582,1132,441,1250,442
1500000US131210116193,131210116193,"Block Group 3, Census Tract 116.19, Fulton County, Georgia",3221,416,1889,504,1332,509
1500000US131210116201,131210116201,"Block Group 1, Census Tract 116.20, Fulton County, Georgia",3201,638,3035,644,166,182
1500000US131210116202,131210116202,"Block Group 2, Census Tract 116.20, Fulton County, Georgia",4324,802,4278,822,46,55
1500000US131210116203,131210116203,"Block Group 3, Census Tract 116.20, Fulton County, Georgia",3104,684,1998,592,1106,510
1500000US131210116211,131210116211,"Block Group 1, Census Tract 116.21, Fulton County, Georgia",828,292,0,13,828,292
1500000US131210116212,131210116212,"Block Group 2, Census Tract 116.21, Fulton County, Georgia",2359,577,2091,601,268,404
1500000US131210116213,131210116213,"Block Group 3, Census Tract 116.21, Fulton County, Georgia",4031,918,3381,813,650,722
1500000US131210116221,131210116221,"Block Group 1, Census Tract 116.22, Fulton County, Georgia",3922,627,3922,627,0,13
1500000US131210116222,131210116222,"Block Group 2, Census Tract 116.22, Fulton County, Georgia",3196,546,3139,546,57,92
1500000US131210116223,131210116223,"Block Group 3, Census Tract 116.22, Fulton County, Georgia",2896,580,2745,566,151,155
1500000US131210116231,131210116231,"Block Group 1, Census Tract 116.23, Fulton County, Georgia",3451,841,3347,818,104,183
1500000US131210116232,131210116232,"Block Group 2, Census Tract 116.23, Fulton County, Georgia",4570,873,2660,709,1910,888
1500000US131210116233,131210116233,"Block Group 3, Census Tract 116.23, Fulton County, Georgia",1035,376,986,384,49,73
1500000US131210116234,131210116234,"Block Group 4, Census Tract 116.23, Fulton County, Georgia",2945,669,1976,500,969,570
1500000US131210116241,131210116241,"Block Group 1, Census Tract 116.24, Fulton County, Georgia",2535,389,2415,369,120,161
1500000US131210116242,131210116242,"Block Group 2, Census Tract 116.24, Fulton County, Georgia",1766,294,1654,280,112,101
1500000US131210116251,131210116251,"Block Group 1, Census Tract 116.25, Fulton County, Georgia",2646,601,679,223,1967,573
1500000US131210116252,131210116252,"Block Group 2, Census Tract 116.25, Fulton County, Georgia",2011,477,1955,480,56,89
1500000US131210116253,131210116253,"Block Group 3, Census Tract 116.25, Fulton County, Georgia",2937,597,2435,613,502,539
1500000US131210116261,131210116261,"Block Group 1, Census Tract 116.26, Fulton County, Georgia",5100,777,2692,626,2408,752
1500000US131210116262,131210116262,"Block Group 2, Census Tract 116.26, Fulton County, Georgia",4199,864,2637,645,1562,723
1500000US131210118001,131210118001,"Block Group 1, Census Tract 118, Fulton County, Georgia",290,146,76,86,214,121
1500000US131210118002,131210118002,"Block Group 2, Census Tract 118, Fulton County, Georgia",1889,454,119,84,1770,459
1500000US131210118003,131210118003,"Block Group 3, Census Tract 118, Fulton County, Georgia",708,208,49,55,659,202
1500000US131210119001,131210119001,"Block Group 1, Census Tract 119, Fulton County, Georgia",1174,245,44,41,1130,242
1500000US131210119002,131210119002,"Block Group 2, Census Tract 119, Fulton County, Georgia",1318,186,208,89,1110,156
1500000US131210120001,131210120001,"Block Group 1, Census Tract 120, Fulton County, Georgia",1329,287,290,136,1039,281
1500000US131210120002,131210120002,"Block Group 2, Census Tract 120, Fulton County, Georgia",1355,345,559,302,796,355
1500000US131210123001,131210123001,"Block Group 1, Census Tract 123, Fulton County, Georgia",974,299,422,189,552,305
1500000US131210123002,131210123002,"Block Group 2, Census Tract 123, Fulton County, Georgia",825,248,190,99,635,243
1500000US131210123003,131210123003,"Block Group 3, Census Tract 123, Fulton County, Georgia",656,246,469,223,187,136
1500000US131219800001,131219800001,"Block Group 1, Census Tract 9800, Fulton County, Georgia",0,13,0,13,0,13
1500000US131230801001,131230801001,"Block Group 1, Census Tract 801, Gilmer County, Georgia",1762,302,1317,294,445,150
1500000US131230801002,131230801002,"Block Group 2, Census Tract 801, Gilmer County, Georgia",1427,358,1305,355,122,88
1500000US131230801003,131230801003,"Block Group 3, Census Tract 801, Gilmer County, Georgia",818,202,727,196,91,65
1500000US131230802001,131230802001,"Block Group 1, Census Tract 802, Gilmer County, Georgia",1182,298,1133,305,49,60
1500000US131230802002,131230802002,"Block Group 2, Census Tract 802, Gilmer County, Georgia",2106,459,1855,457,251,224
1500000US131230802003,131230802003,"Block Group 3, Census Tract 802, Gilmer County, Georgia",2389,548,1989,576,400,201
1500000US131230803001,131230803001,"Block Group 1, Census Tract 803, Gilmer County, Georgia",1457,427,637,210,820,381
1500000US131230803002,131230803002,"Block Group 2, Census Tract 803, Gilmer County, Georgia",1556,666,778,649,778,425
1500000US131230803003,131230803003,"Block Group 3, Census Tract 803, Gilmer County, Georgia",1545,359,989,294,556,243
1500000US131230803004,131230803004,"Block Group 4, Census Tract 803, Gilmer County, Georgia",2061,380,1143,281,918,297
1500000US131230804001,131230804001,"Block Group 1, Census Tract 804, Gilmer County, Georgia",2928,667,2421,633,507,400
1500000US131230804002,131230804002,"Block Group 2, Census Tract 804, Gilmer County, Georgia",2955,664,2628,589,327,228
1500000US131230804003,131230804003,"Block Group 3, Census Tract 804, Gilmer County, Georgia",2443,567,1476,383,967,522
1500000US131230805001,131230805001,"Block Group 1, Census Tract 805, Gilmer County, Georgia",729,268,414,201,315,233
1500000US131230805002,131230805002,"Block Group 2, Census Tract 805, Gilmer County, Georgia",1539,330,1278,308,261,193
1500000US131230805003,131230805003,"Block Group 3, Census Tract 805, Gilmer County, Georgia",1497,321,1099,300,398,228
1500000US131250101001,131250101001,"Block Group 1, Census Tract 101, Glascock County, Georgia",1119,181,802,167,317,103
1500000US131250101002,131250101002,"Block Group 2, Census Tract 101, Glascock County, Georgia",946,182,736,167,210,111
1500000US131250101003,131250101003,"Block Group 3, Census Tract 101, Glascock County, Georgia",927,147,730,117,197,114
1500000US131270001011,131270001011,"Block Group 1, Census Tract 1.01, Glynn County, Georgia",677,176,473,142,204,96
1500000US131270001012,131270001012,"Block Group 2, Census Tract 1.01, Glynn County, Georgia",544,192,455,191,89,49
1500000US131270001021,131270001021,"Block Group 1, Census Tract 1.02, Glynn County, Georgia",1753,319,1026,235,727,279
1500000US131270001022,131270001022,"Block Group 2, Census Tract 1.02, Glynn County, Georgia",744,192,443,144,301,177
1500000US131270001023,131270001023,"Block Group 3, Census Tract 1.02, Glynn County, Georgia",977,237,641,157,336,207
1500000US131270002001,131270002001,"Block Group 1, Census Tract 2, Glynn County, Georgia",1448,311,1160,306,288,163
1500000US131270002002,131270002002,"Block Group 2, Census Tract 2, Glynn County, Georgia",1598,367,1193,377,405,227
1500000US131270002003,131270002003,"Block Group 3, Census Tract 2, Glynn County, Georgia",1664,357,1376,388,288,183
1500000US131270003001,131270003001,"Block Group 1, Census Tract 3, Glynn County, Georgia",2463,448,1949,436,514,349
1500000US131270003002,131270003002,"Block Group 2, Census Tract 3, Glynn County, Georgia",1045,451,677,360,368,302
1500000US131270003003,131270003003,"Block Group 3, Census Tract 3, Glynn County, Georgia",2164,429,1664,402,500,248
1500000US131270003004,131270003004,"Block Group 4, Census Tract 3, Glynn County, Georgia",630,238,552,230,78,67
1500000US131270004011,131270004011,"Block Group 1, Census Tract 4.01, Glynn County, Georgia",3757,753,2534,616,1223,642
1500000US131270004012,131270004012,"Block Group 2, Census Tract 4.01, Glynn County, Georgia",1079,386,893,325,186,186
1500000US131270004013,131270004013,"Block Group 3, Census Tract 4.01, Glynn County, Georgia",3097,547,2990,555,107,136
1500000US131270004031,131270004031,"Block Group 1, Census Tract 4.03, Glynn County, Georgia",1619,371,1018,219,601,352
1500000US131270004032,131270004032,"Block Group 2, Census Tract 4.03, Glynn County, Georgia",1521,237,1409,224,112,84
1500000US131270004041,131270004041,"Block Group 1, Census Tract 4.04, Glynn County, Georgia",910,472,845,458,65,102
1500000US131270004042,131270004042,"Block Group 2, Census Tract 4.04, Glynn County, Georgia",5287,721,2775,617,2512,787
1500000US131270004043,131270004043,"Block Group 3, Census Tract 4.04, Glynn County, Georgia",5181,876,3229,584,1952,810
1500000US131270005011,131270005011,"Block Group 1, Census Tract 5.01, Glynn County, Georgia",675,275,153,92,522,285
1500000US131270005012,131270005012,"Block Group 2, Census Tract 5.01, Glynn County, Georgia",1903,353,1030,337,873,371
1500000US131270005013,131270005013,"Block Group 3, Census Tract 5.01, Glynn County, Georgia",1118,254,279,107,839,251
1500000US131270005031,131270005031,"Block Group 1, Census Tract 5.03, Glynn County, Georgia",1042,249,412,126,630,240
1500000US131270005032,131270005032,"Block Group 2, Census Tract 5.03, Glynn County, Georgia",1129,335,85,52,1044,335
1500000US131270005033,131270005033,"Block Group 3, Census Tract 5.03, Glynn County, Georgia",1818,433,549,221,1269,389
1500000US131270005041,131270005041,"Block Group 1, Census Tract 5.04, Glynn County, Georgia",598,202,346,151,252,195
1500000US131270005042,131270005042,"Block Group 2, Census Tract 5.04, Glynn County, Georgia",983,333,808,294,175,158
1500000US131270005043,131270005043,"Block Group 3, Census Tract 5.04, Glynn County, Georgia",1845,410,534,295,1311,361
1500000US131270006001,131270006001,"Block Group 1, Census Tract 6, Glynn County, Georgia",1509,497,778,327,731,409
1500000US131270006002,131270006002,"Block Group 2, Census Tract 6, Glynn County, Georgia",1604,662,824,540,780,323
1500000US131270006003,131270006003,"Block Group 3, Census Tract 6, Glynn County, Georgia",1122,372,756,288,366,290
1500000US131270006004,131270006004,"Block Group 4, Census Tract 6, Glynn County, Georgia",1522,562,1202,458,320,289
1500000US131270007001,131270007001,"Block Group 1, Census Tract 7, Glynn County, Georgia",2442,510,720,266,1722,471
1500000US131270007002,131270007002,"Block Group 2, Census Tract 7, Glynn County, Georgia",992,551,859,555,133,143
1500000US131270007003,131270007003,"Block Group 3, Census Tract 7, Glynn County, Georgia",773,264,381,250,392,201
1500000US131270007004,131270007004,"Block Group 4, Census Tract 7, Glynn County, Georgia",1213,500,675,429,538,386
1500000US131270007005,131270007005,"Block Group 5, Census Tract 7, Glynn County, Georgia",666,440,203,218,463,385
1500000US131270007006,131270007006,"Block Group 6, Census Tract 7, Glynn County, Georgia",582,366,353,338,229,171
1500000US131270007007,131270007007,"Block Group 7, Census Tract 7, Glynn County, Georgia",334,159,201,104,133,129
1500000US131270007008,131270007008,"Block Group 8, Census Tract 7, Glynn County, Georgia",690,346,329,221,361,283
1500000US131270008001,131270008001,"Block Group 1, Census Tract 8, Glynn County, Georgia",498,244,247,161,251,189
1500000US131270008002,131270008002,"Block Group 2, Census Tract 8, Glynn County, Georgia",1355,390,481,202,874,358
1500000US131270008003,131270008003,"Block Group 3, Census Tract 8, Glynn County, Georgia",854,346,88,84,766,345
1500000US131270008004,131270008004,"Block Group 4, Census Tract 8, Glynn County, Georgia",1011,333,100,90,911,320
1500000US131270009001,131270009001,"Block Group 1, Census Tract 9, Glynn County, Georgia",597,243,191,161,406,206
1500000US131270009002,131270009002,"Block Group 2, Census Tract 9, Glynn County, Georgia",466,184,183,116,283,140
1500000US131270009003,131270009003,"Block Group 3, Census Tract 9, Glynn County, Georgia",901,439,418,257,483,392
1500000US131270009004,131270009004,"Block Group 4, Census Tract 9, Glynn County, Georgia",1388,378,626,245,762,370
1500000US131270009005,131270009005,"Block Group 5, Census Tract 9, Glynn County, Georgia",1179,338,545,216,634,321
1500000US131270010001,131270010001,"Block Group 1, Census Tract 10, Glynn County, Georgia",588,206,393,145,195,167
1500000US131270010002,131270010002,"Block Group 2, Census Tract 10, Glynn County, Georgia",2552,444,1857,391,695,353
1500000US131270010003,131270010003,"Block Group 3, Census Tract 10, Glynn County, Georgia",2216,444,1938,451,278,209
1500000US131270010004,131270010004,"Block Group 4, Census Tract 10, Glynn County, Georgia",4107,588,3268,499,839,518
1500000US131279900000,131279900000,"Block Group 0, Census Tract 9900, Glynn County, Georgia",0,13,0,13,0,13
1500000US131299701001,131299701001,"Block Group 1, Census Tract 9701, Gordon County, Georgia",1256,370,944,284,312,254
1500000US131299701002,131299701002,"Block Group 2, Census Tract 9701, Gordon County, Georgia",1501,459,1228,437,273,220
1500000US131299701003,131299701003,"Block Group 3, Census Tract 9701, Gordon County, Georgia",3554,669,2493,653,1061,556
1500000US131299702001,131299702001,"Block Group 1, Census Tract 9702, Gordon County, Georgia",1364,365,906,263,458,300
1500000US131299702002,131299702002,"Block Group 2, Census Tract 9702, Gordon County, Georgia",1304,404,781,332,523,305
1500000US131299702003,131299702003,"Block Group 3, Census Tract 9702, Gordon County, Georgia",2429,463,1413,436,1016,416
1500000US131299702004,131299702004,"Block Group 4, Census Tract 9702, Gordon County, Georgia",2036,661,1642,447,394,532
1500000US131299703001,131299703001,"Block Group 1, Census Tract 9703, Gordon County, Georgia",1102,396,862,290,240,271
1500000US131299703002,131299703002,"Block Group 2, Census Tract 9703, Gordon County, Georgia",2605,575,1585,433,1020,476
1500000US131299703003,131299703003,"Block Group 3, Census Tract 9703, Gordon County, Georgia",3872,780,1465,404,2407,827
1500000US131299703004,131299703004,"Block Group 4, Census Tract 9703, Gordon County, Georgia",1116,398,263,187,853,430
1500000US131299704001,131299704001,"Block Group 1, Census Tract 9704, Gordon County, Georgia",2451,416,1770,386,681,343
1500000US131299704002,131299704002,"Block Group 2, Census Tract 9704, Gordon County, Georgia",1518,321,409,165,1109,291
1500000US131299704003,131299704003,"Block Group 3, Census Tract 9704, Gordon County, Georgia",1008,295,446,163,562,283
1500000US131299705001,131299705001,"Block Group 1, Census Tract 9705, Gordon County, Georgia",2031,364,1067,257,964,376
1500000US131299705002,131299705002,"Block Group 2, Census Tract 9705, Gordon County, Georgia",1326,406,816,320,510,266
1500000US131299705003,131299705003,"Block Group 3, Census Tract 9705, Gordon County, Georgia",1410,352,534,296,876,297
1500000US131299706001,131299706001,"Block Group 1, Census Tract 9706, Gordon County, Georgia",634,379,131,123,503,369
1500000US131299706002,131299706002,"Block Group 2, Census Tract 9706, Gordon County, Georgia",2122,548,1408,424,714,358
1500000US131299706003,131299706003,"Block Group 3, Census Tract 9706, Gordon County, Georgia",3642,741,1337,556,2305,630
1500000US131299707001,131299707001,"Block Group 1, Census Tract 9707, Gordon County, Georgia",1682,330,1438,319,244,193
1500000US131299707002,131299707002,"Block Group 2, Census Tract 9707, Gordon County, Georgia",902,265,545,226,357,168
1500000US131299707003,131299707003,"Block Group 3, Census Tract 9707, Gordon County, Georgia",1680,423,1040,321,640,353
1500000US131299708001,131299708001,"Block Group 1, Census Tract 9708, Gordon County, Georgia",1160,346,981,347,179,162
1500000US131299708002,131299708002,"Block Group 2, Census Tract 9708, Gordon County, Georgia",1900,417,1729,429,171,157
1500000US131299708003,131299708003,"Block Group 3, Census Tract 9708, Gordon County, Georgia",2760,530,2401,534,359,281
1500000US131299709001,131299709001,"Block Group 1, Census Tract 9709, Gordon County, Georgia",1650,529,989,408,661,491
1500000US131299709002,131299709002,"Block Group 2, Census Tract 9709, Gordon County, Georgia",1408,386,1076,384,332,157
1500000US131299709003,131299709003,"Block Group 3, Census Tract 9709, Gordon County, Georgia",3842,611,3250,604,592,337
1500000US131319501001,131319501001,"Block Group 1, Census Tract 9501, Grady County, Georgia",1311,263,874,216,437,182
1500000US131319501002,131319501002,"Block Group 2, Census Tract 9501, Grady County, Georgia",823,182,463,150,360,153
1500000US131319502001,131319502001,"Block Group 1, Census Tract 9502, Grady County, Georgia",1361,292,1109,269,252,159
1500000US131319502002,131319502002,"Block Group 2, Census Tract 9502, Grady County, Georgia",1361,275,958,259,403,201
1500000US131319503001,131319503001,"Block Group 1, Census Tract 9503, Grady County, Georgia",1729,295,1106,201,623,254
1500000US131319503002,131319503002,"Block Group 2, Census Tract 9503, Grady County, Georgia",1172,367,413,181,759,367
1500000US131319503003,131319503003,"Block Group 3, Census Tract 9503, Grady County, Georgia",643,256,209,98,434,252
1500000US131319503004,131319503004,"Block Group 4, Census Tract 9503, Grady County, Georgia",865,320,357,154,508,291
1500000US131319504001,131319504001,"Block Group 1, Census Tract 9504, Grady County, Georgia",2412,520,1426,420,986,518
1500000US131319504002,131319504002,"Block Group 2, Census Tract 9504, Grady County, Georgia",1774,397,978,295,796,315
1500000US131319504003,131319504003,"Block Group 3, Census Tract 9504, Grady County, Georgia",1700,423,511,309,1189,362
1500000US131319504004,131319504004,"Block Group 4, Census Tract 9504, Grady County, Georgia",673,316,0,13,673,316
1500000US131319505001,131319505001,"Block Group 1, Census Tract 9505, Grady County, Georgia",2680,496,1463,347,1217,460
1500000US131319505002,131319505002,"Block Group 2, Census Tract 9505, Grady County, Georgia",1215,356,437,199,778,336
1500000US131319505003,131319505003,"Block Group 3, Census Tract 9505, Grady County, Georgia",1573,404,815,229,758,389
1500000US131319505004,131319505004,"Block Group 4, Census Tract 9505, Grady County, Georgia",1439,426,536,234,903,454
1500000US131319506001,131319506001,"Block Group 1, Census Tract 9506, Grady County, Georgia",2324,293,1707,294,617,191
1500000US131339501001,131339501001,"Block Group 1, Census Tract 9501, Greene County, Georgia",1154,230,1096,226,58,61
1500000US131339501002,131339501002,"Block Group 2, Census Tract 9501, Greene County, Georgia",1069,271,636,172,433,303
1500000US131339502001,131339502001,"Block Group 1, Census Tract 9502, Greene County, Georgia",715,186,363,137,352,141
1500000US131339502002,131339502002,"Block Group 2, Census Tract 9502, Greene County, Georgia",795,150,565,130,230,113
1500000US131339502003,131339502003,"Block Group 3, Census Tract 9502, Greene County, Georgia",583,135,353,93,230,119
1500000US131339503011,131339503011,"Block Group 1, Census Tract 9503.01, Greene County, Georgia",849,161,838,162,11,15
1500000US131339503012,131339503012,"Block Group 2, Census Tract 9503.01, Greene County, Georgia",718,133,703,135,15,17
1500000US131339503013,131339503013,"Block Group 3, Census Tract 9503.01, Greene County, Georgia",472,111,381,98,91,64
1500000US131339503014,131339503014,"Block Group 4, Census Tract 9503.01, Greene County, Georgia",371,117,364,117,7,11
1500000US131339503021,131339503021,"Block Group 1, Census Tract 9503.02, Greene County, Georgia",1771,388,1442,420,329,206
1500000US131339503022,131339503022,"Block Group 2, Census Tract 9503.02, Greene County, Georgia",755,160,714,160,41,35
1500000US131339503031,131339503031,"Block Group 1, Census Tract 9503.03, Greene County, Georgia",800,313,582,261,218,158
1500000US131339503032,131339503032,"Block Group 2, Census Tract 9503.03, Greene County, Georgia",1342,425,373,163,969,425
1500000US131339503033,131339503033,"Block Group 3, Census Tract 9503.03, Greene County, Georgia",1487,395,475,198,1012,393
1500000US131339503034,131339503034,"Block Group 4, Census Tract 9503.03, Greene County, Georgia",237,85,85,64,152,65
1500000US131339503035,131339503035,"Block Group 5, Census Tract 9503.03, Greene County, Georgia",278,138,99,67,179,122
1500000US131339504001,131339504001,"Block Group 1, Census Tract 9504, Greene County, Georgia",1325,205,943,206,382,137
1500000US131339505001,131339505001,"Block Group 1, Census Tract 9505, Greene County, Georgia",637,117,615,118,22,23
1500000US131339505002,131339505002,"Block Group 2, Census Tract 9505, Greene County, Georgia",763,165,588,142,175,81
1500000US131350501031,131350501031,"Block Group 1, Census Tract 501.03, Gwinnett County, Georgia",4562,539,4088,543,474,237
1500000US131350501032,131350501032,"Block Group 2, Census Tract 501.03, Gwinnett County, Georgia",1455,442,790,390,665,311
1500000US131350501033,131350501033,"Block Group 3, Census Tract 501.03, Gwinnett County, Georgia",4397,596,3131,637,1266,536
1500000US131350501051,131350501051,"Block Group 1, Census Tract 501.05, Gwinnett County, Georgia",571,258,220,114,351,258
1500000US131350501052,131350501052,"Block Group 2, Census Tract 501.05, Gwinnett County, Georgia",1320,321,686,318,634,279
1500000US131350501053,131350501053,"Block Group 3, Census Tract 501.05, Gwinnett County, Georgia",1934,443,869,322,1065,375
1500000US131350501061,131350501061,"Block Group 1, Census Tract 501.06, Gwinnett County, Georgia",5086,938,3572,964,1514,506
1500000US131350501062,131350501062,"Block Group 2, Census Tract 501.06, Gwinnett County, Georgia",1644,428,1351,368,293,267
1500000US131350501063,131350501063,"Block Group 3, Census Tract 501.06, Gwinnett County, Georgia",2149,563,1781,392,368,538
1500000US131350501064,131350501064,"Block Group 4, Census Tract 501.06, Gwinnett County, Georgia",2543,752,492,358,2051,761
1500000US131350501071,131350501071,"Block Group 1, Census Tract 501.07, Gwinnett County, Georgia",7312,599,6503,581,809,474
1500000US131350501081,131350501081,"Block Group 1, Census Tract 501.08, Gwinnett County, Georgia",6628,675,6541,682,87,89
1500000US131350501082,131350501082,"Block Group 2, Census Tract 501.08, Gwinnett County, Georgia",3007,721,2629,742,378,279
1500000US131350501091,131350501091,"Block Group 1, Census Tract 501.09, Gwinnett County, Georgia",2960,629,2557,581,403,324
1500000US131350501092,131350501092,"Block Group 2, Census Tract 501.09, Gwinnett County, Georgia",4911,1131,2881,849,2030,1128
1500000US131350502051,131350502051,"Block Group 1, Census Tract 502.05, Gwinnett County, Georgia",2535,455,1633,386,902,351
1500000US131350502052,131350502052,"Block Group 2, Census Tract 502.05, Gwinnett County, Georgia",1724,369,278,142,1446,387
1500000US131350502081,131350502081,"Block Group 1, Census Tract 502.08, Gwinnett County, Georgia",3294,618,2194,581,1100,455
1500000US131350502082,131350502082,"Block Group 2, Census Tract 502.08, Gwinnett County, Georgia",3277,537,1559,477,1718,460
1500000US131350502091,131350502091,"Block Group 1, Census Tract 502.09, Gwinnett County, Georgia",4434,818,1688,550,2746,901
1500000US131350502092,131350502092,"Block Group 2, Census Tract 502.09, Gwinnett County, Georgia",2737,1106,468,192,2269,1087
1500000US131350502093,131350502093,"Block Group 3, Census Tract 502.09, Gwinnett County, Georgia",2858,773,2578,780,280,246
1500000US131350502101,131350502101,"Block Group 1, Census Tract 502.10, Gwinnett County, Georgia",3024,648,1987,591,1037,738
1500000US131350502102,131350502102,"Block Group 2, Census Tract 502.10, Gwinnett County, Georgia",3881,611,1591,434,2290,538
1500000US131350502111,131350502111,"Block Group 1, Census Tract 502.11, Gwinnett County, Georgia",1351,434,26,42,1325,431
1500000US131350502112,131350502112,"Block Group 2, Census Tract 502.11, Gwinnett County, Georgia",1087,348,7,13,1080,348
1500000US131350502113,131350502113,"Block Group 3, Census Tract 502.11, Gwinnett County, Georgia",2814,509,1389,251,1425,484
1500000US131350502121,131350502121,"Block Group 1, Census Tract 502.12, Gwinnett County, Georgia",3116,620,3042,600,74,123
1500000US131350502122,131350502122,"Block Group 2, Census Tract 502.12, Gwinnett County, Georgia",2652,561,2313,517,339,425
1500000US131350502123,131350502123,"Block Group 3, Census Tract 502.12, Gwinnett County, Georgia",6965,777,6652,791,313,200
1500000US131350502131,131350502131,"Block Group 1, Census Tract 502.13, Gwinnett County, Georgia",5111,880,4008,839,1103,663
1500000US131350502132,131350502132,"Block Group 2, Census Tract 502.13, Gwinnett County, Georgia",7897,917,6940,923,957,676
1500000US131350502141,131350502141,"Block Group 1, Census Tract 502.14, Gwinnett County, Georgia",2210,582,1861,555,349,348
1500000US131350502142,131350502142,"Block Group 2, Census Tract 502.14, Gwinnett County, Georgia",4908,1025,2805,608,2103,1121
1500000US131350502143,131350502143,"Block Group 3, Census Tract 502.14, Gwinnett County, Georgia",1637,454,1637,454,0,13
1500000US131350502151,131350502151,"Block Group 1, Census Tract 502.15, Gwinnett County, Georgia",3363,327,695,263,2668,454
1500000US131350502161,131350502161,"Block Group 1, Census Tract 502.16, Gwinnett County, Georgia",2471,762,1560,605,911,559
1500000US131350502162,131350502162,"Block Group 2, Census Tract 502.16, Gwinnett County, Georgia",2795,942,2761,953,34,42
1500000US131350502163,131350502163,"Block Group 3, Census Tract 502.16, Gwinnett County, Georgia",3758,774,2812,844,946,843
1500000US131350502171,131350502171,"Block Group 1, Census Tract 502.17, Gwinnett County, Georgia",8288,700,4317,610,3971,656
1500000US131350502172,131350502172,"Block Group 2, Census Tract 502.17, Gwinnett County, Georgia",1873,557,1815,568,58,81
1500000US131350502181,131350502181,"Block Group 1, Census Tract 502.18, Gwinnett County, Georgia",2458,623,1278,395,1180,711
1500000US131350502182,131350502182,"Block Group 2, Census Tract 502.18, Gwinnett County, Georgia",1493,456,651,277,842,458
1500000US131350502191,131350502191,"Block Group 1, Census Tract 502.19, Gwinnett County, Georgia",849,269,555,181,294,244
1500000US131350502192,131350502192,"Block Group 2, Census Tract 502.19, Gwinnett County, Georgia",2888,306,2040,298,848,213
1500000US131350502201,131350502201,"Block Group 1, Census Tract 502.20, Gwinnett County, Georgia",2130,512,1042,353,1088,428
1500000US131350502202,131350502202,"Block Group 2, Census Tract 502.20, Gwinnett County, Georgia",2990,506,113,139,2877,503
1500000US131350502203,131350502203,"Block Group 3, Census Tract 502.20, Gwinnett County, Georgia",1115,400,342,183,773,357
1500000US131350503041,131350503041,"Block Group 1, Census Tract 503.04, Gwinnett County, Georgia",2501,660,524,218,1977,651
1500000US131350503042,131350503042,"Block Group 2, Census Tract 503.04, Gwinnett County, Georgia",1629,421,612,245,1017,362
1500000US131350503043,131350503043,"Block Group 3, Census Tract 503.04, Gwinnett County, Georgia",889,275,7,17,882,273
1500000US131350503061,131350503061,"Block Group 1, Census Tract 503.06, Gwinnett County, Georgia",2717,464,1155,341,1562,471
1500000US131350503062,131350503062,"Block Group 2, Census Tract 503.06, Gwinnett County, Georgia",2151,522,1047,348,1104,477
1500000US131350503081,131350503081,"Block Group 1, Census Tract 503.08, Gwinnett County, Georgia",2037,247,1833,256,204,148
1500000US131350503082,131350503082,"Block Group 2, Census Tract 503.08, Gwinnett County, Georgia",1890,307,1697,311,193,183
1500000US131350503091,131350503091,"Block Group 1, Census Tract 503.09, Gwinnett County, Georgia",2074,352,1920,342,154,114
1500000US131350503092,131350503092,"Block Group 2, Census Tract 503.09, Gwinnett County, Georgia",2038,368,662,238,1376,295
1500000US131350503093,131350503093,"Block Group 3, Census Tract 503.09, Gwinnett County, Georgia",1666,395,1540,410,126,89
1500000US131350503094,131350503094,"Block Group 4, Census Tract 503.09, Gwinnett County, Georgia",2338,537,1452,442,886,442
1500000US131350503101,131350503101,"Block Group 1, Census Tract 503.10, Gwinnett County, Georgia",2026,338,1100,239,926,306
1500000US131350503102,131350503102,"Block Group 2, Census Tract 503.10, Gwinnett County, Georgia",739,202,622,187,117,95
1500000US131350503103,131350503103,"Block Group 3, Census Tract 503.10, Gwinnett County, Georgia",2564,445,2015,401,549,332
1500000US131350503111,131350503111,"Block Group 1, Census Tract 503.11, Gwinnett County, Georgia",1907,214,1549,241,358,168
1500000US131350503112,131350503112,"Block Group 2, Census Tract 503.11, Gwinnett County, Georgia",825,238,596,165,229,219
1500000US131350503131,131350503131,"Block Group 1, Census Tract 503.13, Gwinnett County, Georgia",1827,1074,1008,586,819,901
1500000US131350503132,131350503132,"Block Group 2, Census Tract 503.13, Gwinnett County, Georgia",1895,489,1306,467,589,438
1500000US131350503133,131350503133,"Block Group 3, Census Tract 503.13, Gwinnett County, Georgia",820,340,820,340,0,13
1500000US131350503134,131350503134,"Block Group 4, Census Tract 503.13, Gwinnett County, Georgia",982,356,982,356,0,13
1500000US131350503135,131350503135,"Block Group 5, Census Tract 503.13, Gwinnett County, Georgia",1044,324,867,312,177,178
1500000US131350503136,131350503136,"Block Group 6, Census Tract 503.13, Gwinnett County, Georgia",1533,701,295,194,1238,709
1500000US131350503141,131350503141,"Block Group 1, Census Tract 503.14, Gwinnett County, Georgia",2706,877,2196,814,510,472
1500000US131350503142,131350503142,"Block Group 2, Census Tract 503.14, Gwinnett County, Georgia",4831,864,612,305,4219,877
1500000US131350503143,131350503143,"Block Group 3, Census Tract 503.14, Gwinnett County, Georgia",1391,556,721,495,670,556
1500000US131350503144,131350503144,"Block Group 4, Census Tract 503.14, Gwinnett County, Georgia",1169,455,1057,465,112,86
1500000US131350503151,131350503151,"Block Group 1, Census Tract 503.15, Gwinnett County, Georgia",1534,299,742,226,792,249
1500000US131350503152,131350503152,"Block Group 2, Census Tract 503.15, Gwinnett County, Georgia",3476,494,191,90,3285,487
1500000US131350503153,131350503153,"Block Group 3, Census Tract 503.15, Gwinnett County, Georgia",714,140,665,146,49,48
1500000US131350503171,131350503171,"Block Group 1, Census Tract 503.17, Gwinnett County, Georgia",390,155,0,13,390,155
1500000US131350503172,131350503172,"Block Group 2, Census Tract 503.17, Gwinnett County, Georgia",2086,523,8,14,2078,522
1500000US131350503173,131350503173,"Block Group 3, Census Tract 503.17, Gwinnett County, Georgia",1217,329,166,97,1051,333
1500000US131350503181,131350503181,"Block Group 1, Census Tract 503.18, Gwinnett County, Georgia",1905,597,386,172,1519,644
1500000US131350503182,131350503182,"Block Group 2, Census Tract 503.18, Gwinnett County, Georgia",1088,507,0,13,1088,507
1500000US131350503191,131350503191,"Block Group 1, Census Tract 503.19, Gwinnett County, Georgia",3564,626,1181,334,2383,576
1500000US131350503192,131350503192,"Block Group 2, Census Tract 503.19, Gwinnett County, Georgia",2861,589,663,268,2198,590
1500000US131350503201,131350503201,"Block Group 1, Census Tract 503.20, Gwinnett County, Georgia",1801,580,1028,413,773,457
1500000US131350503202,131350503202,"Block Group 2, Census Tract 503.20, Gwinnett County, Georgia",3162,611,262,222,2900,624
1500000US131350503203,131350503203,"Block Group 3, Census Tract 503.20, Gwinnett County, Georgia",1283,511,739,500,544,378
1500000US131350503211,131350503211,"Block Group 1, Census Tract 503.21, Gwinnett County, Georgia",2079,241,2070,242,9,14
1500000US131350503212,131350503212,"Block Group 2, Census Tract 503.21, Gwinnett County, Georgia",2424,299,2184,300,240,145
1500000US131350503221,131350503221,"Block Group 1, Census Tract 503.22, Gwinnett County, Georgia",1164,180,1164,180,0,13
1500000US131350503222,131350503222,"Block Group 2, Census Tract 503.22, Gwinnett County, Georgia",2623,317,2423,317,200,239
1500000US131350503223,131350503223,"Block Group 3, Census Tract 503.22, Gwinnett County, Georgia",949,163,846,182,103,111
1500000US131350504101,131350504101,"Block Group 1, Census Tract 504.10, Gwinnett County, Georgia",1810,516,454,217,1356,515
1500000US131350504102,131350504102,"Block Group 2, Census Tract 504.10, Gwinnett County, Georgia",2532,526,948,344,1584,472
1500000US131350504103,131350504103,"Block Group 3, Census Tract 504.10, Gwinnett County, Georgia",1271,318,991,278,280,204
1500000US131350504151,131350504151,"Block Group 1, Census Tract 504.15, Gwinnett County, Georgia",874,259,695,233,179,139
1500000US131350504152,131350504152,"Block Group 2, Census Tract 504.15, Gwinnett County, Georgia",1135,398,1103,397,32,36
1500000US131350504153,131350504153,"Block Group 3, Census Tract 504.15, Gwinnett County, Georgia",1632,364,1239,358,393,300
1500000US131350504161,131350504161,"Block Group 1, Census Tract 504.16, Gwinnett County, Georgia",2827,486,1902,456,925,414
1500000US131350504162,131350504162,"Block Group 2, Census Tract 504.16, Gwinnett County, Georgia",693,245,598,235,95,83
1500000US131350504171,131350504171,"Block Group 1, Census Tract 504.17, Gwinnett County, Georgia",2431,520,960,389,1471,599
1500000US131350504172,131350504172,"Block Group 2, Census Tract 504.17, Gwinnett County, Georgia",1494,423,0,13,1494,423
1500000US131350504173,131350504173,"Block Group 3, Census Tract 504.17, Gwinnett County, Georgia",2095,501,526,299,1569,405
1500000US131350504181,131350504181,"Block Group 1, Census Tract 504.18, Gwinnett County, Georgia",3046,907,871,429,2175,888
1500000US131350504182,131350504182,"Block Group 2, Census Tract 504.18, Gwinnett County, Georgia",2562,668,682,402,1880,586
1500000US131350504183,131350504183,"Block Group 3, Census Tract 504.18, Gwinnett County, Georgia",1646,544,0,13,1646,544
1500000US131350504191,131350504191,"Block Group 1, Census Tract 504.19, Gwinnett County, Georgia",2342,725,385,199,1957,696
1500000US131350504192,131350504192,"Block Group 2, Census Tract 504.19, Gwinnett County, Georgia",2654,569,2112,513,542,266
1500000US131350504193,131350504193,"Block Group 3, Census Tract 504.19, Gwinnett County, Georgia",2903,1055,1518,631,1385,965
1500000US131350504211,131350504211,"Block Group 1, Census Tract 504.21, Gwinnett County, Georgia",2909,524,477,208,2432,526
1500000US131350504212,131350504212,"Block Group 2, Census Tract 504.21, Gwinnett County, Georgia",1218,384,507,289,711,313
1500000US131350504213,131350504213,"Block Group 3, Census Tract 504.21, Gwinnett County, Georgia",3171,768,1204,466,1967,710
1500000US131350504221,131350504221,"Block Group 1, Census Tract 504.22, Gwinnett County, Georgia",1945,543,616,309,1329,548
1500000US131350504222,131350504222,"Block Group 2, Census Tract 504.22, Gwinnett County, Georgia",2418,704,610,254,1808,698
1500000US131350504223,131350504223,"Block Group 3, Census Tract 504.22, Gwinnett County, Georgia",4135,779,1577,526,2558,821
1500000US131350504231,131350504231,"Block Group 1, Census Tract 504.23, Gwinnett County, Georgia",2621,509,2052,510,569,410
1500000US131350504232,131350504232,"Block Group 2, Census Tract 504.23, Gwinnett County, Georgia",2380,569,95,109,2285,567
1500000US131350504233,131350504233,"Block Group 3, Census Tract 504.23, Gwinnett County, Georgia",2325,757,1685,680,640,335
1500000US131350504241,131350504241,"Block Group 1, Census Tract 504.24, Gwinnett County, Georgia",2332,708,515,298,1817,654
1500000US131350504242,131350504242,"Block Group 2, Census Tract 504.24, Gwinnett County, Georgia",3930,978,1549,692,2381,705
1500000US131350504243,131350504243,"Block Group 3, Census Tract 504.24, Gwinnett County, Georgia",1649,446,1160,411,489,244
1500000US131350504251,131350504251,"Block Group 1, Census Tract 504.25, Gwinnett County, Georgia",1351,335,1091,246,260,258
1500000US131350504252,131350504252,"Block Group 2, Census Tract 504.25, Gwinnett County, Georgia",1633,280,1507,271,126,142
1500000US131350504253,131350504253,"Block Group 3, Census Tract 504.25, Gwinnett County, Georgia",2454,344,2040,319,414,248
1500000US131350504261,131350504261,"Block Group 1, Census Tract 504.26, Gwinnett County, Georgia",1717,545,1479,412,238,379
1500000US131350504262,131350504262,"Block Group 2, Census Tract 504.26, Gwinnett County, Georgia",760,269,619,274,141,212
1500000US131350504263,131350504263,"Block Group 3, Census Tract 504.26, Gwinnett County, Georgia",928,373,594,278,334,331
1500000US131350504264,131350504264,"Block Group 4, Census Tract 504.26, Gwinnett County, Georgia",1599,483,1125,292,474,428
1500000US131350504265,131350504265,"Block Group 5, Census Tract 504.26, Gwinnett County, Georgia",1801,329,1592,325,209,178
1500000US131350504271,131350504271,"Block Group 1, Census Tract 504.27, Gwinnett County, Georgia",3043,436,2088,380,955,430
1500000US131350504272,131350504272,"Block Group 2, Census Tract 504.27, Gwinnett County, Georgia",2031,302,1483,278,548,290
1500000US131350504273,131350504273,"Block Group 3, Census Tract 504.27, Gwinnett County, Georgia",1052,309,916,298,136,113
1500000US131350504281,131350504281,"Block Group 1, Census Tract 504.28, Gwinnett County, Georgia",1695,395,1503,310,192,246
1500000US131350504282,131350504282,"Block Group 2, Census Tract 504.28, Gwinnett County, Georgia",1092,391,864,339,228,219
1500000US131350504283,131350504283,"Block Group 3, Census Tract 504.28, Gwinnett County, Georgia",2339,295,2069,276,270,224
1500000US131350504284,131350504284,"Block Group 4, Census Tract 504.28, Gwinnett County, Georgia",1645,310,1393,270,252,231
1500000US131350504291,131350504291,"Block Group 1, Census Tract 504.29, Gwinnett County, Georgia",2348,446,1726,376,622,427
1500000US131350504292,131350504292,"Block Group 2, Census Tract 504.29, Gwinnett County, Georgia",3166,594,3065,612,101,160
1500000US131350504293,131350504293,"Block Group 3, Census Tract 504.29, Gwinnett County, Georgia",1785,470,1654,468,131,141
1500000US131350504301,131350504301,"Block Group 1, Census Tract 504.30, Gwinnett County, Georgia",1452,342,649,173,803,326
1500000US131350504302,131350504302,"Block Group 2, Census Tract 504.30, Gwinnett County, Georgia",1327,374,1066,355,261,187
1500000US131350504303,131350504303,"Block Group 3, Census Tract 504.30, Gwinnett County, Georgia",2675,372,2321,381,354,198
1500000US131350504311,131350504311,"Block Group 1, Census Tract 504.31, Gwinnett County, Georgia",1067,486,341,228,726,439
1500000US131350504312,131350504312,"Block Group 2, Census Tract 504.31, Gwinnett County, Georgia",3099,739,31,55,3068,740
1500000US131350504313,131350504313,"Block Group 3, Census Tract 504.31, Gwinnett County, Georgia",4222,572,3877,534,345,366
1500000US131350504321,131350504321,"Block Group 1, Census Tract 504.32, Gwinnett County, Georgia",1382,322,968,375,414,251
1500000US131350504322,131350504322,"Block Group 2, Census Tract 504.32, Gwinnett County, Georgia",1860,560,1032,298,828,524
1500000US131350504323,131350504323,"Block Group 3, Census Tract 504.32, Gwinnett County, Georgia",2824,429,2285,392,539,320
1500000US131350504331,131350504331,"Block Group 1, Census Tract 504.33, Gwinnett County, Georgia",2337,254,842,182,1495,251
1500000US131350504341,131350504341,"Block Group 1, Census Tract 504.34, Gwinnett County, Georgia",2005,828,403,204,1602,778
1500000US131350504342,131350504342,"Block Group 2, Census Tract 504.34, Gwinnett County, Georgia",4658,993,956,376,3702,1028
1500000US131350504343,131350504343,"Block Group 3, Census Tract 504.34, Gwinnett County, Georgia",1251,701,731,494,520,544
1500000US131350504351,131350504351,"Block Group 1, Census Tract 504.35, Gwinnett County, Georgia",2451,684,1385,511,1066,466
1500000US131350504352,131350504352,"Block Group 2, Census Tract 504.35, Gwinnett County, Georgia",1067,397,746,368,321,152
1500000US131350504361,131350504361,"Block Group 1, Census Tract 504.36, Gwinnett County, Georgia",1351,360,0,13,1351,360
1500000US131350504362,131350504362,"Block Group 2, Census Tract 504.36, Gwinnett County, Georgia",1544,558,925,377,619,511
1500000US131350504363,131350504363,"Block Group 3, Census Tract 504.36, Gwinnett County, Georgia",1394,543,717,392,677,420
1500000US131350504364,131350504364,"Block Group 4, Census Tract 504.36, Gwinnett County, Georgia",856,364,738,389,118,157
1500000US131350504365,131350504365,"Block Group 5, Census Tract 504.36, Gwinnett County, Georgia",1454,619,802,471,652,658
1500000US131350505111,131350505111,"Block Group 1, Census Tract 505.11, Gwinnett County, Georgia",2537,650,2188,573,349,320
1500000US131350505112,131350505112,"Block Group 2, Census Tract 505.11, Gwinnett County, Georgia",3386,680,1796,690,1590,551
1500000US131350505113,131350505113,"Block Group 3, Census Tract 505.11, Gwinnett County, Georgia",5263,947,3472,825,1791,653
1500000US131350505201,131350505201,"Block Group 1, Census Tract 505.20, Gwinnett County, Georgia",1771,308,1265,308,506,315
1500000US131350505202,131350505202,"Block Group 2, Census Tract 505.20, Gwinnett County, Georgia",1315,338,93,43,1222,343
1500000US131350505203,131350505203,"Block Group 3, Census Tract 505.20, Gwinnett County, Georgia",1710,413,42,49,1668,418
1500000US131350505211,131350505211,"Block Group 1, Census Tract 505.21, Gwinnett County, Georgia",620,302,145,138,475,278
1500000US131350505212,131350505212,"Block Group 2, Census Tract 505.21, Gwinnett County, Georgia",1471,389,1240,388,231,296
1500000US131350505213,131350505213,"Block Group 3, Census Tract 505.21, Gwinnett County, Georgia",1952,413,1309,329,643,294
1500000US131350505214,131350505214,"Block Group 4, Census Tract 505.21, Gwinnett County, Georgia",1382,395,187,65,1195,387
1500000US131350505221,131350505221,"Block Group 1, Census Tract 505.22, Gwinnett County, Georgia",1299,464,909,355,390,375
1500000US131350505222,131350505222,"Block Group 2, Census Tract 505.22, Gwinnett County, Georgia",4029,739,1946,550,2083,571
1500000US131350505231,131350505231,"Block Group 1, Census Tract 505.23, Gwinnett County, Georgia",3229,682,371,333,2858,649
1500000US131350505232,131350505232,"Block Group 2, Census Tract 505.23, Gwinnett County, Georgia",828,547,140,173,688,551
1500000US131350505233,131350505233,"Block Group 3, Census Tract 505.23, Gwinnett County, Georgia",2844,737,2495,613,349,472
1500000US131350505241,131350505241,"Block Group 1, Census Tract 505.24, Gwinnett County, Georgia",3164,603,1124,368,2040,588
1500000US131350505242,131350505242,"Block Group 2, Census Tract 505.24, Gwinnett County, Georgia",2912,638,1175,347,1737,638
1500000US131350505251,131350505251,"Block Group 1, Census Tract 505.25, Gwinnett County, Georgia",2430,667,1859,700,571,378
1500000US131350505252,131350505252,"Block Group 2, Census Tract 505.25, Gwinnett County, Georgia",1626,618,1206,544,420,387
1500000US131350505253,131350505253,"Block Group 3, Census Tract 505.25, Gwinnett County, Georgia",2677,589,2522,561,155,148
1500000US131350505254,131350505254,"Block Group 4, Census Tract 505.25, Gwinnett County, Georgia",1465,495,1197,416,268,266
1500000US131350505261,131350505261,"Block Group 1, Census Tract 505.26, Gwinnett County, Georgia",3034,525,1530,353,1504,523
1500000US131350505262,131350505262,"Block Group 2, Census Tract 505.26, Gwinnett County, Georgia",1796,434,417,212,1379,413
1500000US131350505271,131350505271,"Block Group 1, Census Tract 505.27, Gwinnett County, Georgia",2379,469,1704,487,675,363
1500000US131350505272,131350505272,"Block Group 2, Census Tract 505.27, Gwinnett County, Georgia",2239,487,1734,408,505,414
1500000US131350505273,131350505273,"Block Group 3, Census Tract 505.27, Gwinnett County, Georgia",1720,364,1615,356,105,130
1500000US131350505281,131350505281,"Block Group 1, Census Tract 505.28, Gwinnett County, Georgia",3367,463,2897,521,470,362
1500000US131350505282,131350505282,"Block Group 2, Census Tract 505.28, Gwinnett County, Georgia",1851,367,1802,366,49,61
1500000US131350505291,131350505291,"Block Group 1, Census Tract 505.29, Gwinnett County, Georgia",2487,392,1833,437,654,309
1500000US131350505292,131350505292,"Block Group 2, Census Tract 505.29, Gwinnett County, Georgia",1528,401,1101,392,427,242
1500000US131350505301,131350505301,"Block Group 1, Census Tract 505.30, Gwinnett County, Georgia",4076,437,3551,408,525,298
1500000US131350505302,131350505302,"Block Group 2, Census Tract 505.30, Gwinnett County, Georgia",1296,314,1103,296,193,149
1500000US131350505303,131350505303,"Block Group 3, Census Tract 505.30, Gwinnett County, Georgia",682,223,559,220,123,142
1500000US131350505311,131350505311,"Block Group 1, Census Tract 505.31, Gwinnett County, Georgia",2928,1007,1885,813,1043,693
1500000US131350505312,131350505312,"Block Group 2, Census Tract 505.31, Gwinnett County, Georgia",2252,1020,583,323,1669,990
1500000US131350505313,131350505313,"Block Group 3, Census Tract 505.31, Gwinnett County, Georgia",3492,878,2311,796,1181,634
1500000US131350505321,131350505321,"Block Group 1, Census Tract 505.32, Gwinnett County, Georgia",3842,846,2307,712,1535,736
1500000US131350505322,131350505322,"Block Group 2, Census Tract 505.32, Gwinnett County, Georgia",4096,645,3204,657,892,477
1500000US131350505331,131350505331,"Block Group 1, Census Tract 505.33, Gwinnett County, Georgia",1837,566,1519,534,318,272
1500000US131350505332,131350505332,"Block Group 2, Census Tract 505.33, Gwinnett County, Georgia",4290,865,3098,781,1192,730
1500000US131350505333,131350505333,"Block Group 3, Census Tract 505.33, Gwinnett County, Georgia",1839,536,769,311,1070,463
1500000US131350505341,131350505341,"Block Group 1, Census Tract 505.34, Gwinnett County, Georgia",3977,732,1848,637,2129,563
1500000US131350505342,131350505342,"Block Group 2, Census Tract 505.34, Gwinnett County, Georgia",2076,565,1448,466,628,393
1500000US131350505343,131350505343,"Block Group 3, Census Tract 505.34, Gwinnett County, Georgia",2312,552,1694,517,618,399
1500000US131350505351,131350505351,"Block Group 1, Census Tract 505.35, Gwinnett County, Georgia",3055,777,2726,780,329,243
1500000US131350505352,131350505352,"Block Group 2, Census Tract 505.35, Gwinnett County, Georgia",4064,731,2565,549,1499,640
1500000US131350505361,131350505361,"Block Group 1, Census Tract 505.36, Gwinnett County, Georgia",1522,305,1382,299,140,96
1500000US131350505362,131350505362,"Block Group 2, Census Tract 505.36, Gwinnett County, Georgia",1124,406,768,393,356,230
1500000US131350505363,131350505363,"Block Group 3, Census Tract 505.36, Gwinnett County, Georgia",2397,610,1415,521,982,434
1500000US131350505371,131350505371,"Block Group 1, Census Tract 505.37, Gwinnett County, Georgia",1827,486,243,166,1584,510
1500000US131350505372,131350505372,"Block Group 2, Census Tract 505.37, Gwinnett County, Georgia",3008,621,691,242,2317,584
1500000US131350505381,131350505381,"Block Group 1, Census Tract 505.38, Gwinnett County, Georgia",2196,560,2057,598,139,114
1500000US131350505382,131350505382,"Block Group 2, Census Tract 505.38, Gwinnett County, Georgia",3659,886,3312,847,347,361
1500000US131350505383,131350505383,"Block Group 3, Census Tract 505.38, Gwinnett County, Georgia",1983,724,1653,607,330,400
1500000US131350505391,131350505391,"Block Group 1, Census Tract 505.39, Gwinnett County, Georgia",3114,637,828,348,2286,634
1500000US131350505392,131350505392,"Block Group 2, Census Tract 505.39, Gwinnett County, Georgia",1919,408,1237,424,682,297
1500000US131350505401,131350505401,"Block Group 1, Census Tract 505.40, Gwinnett County, Georgia",2901,646,996,402,1905,574
1500000US131350505402,131350505402,"Block Group 2, Census Tract 505.40, Gwinnett County, Georgia",1984,632,0,13,1984,632
1500000US131350505403,131350505403,"Block Group 3, Census Tract 505.40, Gwinnett County, Georgia",2159,711,1877,609,282,339
1500000US131350505411,131350505411,"Block Group 1, Census Tract 505.41, Gwinnett County, Georgia",2176,795,16,16,2160,796
1500000US131350505412,131350505412,"Block Group 2, Census Tract 505.41, Gwinnett County, Georgia",1547,366,9,15,1538,369
1500000US131350505413,131350505413,"Block Group 3, Census Tract 505.41, Gwinnett County, Georgia",2270,557,18,30,2252,563
1500000US131350505421,131350505421,"Block Group 1, Census Tract 505.42, Gwinnett County, Georgia",4793,776,777,369,4016,834
1500000US131350505431,131350505431,"Block Group 1, Census Tract 505.43, Gwinnett County, Georgia",3786,651,2695,458,1091,536
1500000US131350505432,131350505432,"Block Group 2, Census Tract 505.43, Gwinnett County, Georgia",3337,609,2953,627,384,243
1500000US131350505441,131350505441,"Block Group 1, Census Tract 505.44, Gwinnett County, Georgia",4025,746,3540,791,485,269
1500000US131350505442,131350505442,"Block Group 2, Census Tract 505.44, Gwinnett County, Georgia",3506,832,3151,830,355,246
1500000US131350505443,131350505443,"Block Group 3, Census Tract 505.44, Gwinnett County, Georgia",4308,1020,2711,642,1597,911
1500000US131350505451,131350505451,"Block Group 1, Census Tract 505.45, Gwinnett County, Georgia",2692,1019,2044,846,648,525
1500000US131350505452,131350505452,"Block Group 2, Census Tract 505.45, Gwinnett County, Georgia",4137,1372,3972,1399,165,158
1500000US131350505453,131350505453,"Block Group 3, Census Tract 505.45, Gwinnett County, Georgia",4558,991,2786,868,1772,659
1500000US131350505461,131350505461,"Block Group 1, Census Tract 505.46, Gwinnett County, Georgia",10226,1421,9212,1404,1014,677
1500000US131350505462,131350505462,"Block Group 2, Census Tract 505.46, Gwinnett County, Georgia",2949,1120,1564,1114,1385,1185
1500000US131350505463,131350505463,"Block Group 3, Census Tract 505.46, Gwinnett County, Georgia",3677,1382,3577,1421,100,161
1500000US131350505471,131350505471,"Block Group 1, Census Tract 505.47, Gwinnett County, Georgia",5168,861,3938,898,1230,646
1500000US131350505472,131350505472,"Block Group 2, Census Tract 505.47, Gwinnett County, Georgia",2995,686,2770,680,225,176
1500000US131350505481,131350505481,"Block Group 1, Census Tract 505.48, Gwinnett County, Georgia",2419,592,1430,499,989,581
1500000US131350505482,131350505482,"Block Group 2, Census Tract 505.48, Gwinnett County, Georgia",2622,479,2486,509,136,162
1500000US131350505483,131350505483,"Block Group 3, Census Tract 505.48, Gwinnett County, Georgia",3933,686,3786,696,147,118
1500000US131350505491,131350505491,"Block Group 1, Census Tract 505.49, Gwinnett County, Georgia",3726,563,3222,412,504,479
1500000US131350505492,131350505492,"Block Group 2, Census Tract 505.49, Gwinnett County, Georgia",1465,374,1048,301,417,355
1500000US131350506051,131350506051,"Block Group 1, Census Tract 506.05, Gwinnett County, Georgia",7977,1387,6721,1124,1256,1086
1500000US131350506052,131350506052,"Block Group 2, Census Tract 506.05, Gwinnett County, Georgia",2045,711,1660,520,385,431
1500000US131350506053,131350506053,"Block Group 3, Census Tract 506.05, Gwinnett County, Georgia",4473,1251,2612,1032,1861,806
1500000US131350506061,131350506061,"Block Group 1, Census Tract 506.06, Gwinnett County, Georgia",6434,1490,5926,1415,508,618
1500000US131350506062,131350506062,"Block Group 2, Census Tract 506.06, Gwinnett County, Georgia",6115,1622,5381,1547,734,641
1500000US131350506063,131350506063,"Block Group 3, Census Tract 506.06, Gwinnett County, Georgia",9639,1838,5933,1603,3706,1773
1500000US131350506071,131350506071,"Block Group 1, Census Tract 506.07, Gwinnett County, Georgia",10219,1547,7843,1315,2376,1559
1500000US131350506072,131350506072,"Block Group 2, Census Tract 506.07, Gwinnett County, Georgia",6940,1299,5654,1285,1286,918
1500000US131350506081,131350506081,"Block Group 1, Census Tract 506.08, Gwinnett County, Georgia",8285,1428,6666,1421,1619,1013
1500000US131350506082,131350506082,"Block Group 2, Census Tract 506.08, Gwinnett County, Georgia",6437,1372,5773,1354,664,435
1500000US131350506083,131350506083,"Block Group 3, Census Tract 506.08, Gwinnett County, Georgia",2633,836,2310,864,323,301
1500000US131350506091,131350506091,"Block Group 1, Census Tract 506.09, Gwinnett County, Georgia",2052,646,1863,628,189,182
1500000US131350506092,131350506092,"Block Group 2, Census Tract 506.09, Gwinnett County, Georgia",6445,651,5161,829,1284,597
1500000US131350506093,131350506093,"Block Group 3, Census Tract 506.09, Gwinnett County, Georgia",3035,908,2894,886,141,226
1500000US131350506101,131350506101,"Block Group 1, Census Tract 506.10, Gwinnett County, Georgia",5186,972,5089,988,97,159
1500000US131350506102,131350506102,"Block Group 2, Census Tract 506.10, Gwinnett County, Georgia",4387,1201,3254,682,1133,1255
1500000US131350506103,131350506103,"Block Group 3, Census Tract 506.10, Gwinnett County, Georgia",3456,850,3124,829,332,350
1500000US131350506104,131350506104,"Block Group 4, Census Tract 506.10, Gwinnett County, Georgia",3796,705,3554,700,242,303
1500000US131350507091,131350507091,"Block Group 1, Census Tract 507.09, Gwinnett County, Georgia",5528,843,4210,902,1318,553
1500000US131350507092,131350507092,"Block Group 2, Census Tract 507.09, Gwinnett County, Georgia",2693,657,1547,445,1146,563
1500000US131350507093,131350507093,"Block Group 3, Census Tract 507.09, Gwinnett County, Georgia",4372,749,3009,702,1363,681
1500000US131350507121,131350507121,"Block Group 1, Census Tract 507.12, Gwinnett County, Georgia",1703,340,1422,330,281,173
1500000US131350507122,131350507122,"Block Group 2, Census Tract 507.12, Gwinnett County, Georgia",1666,423,1541,427,125,163
1500000US131350507123,131350507123,"Block Group 3, Census Tract 507.12, Gwinnett County, Georgia",2054,533,1849,541,205,244
1500000US131350507124,131350507124,"Block Group 4, Census Tract 507.12, Gwinnett County, Georgia",1351,328,1235,319,116,182
1500000US131350507131,131350507131,"Block Group 1, Census Tract 507.13, Gwinnett County, Georgia",4348,568,3808,626,540,252
1500000US131350507132,131350507132,"Block Group 2, Census Tract 507.13, Gwinnett County, Georgia",659,183,659,183,0,13
1500000US131350507133,131350507133,"Block Group 3, Census Tract 507.13, Gwinnett County, Georgia",1553,316,1553,316,0,13
1500000US131350507134,131350507134,"Block Group 4, Census Tract 507.13, Gwinnett County, Georgia",1092,319,1057,322,35,54
1500000US131350507141,131350507141,"Block Group 1, Census Tract 507.14, Gwinnett County, Georgia",2476,381,2260,357,216,174
1500000US131350507142,131350507142,"Block Group 2, Census Tract 507.14, Gwinnett County, Georgia",2982,352,2103,354,879,284
1500000US131350507151,131350507151,"Block Group 1, Census Tract 507.15, Gwinnett County, Georgia",2844,420,1983,370,861,550
1500000US131350507152,131350507152,"Block Group 2, Census Tract 507.15, Gwinnett County, Georgia",1529,428,1204,260,325,440
1500000US131350507153,131350507153,"Block Group 3, Census Tract 507.15, Gwinnett County, Georgia",1432,259,927,214,505,310
1500000US131350507181,131350507181,"Block Group 1, Census Tract 507.18, Gwinnett County, Georgia",2334,592,1681,500,653,487
1500000US131350507182,131350507182,"Block Group 2, Census Tract 507.18, Gwinnett County, Georgia",2426,524,2011,447,415,318
1500000US131350507183,131350507183,"Block Group 3, Census Tract 507.18, Gwinnett County, Georgia",530,172,469,174,61,69
1500000US131350507184,131350507184,"Block Group 4, Census Tract 507.18, Gwinnett County, Georgia",2914,574,2678,579,236,168
1500000US131350507191,131350507191,"Block Group 1, Census Tract 507.19, Gwinnett County, Georgia",3265,436,1740,352,1525,499
1500000US131350507192,131350507192,"Block Group 2, Census Tract 507.19, Gwinnett County, Georgia",2172,509,608,227,1564,435
1500000US131350507201,131350507201,"Block Group 1, Census Tract 507.20, Gwinnett County, Georgia",2002,613,1793,592,209,196
1500000US131350507202,131350507202,"Block Group 2, Census Tract 507.20, Gwinnett County, Georgia",2677,904,1929,611,748,651
1500000US131350507203,131350507203,"Block Group 3, Census Tract 507.20, Gwinnett County, Georgia",1677,444,1258,463,419,444
1500000US131350507204,131350507204,"Block Group 4, Census Tract 507.20, Gwinnett County, Georgia",1522,407,971,378,551,391
1500000US131350507211,131350507211,"Block Group 1, Census Tract 507.21, Gwinnett County, Georgia",2968,676,2456,654,512,293
1500000US131350507212,131350507212,"Block Group 2, Census Tract 507.21, Gwinnett County, Georgia",813,432,622,316,191,309
1500000US131350507213,131350507213,"Block Group 3, Census Tract 507.21, Gwinnett County, Georgia",2637,584,2125,579,512,320
1500000US131350507214,131350507214,"Block Group 4, Census Tract 507.21, Gwinnett County, Georgia",3104,684,3094,684,10,17
1500000US131350507221,131350507221,"Block Group 1, Census Tract 507.22, Gwinnett County, Georgia",3694,526,2644,569,1050,509
1500000US131350507231,131350507231,"Block Group 1, Census Tract 507.23, Gwinnett County, Georgia",1124,280,873,271,251,125
1500000US131350507232,131350507232,"Block Group 2, Census Tract 507.23, Gwinnett County, Georgia",3258,547,2947,559,311,265
1500000US131350507233,131350507233,"Block Group 3, Census Tract 507.23, Gwinnett County, Georgia",3035,426,2493,492,542,388
1500000US131350507241,131350507241,"Block Group 1, Census Tract 507.24, Gwinnett County, Georgia",4711,1566,3039,1043,1672,1419
1500000US131350507242,131350507242,"Block Group 2, Census Tract 507.24, Gwinnett County, Georgia",5445,1114,4280,1042,1165,825
1500000US131350507243,131350507243,"Block Group 3, Census Tract 507.24, Gwinnett County, Georgia",5693,951,4410,878,1283,636
1500000US131350507251,131350507251,"Block Group 1, Census Tract 507.25, Gwinnett County, Georgia",2455,495,1862,447,593,297
1500000US131350507252,131350507252,"Block Group 2, Census Tract 507.25, Gwinnett County, Georgia",2469,603,1574,296,895,610
1500000US131350507253,131350507253,"Block Group 3, Census Tract 507.25, Gwinnett County, Georgia",997,278,858,264,139,151
1500000US131350507261,131350507261,"Block Group 1, Census Tract 507.26, Gwinnett County, Georgia",4070,888,3101,841,969,639
1500000US131350507262,131350507262,"Block Group 2, Census Tract 507.26, Gwinnett County, Georgia",5283,1005,4249,750,1034,795
1500000US131350507271,131350507271,"Block Group 1, Census Tract 507.27, Gwinnett County, Georgia",2051,894,1224,436,827,958
1500000US131350507272,131350507272,"Block Group 2, Census Tract 507.27, Gwinnett County, Georgia",4446,761,4285,782,161,167
1500000US131350507273,131350507273,"Block Group 3, Census Tract 507.27, Gwinnett County, Georgia",3993,755,3896,756,97,148
1500000US131350507281,131350507281,"Block Group 1, Census Tract 507.28, Gwinnett County, Georgia",5096,1400,4376,1398,720,713
1500000US131350507282,131350507282,"Block Group 2, Census Tract 507.28, Gwinnett County, Georgia",3721,1226,2901,1061,820,1126
1500000US131350507283,131350507283,"Block Group 3, Census Tract 507.28, Gwinnett County, Georgia",3011,949,2314,811,697,682
1500000US131350507284,131350507284,"Block Group 4, Census Tract 507.28, Gwinnett County, Georgia",1879,615,1494,548,385,457
1500000US131350507291,131350507291,"Block Group 1, Census Tract 507.29, Gwinnett County, Georgia",791,301,507,306,284,185
1500000US131350507292,131350507292,"Block Group 2, Census Tract 507.29, Gwinnett County, Georgia",2491,480,1208,376,1283,342
1500000US131350507301,131350507301,"Block Group 1, Census Tract 507.30, Gwinnett County, Georgia",3827,1012,2079,539,1748,1001
1500000US131350507302,131350507302,"Block Group 2, Census Tract 507.30, Gwinnett County, Georgia",3239,953,2464,854,775,521
1500000US131350507311,131350507311,"Block Group 1, Census Tract 507.31, Gwinnett County, Georgia",4948,969,4725,993,223,235
1500000US131350507312,131350507312,"Block Group 2, Census Tract 507.31, Gwinnett County, Georgia",4429,756,3734,667,695,507
1500000US131370001001,131370001001,"Block Group 1, Census Tract 1, Habersham County, Georgia",1491,314,1198,282,293,216
1500000US131370001002,131370001002,"Block Group 2, Census Tract 1, Habersham County, Georgia",2318,331,1918,360,400,235
1500000US131370002011,131370002011,"Block Group 1, Census Tract 2.01, Habersham County, Georgia",1940,474,1790,480,150,78
1500000US131370002012,131370002012,"Block Group 2, Census Tract 2.01, Habersham County, Georgia",1967,372,1729,351,238,133
1500000US131370002021,131370002021,"Block Group 1, Census Tract 2.02, Habersham County, Georgia",1201,357,860,270,341,231
1500000US131370002022,131370002022,"Block Group 2, Census Tract 2.02, Habersham County, Georgia",2130,460,1893,467,237,165
1500000US131370002023,131370002023,"Block Group 3, Census Tract 2.02, Habersham County, Georgia",1859,317,1667,313,192,178
1500000US131370003001,131370003001,"Block Group 1, Census Tract 3, Habersham County, Georgia",1351,429,778,162,573,399
1500000US131370003002,131370003002,"Block Group 2, Census Tract 3, Habersham County, Georgia",1364,278,876,204,488,236
1500000US131370003003,131370003003,"Block Group 3, Census Tract 3, Habersham County, Georgia",1165,236,732,202,433,142
1500000US131370004001,131370004001,"Block Group 1, Census Tract 4, Habersham County, Georgia",3343,525,2875,517,468,222
1500000US131370004002,131370004002,"Block Group 2, Census Tract 4, Habersham County, Georgia",1190,267,923,276,267,121
1500000US131370004003,131370004003,"Block Group 3, Census Tract 4, Habersham County, Georgia",980,246,760,216,220,154
1500000US131370005001,131370005001,"Block Group 1, Census Tract 5, Habersham County, Georgia",1801,480,1449,455,352,235
1500000US131370005002,131370005002,"Block Group 2, Census Tract 5, Habersham County, Georgia",1693,509,801,249,892,523
1500000US131370005003,131370005003,"Block Group 3, Census Tract 5, Habersham County, Georgia",1164,378,654,199,510,360
1500000US131370005004,131370005004,"Block Group 4, Census Tract 5, Habersham County, Georgia",537,232,474,229,63,64
1500000US131370005005,131370005005,"Block Group 5, Census Tract 5, Habersham County, Georgia",898,254,645,251,253,172
1500000US131370006011,131370006011,"Block Group 1, Census Tract 6.01, Habersham County, Georgia",1798,353,1687,353,111,70
1500000US131370006012,131370006012,"Block Group 2, Census Tract 6.01, Habersham County, Georgia",1526,330,1214,351,312,161
1500000US131370006013,131370006013,"Block Group 3, Census Tract 6.01, Habersham County, Georgia",606,187,479,171,127,122
1500000US131370006021,131370006021,"Block Group 1, Census Tract 6.02, Habersham County, Georgia",1235,312,1119,295,116,177
1500000US131370006022,131370006022,"Block Group 2, Census Tract 6.02, Habersham County, Georgia",1829,425,1256,261,573,396
1500000US131370006023,131370006023,"Block Group 3, Census Tract 6.02, Habersham County, Georgia",2834,527,1294,374,1540,481
1500000US131370006024,131370006024,"Block Group 4, Census Tract 6.02, Habersham County, Georgia",1491,392,428,223,1063,354
1500000US131370006025,131370006025,"Block Group 5, Census Tract 6.02, Habersham County, Georgia",953,377,564,393,389,257
1500000US131390001011,131390001011,"Block Group 1, Census Tract 1.01, Hall County, Georgia",1943,259,1516,248,427,146
1500000US131390001012,131390001012,"Block Group 2, Census Tract 1.01, Hall County, Georgia",2642,325,2036,298,606,193
1500000US131390001021,131390001021,"Block Group 1, Census Tract 1.02, Hall County, Georgia",2121,315,1655,349,466,256
1500000US131390001022,131390001022,"Block Group 2, Census Tract 1.02, Hall County, Georgia",1347,348,1153,348,194,133
1500000US131390002011,131390002011,"Block Group 1, Census Tract 2.01, Hall County, Georgia",2057,571,1360,377,697,589
1500000US131390002012,131390002012,"Block Group 2, Census Tract 2.01, Hall County, Georgia",1220,395,957,353,263,244
1500000US131390002013,131390002013,"Block Group 3, Census Tract 2.01, Hall County, Georgia",2466,639,1237,424,1229,645
1500000US131390002031,131390002031,"Block Group 1, Census Tract 2.03, Hall County, Georgia",2204,295,1671,316,533,208
1500000US131390002032,131390002032,"Block Group 2, Census Tract 2.03, Hall County, Georgia",2187,233,2026,234,161,88
1500000US131390002041,131390002041,"Block Group 1, Census Tract 2.04, Hall County, Georgia",1899,292,1751,284,148,100
1500000US131390002042,131390002042,"Block Group 2, Census Tract 2.04, Hall County, Georgia",2088,371,1439,322,649,285
1500000US131390003021,131390003021,"Block Group 1, Census Tract 3.02, Hall County, Georgia",1471,333,958,237,513,277
1500000US131390003022,131390003022,"Block Group 2, Census Tract 3.02, Hall County, Georgia",2994,801,2058,517,936,626
1500000US131390003023,131390003023,"Block Group 3, Census Tract 3.02, Hall County, Georgia",1193,332,1035,282,158,185
1500000US131390003024,131390003024,"Block Group 4, Census Tract 3.02, Hall County, Georgia",1194,349,772,234,422,315
1500000US131390003031,131390003031,"Block Group 1, Census Tract 3.03, Hall County, Georgia",1948,345,1121,302,827,236
1500000US131390003032,131390003032,"Block Group 2, Census Tract 3.03, Hall County, Georgia",777,381,417,177,360,398
1500000US131390003041,131390003041,"Block Group 1, Census Tract 3.04, Hall County, Georgia",1990,463,1137,387,853,396
1500000US131390003042,131390003042,"Block Group 2, Census Tract 3.04, Hall County, Georgia",1519,322,1354,325,165,150
1500000US131390003051,131390003051,"Block Group 1, Census Tract 3.05, Hall County, Georgia",1161,296,829,229,332,230
1500000US131390003052,131390003052,"Block Group 2, Census Tract 3.05, Hall County, Georgia",3112,635,2126,336,986,588
1500000US131390003053,131390003053,"Block Group 3, Census Tract 3.05, Hall County, Georgia",598,185,540,185,58,53
1500000US131390004001,131390004001,"Block Group 1, Census Tract 4, Hall County, Georgia",1884,517,1441,524,443,349
1500000US131390004002,131390004002,"Block Group 2, Census Tract 4, Hall County, Georgia",1466,597,1063,570,403,313
1500000US131390004003,131390004003,"Block Group 3, Census Tract 4, Hall County, Georgia",1484,771,1155,794,329,207
1500000US131390004004,131390004004,"Block Group 4, Census Tract 4, Hall County, Georgia",1872,578,449,279,1423,636
1500000US131390005001,131390005001,"Block Group 1, Census Tract 5, Hall County, Georgia",891,273,854,277,37,59
1500000US131390005002,131390005002,"Block Group 2, Census Tract 5, Hall County, Georgia",2067,520,1088,308,979,468
1500000US131390005003,131390005003,"Block Group 3, Census Tract 5, Hall County, Georgia",499,243,266,128,233,202
1500000US131390005004,131390005004,"Block Group 4, Census Tract 5, Hall County, Georgia",2515,456,1949,390,566,371
1500000US131390005005,131390005005,"Block Group 5, Census Tract 5, Hall County, Georgia",1111,368,851,305,260,251
1500000US131390006001,131390006001,"Block Group 1, Census Tract 6, Hall County, Georgia",1361,599,598,195,763,609
1500000US131390006002,131390006002,"Block Group 2, Census Tract 6, Hall County, Georgia",2148,694,1452,576,696,344
1500000US131390006003,131390006003,"Block Group 3, Census Tract 6, Hall County, Georgia",1937,520,1062,394,875,470
1500000US131390007011,131390007011,"Block Group 1, Census Tract 7.01, Hall County, Georgia",2420,485,1479,394,941,429
1500000US131390007012,131390007012,"Block Group 2, Census Tract 7.01, Hall County, Georgia",4002,630,1821,620,2181,678
1500000US131390007021,131390007021,"Block Group 1, Census Tract 7.02, Hall County, Georgia",3020,534,2666,452,354,312
1500000US131390007022,131390007022,"Block Group 2, Census Tract 7.02, Hall County, Georgia",2670,523,1661,455,1009,534
1500000US131390008001,131390008001,"Block Group 1, Census Tract 8, Hall County, Georgia",915,231,490,192,425,260
1500000US131390008002,131390008002,"Block Group 2, Census Tract 8, Hall County, Georgia",754,330,252,212,502,264
1500000US131390008003,131390008003,"Block Group 3, Census Tract 8, Hall County, Georgia",1327,320,380,172,947,290
1500000US131390009001,131390009001,"Block Group 1, Census Tract 9, Hall County, Georgia",1188,329,534,200,654,319
1500000US131390009002,131390009002,"Block Group 2, Census Tract 9, Hall County, Georgia",1498,363,816,331,682,383
1500000US131390009003,131390009003,"Block Group 3, Census Tract 9, Hall County, Georgia",1464,591,847,249,617,635
1500000US131390009004,131390009004,"Block Group 4, Census Tract 9, Hall County, Georgia",1048,324,95,79,953,324
1500000US131390010021,131390010021,"Block Group 1, Census Tract 10.02, Hall County, Georgia",1231,247,757,218,474,195
1500000US131390010022,131390010022,"Block Group 2, Census Tract 10.02, Hall County, Georgia",2310,634,1483,461,827,537
1500000US131390010023,131390010023,"Block Group 3, Census Tract 10.02, Hall County, Georgia",3322,721,2631,601,691,521
1500000US131390010031,131390010031,"Block Group 1, Census Tract 10.03, Hall County, Georgia",2537,598,183,131,2354,617
1500000US131390010032,131390010032,"Block Group 2, Census Tract 10.03, Hall County, Georgia",3219,676,630,296,2589,653
1500000US131390010033,131390010033,"Block Group 3, Census Tract 10.03, Hall County, Georgia",860,478,0,13,860,478
1500000US131390010041,131390010041,"Block Group 1, Census Tract 10.04, Hall County, Georgia",3205,292,516,122,2689,267
1500000US131390011011,131390011011,"Block Group 1, Census Tract 11.01, Hall County, Georgia",1372,457,84,101,1288,459
1500000US131390011012,131390011012,"Block Group 2, Census Tract 11.01, Hall County, Georgia",1675,597,476,275,1199,582
1500000US131390011013,131390011013,"Block Group 3, Census Tract 11.01, Hall County, Georgia",1448,487,234,224,1214,442
1500000US131390011021,131390011021,"Block Group 1, Census Tract 11.02, Hall County, Georgia",4460,492,2630,602,1830,522
1500000US131390012011,131390012011,"Block Group 1, Census Tract 12.01, Hall County, Georgia",1651,433,1326,457,325,201
1500000US131390012012,131390012012,"Block Group 2, Census Tract 12.01, Hall County, Georgia",2104,624,422,361,1682,547
1500000US131390012013,131390012013,"Block Group 3, Census Tract 12.01, Hall County, Georgia",3339,601,2489,520,850,474
1500000US131390012021,131390012021,"Block Group 1, Census Tract 12.02, Hall County, Georgia",4632,905,3186,878,1446,638
1500000US131390012022,131390012022,"Block Group 2, Census Tract 12.02, Hall County, Georgia",2089,661,1296,568,793,440
1500000US131390013011,131390013011,"Block Group 1, Census Tract 13.01, Hall County, Georgia",1972,368,1934,365,38,43
1500000US131390013012,131390013012,"Block Group 2, Census Tract 13.01, Hall County, Georgia",1395,478,1178,418,217,300
1500000US131390013013,131390013013,"Block Group 3, Census Tract 13.01, Hall County, Georgia",2619,387,1518,488,1101,396
1500000US131390013021,131390013021,"Block Group 1, Census Tract 13.02, Hall County, Georgia",2656,453,2279,432,377,203
1500000US131390013022,131390013022,"Block Group 2, Census Tract 13.02, Hall County, Georgia",2568,382,2365,374,203,174
1500000US131390014021,131390014021,"Block Group 1, Census Tract 14.02, Hall County, Georgia",1013,298,965,294,48,55
1500000US131390014022,131390014022,"Block Group 2, Census Tract 14.02, Hall County, Georgia",2114,383,1926,357,188,213
1500000US131390014023,131390014023,"Block Group 3, Census Tract 14.02, Hall County, Georgia",2402,449,2211,451,191,159
1500000US131390014031,131390014031,"Block Group 1, Census Tract 14.03, Hall County, Georgia",1649,455,843,386,806,441
1500000US131390014032,131390014032,"Block Group 2, Census Tract 14.03, Hall County, Georgia",1990,394,844,274,1146,330
1500000US131390014041,131390014041,"Block Group 1, Census Tract 14.04, Hall County, Georgia",3635,719,1951,540,1684,692
1500000US131390014042,131390014042,"Block Group 2, Census Tract 14.04, Hall County, Georgia",742,269,214,148,528,236
1500000US131390014043,131390014043,"Block Group 3, Census Tract 14.04, Hall County, Georgia",815,227,573,219,242,166
1500000US131390015011,131390015011,"Block Group 1, Census Tract 15.01, Hall County, Georgia",3026,432,2834,450,192,163
1500000US131390015012,131390015012,"Block Group 2, Census Tract 15.01, Hall County, Georgia",1577,362,947,314,630,359
1500000US131390015021,131390015021,"Block Group 1, Census Tract 15.02, Hall County, Georgia",2135,461,1927,471,208,148
1500000US131390015022,131390015022,"Block Group 2, Census Tract 15.02, Hall County, Georgia",2825,635,2369,553,456,299
1500000US131390016031,131390016031,"Block Group 1, Census Tract 16.03, Hall County, Georgia",3067,469,2696,447,371,227
1500000US131390016032,131390016032,"Block Group 2, Census Tract 16.03, Hall County, Georgia",2247,450,1683,491,564,260
1500000US131390016041,131390016041,"Block Group 1, Census Tract 16.04, Hall County, Georgia",3136,554,2189,396,947,606
1500000US131390016042,131390016042,"Block Group 2, Census Tract 16.04, Hall County, Georgia",3589,525,3134,516,455,267
1500000US131390016051,131390016051,"Block Group 1, Census Tract 16.05, Hall County, Georgia",1605,364,1290,316,315,238
1500000US131390016052,131390016052,"Block Group 2, Census Tract 16.05, Hall County, Georgia",3748,357,3314,311,434,235
1500000US131390016061,131390016061,"Block Group 1, Census Tract 16.06, Hall County, Georgia",1573,341,1337,292,236,177
1500000US131390016062,131390016062,"Block Group 2, Census Tract 16.06, Hall County, Georgia",2159,372,517,212,1642,340
1500000US131390016071,131390016071,"Block Group 1, Census Tract 16.07, Hall County, Georgia",1569,402,813,281,756,384
1500000US131390016072,131390016072,"Block Group 2, Census Tract 16.07, Hall County, Georgia",1853,391,1691,388,162,105
1500000US131390016073,131390016073,"Block Group 3, Census Tract 16.07, Hall County, Georgia",1364,360,1196,329,168,212
1500000US131390016081,131390016081,"Block Group 1, Census Tract 16.08, Hall County, Georgia",5525,361,4928,457,597,290
1500000US131414803001,131414803001,"Block Group 1, Census Tract 4803, Hancock County, Georgia",1823,313,1745,313,78,87
1500000US131414803002,131414803002,"Block Group 2, Census Tract 4803, Hancock County, Georgia",472,256,443,258,29,38
1500000US131414804001,131414804001,"Block Group 1, Census Tract 4804, Hancock County, Georgia",1298,385,1113,380,185,137
1500000US131414804002,131414804002,"Block Group 2, Census Tract 4804, Hancock County, Georgia",452,131,405,132,47,41
1500000US131414804003,131414804003,"Block Group 3, Census Tract 4804, Hancock County, Georgia",918,266,457,212,461,229
1500000US131414804004,131414804004,"Block Group 4, Census Tract 4804, Hancock County, Georgia",1052,324,577,206,475,279
1500000US131414804005,131414804005,"Block Group 5, Census Tract 4804, Hancock County, Georgia",993,253,468,171,525,197
1500000US131430101001,131430101001,"Block Group 1, Census Tract 101, Haralson County, Georgia",1871,337,1412,312,459,201
1500000US131430101002,131430101002,"Block Group 2, Census Tract 101, Haralson County, Georgia",1514,389,1277,414,237,148
1500000US131430102001,131430102001,"Block Group 1, Census Tract 102, Haralson County, Georgia",849,324,810,330,39,41
1500000US131430102002,131430102002,"Block Group 2, Census Tract 102, Haralson County, Georgia",1937,501,1775,522,162,129
1500000US131430102003,131430102003,"Block Group 3, Census Tract 102, Haralson County, Georgia",2631,383,1545,335,1086,410
1500000US131430102004,131430102004,"Block Group 4, Census Tract 102, Haralson County, Georgia",782,269,620,244,162,177
1500000US131430103011,131430103011,"Block Group 1, Census Tract 103.01, Haralson County, Georgia",1414,303,1038,267,376,218
1500000US131430103012,131430103012,"Block Group 2, Census Tract 103.01, Haralson County, Georgia",1918,285,1309,316,609,288
1500000US131430103021,131430103021,"Block Group 1, Census Tract 103.02, Haralson County, Georgia",1484,551,654,401,830,402
1500000US131430103022,131430103022,"Block Group 2, Census Tract 103.02, Haralson County, Georgia",1746,492,1271,491,475,238
1500000US131430103023,131430103023,"Block Group 3, Census Tract 103.02, Haralson County, Georgia",1634,389,1071,345,563,232
1500000US131430103024,131430103024,"Block Group 4, Census Tract 103.02, Haralson County, Georgia",458,231,369,234,89,69
1500000US131430103025,131430103025,"Block Group 5, Census Tract 103.02, Haralson County, Georgia",1610,460,1306,451,304,186
1500000US131430103026,131430103026,"Block Group 6, Census Tract 103.02, Haralson County, Georgia",613,229,613,229,0,13
1500000US131430104001,131430104001,"Block Group 1, Census Tract 104, Haralson County, Georgia",2971,528,1758,449,1213,550
1500000US131430104002,131430104002,"Block Group 2, Census Tract 104, Haralson County, Georgia",2224,472,1457,452,767,377
1500000US131430104003,131430104003,"Block Group 3, Census Tract 104, Haralson County, Georgia",2529,496,1869,464,660,338
1500000US131451201981,131451201981,"Block Group 1, Census Tract 1201.98, Harris County, Georgia",2181,491,1374,388,807,405
1500000US131451201982,131451201982,"Block Group 2, Census Tract 1201.98, Harris County, Georgia",1391,319,1237,334,154,163
1500000US131451201983,131451201983,"Block Group 3, Census Tract 1201.98, Harris County, Georgia",575,197,487,186,88,75
1500000US131451201984,131451201984,"Block Group 4, Census Tract 1201.98, Harris County, Georgia",986,268,617,224,369,154
1500000US131451202001,131451202001,"Block Group 1, Census Tract 1202, Harris County, Georgia",1742,342,1220,328,522,253
1500000US131451202002,131451202002,"Block Group 2, Census Tract 1202, Harris County, Georgia",1929,419,1497,381,432,191
1500000US131451203001,131451203001,"Block Group 1, Census Tract 1203, Harris County, Georgia",1256,338,843,266,413,183
1500000US131451203002,131451203002,"Block Group 2, Census Tract 1203, Harris County, Georgia",1776,470,1529,392,247,263
1500000US131451203003,131451203003,"Block Group 3, Census Tract 1203, Harris County, Georgia",2320,481,1948,486,372,290
1500000US131451203004,131451203004,"Block Group 4, Census Tract 1203, Harris County, Georgia",872,312,794,308,78,74
1500000US131451203005,131451203005,"Block Group 5, Census Tract 1203, Harris County, Georgia",2730,456,2398,437,332,309
1500000US131451204011,131451204011,"Block Group 1, Census Tract 1204.01, Harris County, Georgia",2754,455,2554,457,200,167
1500000US131451204012,131451204012,"Block Group 2, Census Tract 1204.01, Harris County, Georgia",3748,581,3430,496,318,310
1500000US131451204021,131451204021,"Block Group 1, Census Tract 1204.02, Harris County, Georgia",1081,397,815,410,266,150
1500000US131451204022,131451204022,"Block Group 2, Census Tract 1204.02, Harris County, Georgia",4930,576,4325,588,605,399
1500000US131451204023,131451204023,"Block Group 3, Census Tract 1204.02, Harris County, Georgia",2035,596,1832,639,203,173
1500000US131479601001,131479601001,"Block Group 1, Census Tract 9601, Hart County, Georgia",1512,452,1253,454,259,174
1500000US131479601002,131479601002,"Block Group 2, Census Tract 9601, Hart County, Georgia",833,243,742,251,91,106
1500000US131479601003,131479601003,"Block Group 3, Census Tract 9601, Hart County, Georgia",1327,356,1030,367,297,277
1500000US131479601004,131479601004,"Block Group 4, Census Tract 9601, Hart County, Georgia",856,360,383,204,473,290
1500000US131479601005,131479601005,"Block Group 5, Census Tract 9601, Hart County, Georgia",1152,404,1125,404,27,30
1500000US131479602001,131479602001,"Block Group 1, Census Tract 9602, Hart County, Georgia",1481,288,1300,289,181,130
1500000US131479602002,131479602002,"Block Group 2, Census Tract 9602, Hart County, Georgia",1112,246,731,177,381,220
1500000US131479602003,131479602003,"Block Group 3, Census Tract 9602, Hart County, Georgia",723,210,704,211,19,15
1500000US131479603001,131479603001,"Block Group 1, Census Tract 9603, Hart County, Georgia",1808,330,1309,272,499,293
1500000US131479603002,131479603002,"Block Group 2, Census Tract 9603, Hart County, Georgia",1456,273,738,174,718,262
1500000US131479604001,131479604001,"Block Group 1, Census Tract 9604, Hart County, Georgia",1455,411,988,317,467,268
1500000US131479604002,131479604002,"Block Group 2, Census Tract 9604, Hart County, Georgia",2156,438,1635,473,521,366
1500000US131479604003,131479604003,"Block Group 3, Census Tract 9604, Hart County, Georgia",634,278,316,156,318,246
1500000US131479604004,131479604004,"Block Group 4, Census Tract 9604, Hart County, Georgia",919,264,381,153,538,264
1500000US131479605001,131479605001,"Block Group 1, Census Tract 9605, Hart County, Georgia",1386,456,996,382,390,329
1500000US131479605002,131479605002,"Block Group 2, Census Tract 9605, Hart County, Georgia",1558,425,1207,385,351,231
1500000US131479605003,131479605003,"Block Group 3, Census Tract 9605, Hart County, Georgia",892,429,333,165,559,429
1500000US131479605004,131479605004,"Block Group 4, Census Tract 9605, Hart County, Georgia",1442,277,930,202,512,291
1500000US131479605005,131479605005,"Block Group 5, Census Tract 9605, Hart County, Georgia",1948,501,1441,424,507,351
1500000US131499701001,131499701001,"Block Group 1, Census Tract 9701, Heard County, Georgia",1462,391,1116,330,346,224
1500000US131499701002,131499701002,"Block Group 2, Census Tract 9701, Heard County, Georgia",1555,333,831,287,724,182
1500000US131499701003,131499701003,"Block Group 3, Census Tract 9701, Heard County, Georgia",1345,240,995,208,350,182
1500000US131499702001,131499702001,"Block Group 1, Census Tract 9702, Heard County, Georgia",1882,376,1290,333,592,262
1500000US131499702002,131499702002,"Block Group 2, Census Tract 9702, Heard County, Georgia",1259,202,1048,214,211,135
1500000US131499702003,131499702003,"Block Group 3, Census Tract 9702, Heard County, Georgia",1052,185,931,181,121,67
1500000US131499703001,131499703001,"Block Group 1, Census Tract 9703, Heard County, Georgia",1151,214,833,213,318,111
1500000US131499703002,131499703002,"Block Group 2, Census Tract 9703, Heard County, Georgia",1768,270,1392,226,376,240
1500000US131510701041,131510701041,"Block Group 1, Census Tract 701.04, Henry County, Georgia",5921,775,4578,828,1343,547
1500000US131510701042,131510701042,"Block Group 2, Census Tract 701.04, Henry County, Georgia",2559,723,2155,659,404,435
1500000US131510701043,131510701043,"Block Group 3, Census Tract 701.04, Henry County, Georgia",3857,959,2273,540,1584,934
1500000US131510701061,131510701061,"Block Group 1, Census Tract 701.06, Henry County, Georgia",3445,543,2079,376,1366,532
1500000US131510701062,131510701062,"Block Group 2, Census Tract 701.06, Henry County, Georgia",3035,531,2226,472,809,329
1500000US131510701071,131510701071,"Block Group 1, Census Tract 701.07, Henry County, Georgia",2434,775,2011,710,423,332
1500000US131510701072,131510701072,"Block Group 2, Census Tract 701.07, Henry County, Georgia",2318,634,2017,610,301,293
1500000US131510701073,131510701073,"Block Group 3, Census Tract 701.07, Henry County, Georgia",2425,634,1916,522,509,377
1500000US131510701081,131510701081,"Block Group 1, Census Tract 701.08, Henry County, Georgia",3026,487,2787,403,239,244
1500000US131510701082,131510701082,"Block Group 2, Census Tract 701.08, Henry County, Georgia",2139,414,1342,410,797,384
1500000US131510701091,131510701091,"Block Group 1, Census Tract 701.09, Henry County, Georgia",2183,441,2065,439,118,140
1500000US131510701092,131510701092,"Block Group 2, Census Tract 701.09, Henry County, Georgia",1427,396,1077,402,350,185
1500000US131510701101,131510701101,"Block Group 1, Census Tract 701.10, Henry County, Georgia",1770,642,1164,422,606,578
1500000US131510701102,131510701102,"Block Group 2, Census Tract 701.10, Henry County, Georgia",3080,684,2937,679,143,192
1500000US131510701103,131510701103,"Block Group 3, Census Tract 701.10, Henry County, Georgia",2680,716,2436,746,244,184
1500000US131510701111,131510701111,"Block Group 1, Census Tract 701.11, Henry County, Georgia",3174,742,1313,513,1861,647
1500000US131510701112,131510701112,"Block Group 2, Census Tract 701.11, Henry County, Georgia",3363,742,2553,697,810,541
1500000US131510701113,131510701113,"Block Group 3, Census Tract 701.11, Henry County, Georgia",2416,677,1820,592,596,492
1500000US131510701131,131510701131,"Block Group 1, Census Tract 701.13, Henry County, Georgia",1721,468,1317,405,404,225
1500000US131510701132,131510701132,"Block Group 2, Census Tract 701.13, Henry County, Georgia",2112,354,1025,329,1087,328
1500000US131510701141,131510701141,"Block Group 1, Census Tract 701.14, Henry County, Georgia",2733,576,1383,422,1350,451
1500000US131510701142,131510701142,"Block Group 2, Census Tract 701.14, Henry County, Georgia",2514,619,342,319,2172,717
1500000US131510702021,131510702021,"Block Group 1, Census Tract 702.02, Henry County, Georgia",3235,540,3104,532,131,153
1500000US131510702022,131510702022,"Block Group 2, Census Tract 702.02, Henry County, Georgia",4274,596,3862,580,412,310
1500000US131510702023,131510702023,"Block Group 3, Census Tract 702.02, Henry County, Georgia",3269,492,3089,483,180,147
1500000US131510702031,131510702031,"Block Group 1, Census Tract 702.03, Henry County, Georgia",4820,947,4310,883,510,349
1500000US131510702032,131510702032,"Block Group 2, Census Tract 702.03, Henry County, Georgia",4964,972,3751,872,1213,753
1500000US131510702033,131510702033,"Block Group 3, Census Tract 702.03, Henry County, Georgia",4768,1098,4035,1092,733,555
1500000US131510702041,131510702041,"Block Group 1, Census Tract 702.04, Henry County, Georgia",2490,442,2208,474,282,198
1500000US131510702042,131510702042,"Block Group 2, Census Tract 702.04, Henry County, Georgia",2000,368,1778,366,222,201
1500000US131510702051,131510702051,"Block Group 1, Census Tract 702.05, Henry County, Georgia",2844,776,2297,673,547,560
1500000US131510702052,131510702052,"Block Group 2, Census Tract 702.05, Henry County, Georgia",3752,861,2223,614,1529,722
1500000US131510702053,131510702053,"Block Group 3, Census Tract 702.05, Henry County, Georgia",4452,874,2918,756,1534,713
1500000US131510703041,131510703041,"Block Group 1, Census Tract 703.04, Henry County, Georgia",2462,802,708,308,1754,736
1500000US131510703042,131510703042,"Block Group 2, Census Tract 703.04, Henry County, Georgia",3373,891,1692,654,1681,703
1500000US131510703043,131510703043,"Block Group 3, Census Tract 703.04, Henry County, Georgia",5216,910,2876,684,2340,892
1500000US131510703051,131510703051,"Block Group 1, Census Tract 703.05, Henry County, Georgia",4869,736,4463,748,406,278
1500000US131510703052,131510703052,"Block Group 2, Census Tract 703.05, Henry County, Georgia",2595,621,2387,587,208,228
1500000US131510703053,131510703053,"Block Group 3, Census Tract 703.05, Henry County, Georgia",1923,488,1704,450,219,242
1500000US131510703061,131510703061,"Block Group 1, Census Tract 703.06, Henry County, Georgia",9651,649,6053,931,3598,842
1500000US131510703071,131510703071,"Block Group 1, Census Tract 703.07, Henry County, Georgia",4432,578,3310,554,1122,497
1500000US131510703091,131510703091,"Block Group 1, Census Tract 703.09, Henry County, Georgia",3186,806,2256,706,930,665
1500000US131510703092,131510703092,"Block Group 2, Census Tract 703.09, Henry County, Georgia",4143,765,3701,790,442,304
1500000US131510703101,131510703101,"Block Group 1, Census Tract 703.10, Henry County, Georgia",1735,364,1509,370,226,131
1500000US131510703102,131510703102,"Block Group 2, Census Tract 703.10, Henry County, Georgia",1267,435,925,378,342,241
1500000US131510703103,131510703103,"Block Group 3, Census Tract 703.10, Henry County, Georgia",879,319,571,268,308,253
1500000US131510703111,131510703111,"Block Group 1, Census Tract 703.11, Henry County, Georgia",2918,1175,389,237,2529,1134
1500000US131510703112,131510703112,"Block Group 2, Census Tract 703.11, Henry County, Georgia",4261,1057,2164,984,2097,617
1500000US131510703113,131510703113,"Block Group 3, Census Tract 703.11, Henry County, Georgia",5213,982,2088,775,3125,862
1500000US131510704021,131510704021,"Block Group 1, Census Tract 704.02, Henry County, Georgia",4978,874,3823,842,1155,570
1500000US131510704022,131510704022,"Block Group 2, Census Tract 704.02, Henry County, Georgia",3877,888,3378,815,499,379
1500000US131510704023,131510704023,"Block Group 3, Census Tract 704.02, Henry County, Georgia",3111,526,2895,507,216,186
1500000US131510704031,131510704031,"Block Group 1, Census Tract 704.03, Henry County, Georgia",3825,977,3395,931,430,377
1500000US131510704032,131510704032,"Block Group 2, Census Tract 704.03, Henry County, Georgia",3634,735,2356,616,1278,691
1500000US131510704033,131510704033,"Block Group 3, Census Tract 704.03, Henry County, Georgia",3203,762,2845,757,358,268
1500000US131510704041,131510704041,"Block Group 1, Census Tract 704.04, Henry County, Georgia",3264,606,2453,475,811,502
1500000US131510704042,131510704042,"Block Group 2, Census Tract 704.04, Henry County, Georgia",2854,675,1586,487,1268,563
1500000US131510704043,131510704043,"Block Group 3, Census Tract 704.04, Henry County, Georgia",1078,519,818,399,260,364
1500000US131510705011,131510705011,"Block Group 1, Census Tract 705.01, Henry County, Georgia",5716,989,3759,852,1957,753
1500000US131510705012,131510705012,"Block Group 2, Census Tract 705.01, Henry County, Georgia",1653,658,705,413,948,593
1500000US131510705021,131510705021,"Block Group 1, Census Tract 705.02, Henry County, Georgia",4194,884,3384,939,810,625
1500000US131510705022,131510705022,"Block Group 2, Census Tract 705.02, Henry County, Georgia",8707,1311,7753,1404,954,629
1500000US131510705023,131510705023,"Block Group 3, Census Tract 705.02, Henry County, Georgia",1126,443,1106,447,20,34
1500000US131530201051,131530201051,"Block Group 1, Census Tract 201.05, Houston County, Georgia",2110,614,958,309,1152,645
1500000US131530201052,131530201052,"Block Group 2, Census Tract 201.05, Houston County, Georgia",2041,606,736,352,1305,546
1500000US131530201053,131530201053,"Block Group 3, Census Tract 201.05, Houston County, Georgia",1904,544,1525,504,379,284
1500000US131530201061,131530201061,"Block Group 1, Census Tract 201.06, Houston County, Georgia",3109,355,2408,342,701,256
1500000US131530201081,131530201081,"Block Group 1, Census Tract 201.08, Houston County, Georgia",1858,530,980,392,878,445
1500000US131530201082,131530201082,"Block Group 2, Census Tract 201.08, Houston County, Georgia",2307,577,1189,361,1118,564
1500000US131530201083,131530201083,"Block Group 3, Census Tract 201.08, Houston County, Georgia",1820,431,1211,430,609,365
1500000US131530201091,131530201091,"Block Group 1, Census Tract 201.09, Houston County, Georgia",5023,726,3109,532,1914,712
1500000US131530201092,131530201092,"Block Group 2, Census Tract 201.09, Houston County, Georgia",4068,739,2474,629,1594,746
1500000US131530202001,131530202001,"Block Group 1, Census Tract 202, Houston County, Georgia",1538,402,506,225,1032,414
1500000US131530202002,131530202002,"Block Group 2, Census Tract 202, Houston County, Georgia",840,268,538,266,302,199
1500000US131530202003,131530202003,"Block Group 3, Census Tract 202, Houston County, Georgia",1702,415,922,393,780,284
1500000US131530202004,131530202004,"Block Group 4, Census Tract 202, Houston County, Georgia",1194,414,743,335,451,329
1500000US131530203001,131530203001,"Block Group 1, Census Tract 203, Houston County, Georgia",390,163,20,32,370,166
1500000US131530203002,131530203002,"Block Group 2, Census Tract 203, Houston County, Georgia",1520,535,431,230,1089,488
1500000US131530203003,131530203003,"Block Group 3, Census Tract 203, Houston County, Georgia",1372,467,138,129,1234,470
1500000US131530203004,131530203004,"Block Group 4, Census Tract 203, Houston County, Georgia",2566,482,1058,404,1508,440
1500000US131530203005,131530203005,"Block Group 5, Census Tract 203, Houston County, Georgia",626,269,195,192,431,224
1500000US131530204001,131530204001,"Block Group 1, Census Tract 204, Houston County, Georgia",1075,250,506,155,569,268
1500000US131530204002,131530204002,"Block Group 2, Census Tract 204, Houston County, Georgia",2192,454,409,185,1783,480
1500000US131530206001,131530206001,"Block Group 1, Census Tract 206, Houston County, Georgia",830,118,0,13,830,118
1500000US131530206002,131530206002,"Block Group 2, Census Tract 206, Houston County, Georgia",238,67,4,4,234,68
1500000US131530207001,131530207001,"Block Group 1, Census Tract 207, Houston County, Georgia",1273,443,267,156,1006,421
1500000US131530207002,131530207002,"Block Group 2, Census Tract 207, Houston County, Georgia",1144,309,161,110,983,297
1500000US131530207003,131530207003,"Block Group 3, Census Tract 207, Houston County, Georgia",968,306,352,132,616,337
1500000US131530208001,131530208001,"Block Group 1, Census Tract 208, Houston County, Georgia",1364,288,0,13,1364,288
1500000US131530208002,131530208002,"Block Group 2, Census Tract 208, Houston County, Georgia",1048,247,395,149,653,239
1500000US131530209001,131530209001,"Block Group 1, Census Tract 209, Houston County, Georgia",995,250,805,233,190,163
1500000US131530209002,131530209002,"Block Group 2, Census Tract 209, Houston County, Georgia",1626,392,948,308,678,298
1500000US131530209003,131530209003,"Block Group 3, Census Tract 209, Houston County, Georgia",915,278,456,235,459,221
1500000US131530209004,131530209004,"Block Group 4, Census Tract 209, Houston County, Georgia",723,241,523,205,200,173
1500000US131530210001,131530210001,"Block Group 1, Census Tract 210, Houston County, Georgia",1525,643,1084,549,441,409
1500000US131530210002,131530210002,"Block Group 2, Census Tract 210, Houston County, Georgia",1655,480,830,419,825,339
1500000US131530210003,131530210003,"Block Group 3, Census Tract 210, Houston County, Georgia",1708,645,716,380,992,555
1500000US131530210004,131530210004,"Block Group 4, Census Tract 210, Houston County, Georgia",2157,745,1599,633,558,518
1500000US131530211031,131530211031,"Block Group 1, Census Tract 211.03, Houston County, Georgia",2713,423,2405,414,308,236
1500000US131530211032,131530211032,"Block Group 2, Census Tract 211.03, Houston County, Georgia",2735,617,1893,428,842,493
1500000US131530211033,131530211033,"Block Group 3, Census Tract 211.03, Houston County, Georgia",5061,691,4624,729,437,319
1500000US131530211034,131530211034,"Block Group 4, Census Tract 211.03, Houston County, Georgia",552,233,514,236,38,63
1500000US131530211041,131530211041,"Block Group 1, Census Tract 211.04, Houston County, Georgia",708,299,229,168,479,243
1500000US131530211042,131530211042,"Block Group 2, Census Tract 211.04, Houston County, Georgia",3301,572,1884,506,1417,397
1500000US131530211043,131530211043,"Block Group 3, Census Tract 211.04, Houston County, Georgia",1304,459,1124,402,180,244
1500000US131530211044,131530211044,"Block Group 4, Census Tract 211.04, Houston County, Georgia",1415,370,893,315,522,248
1500000US131530211045,131530211045,"Block Group 5, Census Tract 211.04, Houston County, Georgia",650,185,375,160,275,189
1500000US131530211051,131530211051,"Block Group 1, Census Tract 211.05, Houston County, Georgia",1252,443,128,134,1124,426
1500000US131530211052,131530211052,"Block Group 2, Census Tract 211.05, Houston County, Georgia",3048,658,1477,461,1571,654
1500000US131530211053,131530211053,"Block Group 3, Census Tract 211.05, Houston County, Georgia",1236,493,358,212,878,479
1500000US131530211054,131530211054,"Block Group 4, Census Tract 211.05, Houston County, Georgia",1225,391,555,334,670,409
1500000US131530211071,131530211071,"Block Group 1, Census Tract 211.07, Houston County, Georgia",1213,333,1032,342,181,177
1500000US131530211072,131530211072,"Block Group 2, Census Tract 211.07, Houston County, Georgia",3231,857,1782,499,1449,816
1500000US131530211073,131530211073,"Block Group 3, Census Tract 211.07, Houston County, Georgia",1619,382,1561,382,58,68
1500000US131530211074,131530211074,"Block Group 4, Census Tract 211.07, Houston County, Georgia",2623,436,2075,395,548,335
1500000US131530211081,131530211081,"Block Group 1, Census Tract 211.08, Houston County, Georgia",4507,584,3788,646,719,337
1500000US131530211082,131530211082,"Block Group 2, Census Tract 211.08, Houston County, Georgia",1682,555,1066,427,616,319
1500000US131530211131,131530211131,"Block Group 1, Census Tract 211.13, Houston County, Georgia",4957,1338,4841,1259,116,348
1500000US131530211132,131530211132,"Block Group 2, Census Tract 211.13, Houston County, Georgia",9813,1381,8515,1349,1298,525
1500000US131530211133,131530211133,"Block Group 3, Census Tract 211.13, Houston County, Georgia",2471,572,2471,572,0,13
1500000US131530212011,131530212011,"Block Group 1, Census Tract 212.01, Houston County, Georgia",7113,626,5434,668,1679,649
1500000US131530212012,131530212012,"Block Group 2, Census Tract 212.01, Houston County, Georgia",990,242,893,244,97,117
1500000US131530212021,131530212021,"Block Group 1, Census Tract 212.02, Houston County, Georgia",1387,478,652,400,735,352
1500000US131530212022,131530212022,"Block Group 2, Census Tract 212.02, Houston County, Georgia",1294,436,459,234,835,381
1500000US131530212023,131530212023,"Block Group 3, Census Tract 212.02, Houston County, Georgia",3041,708,2447,664,594,424
1500000US131530212024,131530212024,"Block Group 4, Census Tract 212.02, Houston County, Georgia",546,291,404,297,142,143
1500000US131530213001,131530213001,"Block Group 1, Census Tract 213, Houston County, Georgia",1372,356,980,301,392,225
1500000US131530213002,131530213002,"Block Group 2, Census Tract 213, Houston County, Georgia",494,263,209,134,285,226
1500000US131530213003,131530213003,"Block Group 3, Census Tract 213, Houston County, Georgia",1010,306,755,278,255,137
1500000US131530213004,131530213004,"Block Group 4, Census Tract 213, Houston County, Georgia",1498,450,702,341,796,452
1500000US131530214001,131530214001,"Block Group 1, Census Tract 214, Houston County, Georgia",1774,384,1565,326,209,247
1500000US131530214002,131530214002,"Block Group 2, Census Tract 214, Houston County, Georgia",964,418,624,230,340,395
1500000US131530214003,131530214003,"Block Group 3, Census Tract 214, Houston County, Georgia",1201,444,451,205,750,446
1500000US131530214004,131530214004,"Block Group 4, Census Tract 214, Houston County, Georgia",4378,826,3299,753,1079,519
1500000US131530215001,131530215001,"Block Group 1, Census Tract 215, Houston County, Georgia",1088,326,904,278,184,169
1500000US131530215002,131530215002,"Block Group 2, Census Tract 215, Houston County, Georgia",1773,399,1472,336,301,283
1500000US131530215003,131530215003,"Block Group 3, Census Tract 215, Houston County, Georgia",1337,331,1089,253,248,231
1500000US131559501001,131559501001,"Block Group 1, Census Tract 9501, Irwin County, Georgia",1308,261,1208,248,100,121
1500000US131559501002,131559501002,"Block Group 2, Census Tract 9501, Irwin County, Georgia",1114,248,803,212,311,156
1500000US131559502001,131559502001,"Block Group 1, Census Tract 9502, Irwin County, Georgia",721,241,405,186,316,171
1500000US131559502002,131559502002,"Block Group 2, Census Tract 9502, Irwin County, Georgia",1279,286,817,217,462,306
1500000US131559502003,131559502003,"Block Group 3, Census Tract 9502, Irwin County, Georgia",631,204,418,183,213,122
1500000US131559502004,131559502004,"Block Group 4, Census Tract 9502, Irwin County, Georgia",1324,317,1015,258,309,222
1500000US131559502005,131559502005,"Block Group 5, Census Tract 9502, Irwin County, Georgia",1734,375,1342,378,392,201
1500000US131559502006,131559502006,"Block Group 6, Census Tract 9502, Irwin County, Georgia",739,278,512,246,227,194
1500000US131570101011,131570101011,"Block Group 1, Census Tract 101.01, Jackson County, Georgia",2809,522,2617,536,192,164
1500000US131570101012,131570101012,"Block Group 2, Census Tract 101.01, Jackson County, Georgia",2652,503,1862,406,790,396
1500000US131570101021,131570101021,"Block Group 1, Census Tract 101.02, Jackson County, Georgia",2708,457,2258,464,450,156
1500000US131570101022,131570101022,"Block Group 2, Census Tract 101.02, Jackson County, Georgia",4241,826,3992,841,249,198
1500000US131570101031,131570101031,"Block Group 1, Census Tract 101.03, Jackson County, Georgia",3676,501,2921,492,755,398
1500000US131570101032,131570101032,"Block Group 2, Census Tract 101.03, Jackson County, Georgia",1756,349,1489,318,267,185
1500000US131570102001,131570102001,"Block Group 1, Census Tract 102, Jackson County, Georgia",2533,382,1669,328,864,340
1500000US131570102002,131570102002,"Block Group 2, Census Tract 102, Jackson County, Georgia",2433,284,2144,297,289,166
1500000US131570103001,131570103001,"Block Group 1, Census Tract 103, Jackson County, Georgia",941,267,554,182,387,200
1500000US131570103002,131570103002,"Block Group 2, Census Tract 103, Jackson County, Georgia",987,332,399,207,588,342
1500000US131570103003,131570103003,"Block Group 3, Census Tract 103, Jackson County, Georgia",2301,403,1323,364,978,318
1500000US131570104001,131570104001,"Block Group 1, Census Tract 104, Jackson County, Georgia",1340,291,667,249,673,245
1500000US131570104002,131570104002,"Block Group 2, Census Tract 104, Jackson County, Georgia",1199,243,768,220,431,210
1500000US131570104003,131570104003,"Block Group 3, Census Tract 104, Jackson County, Georgia",904,251,708,190,196,162
1500000US131570104004,131570104004,"Block Group 4, Census Tract 104, Jackson County, Georgia",1269,305,694,246,575,240
1500000US131570105001,131570105001,"Block Group 1, Census Tract 105, Jackson County, Georgia",624,292,495,310,129,129
1500000US131570105002,131570105002,"Block Group 2, Census Tract 105, Jackson County, Georgia",2037,337,1616,300,421,200
1500000US131570105003,131570105003,"Block Group 3, Census Tract 105, Jackson County, Georgia",2619,348,2316,338,303,184
1500000US131570106001,131570106001,"Block Group 1, Census Tract 106, Jackson County, Georgia",1804,447,1051,350,753,343
1500000US131570106002,131570106002,"Block Group 2, Census Tract 106, Jackson County, Georgia",1623,535,1134,365,489,493
1500000US131570106003,131570106003,"Block Group 3, Census Tract 106, Jackson County, Georgia",1737,410,1405,388,332,234
1500000US131570106004,131570106004,"Block Group 4, Census Tract 106, Jackson County, Georgia",1849,383,1541,366,308,167
1500000US131570106005,131570106005,"Block Group 5, Census Tract 106, Jackson County, Georgia",1620,414,1136,375,484,255
1500000US131570107011,131570107011,"Block Group 1, Census Tract 107.01, Jackson County, Georgia",1248,173,932,183,316,119
1500000US131570107012,131570107012,"Block Group 2, Census Tract 107.01, Jackson County, Georgia",705,255,561,232,144,139
1500000US131570107021,131570107021,"Block Group 1, Census Tract 107.02, Jackson County, Georgia",3021,641,2691,617,330,246
1500000US131570107022,131570107022,"Block Group 2, Census Tract 107.02, Jackson County, Georgia",3217,564,2052,499,1165,438
1500000US131570107023,131570107023,"Block Group 3, Census Tract 107.02, Jackson County, Georgia",3499,600,2905,645,594,411
1500000US131570107031,131570107031,"Block Group 1, Census Tract 107.03, Jackson County, Georgia",3342,430,3041,527,301,216
1500000US131590101001,131590101001,"Block Group 1, Census Tract 101, Jasper County, Georgia",2374,228,1880,253,494,162
1500000US131590102001,131590102001,"Block Group 1, Census Tract 102, Jasper County, Georgia",2722,277,2086,369,636,311
1500000US131590105001,131590105001,"Block Group 1, Census Tract 105, Jasper County, Georgia",1154,293,976,266,178,134
1500000US131590105002,131590105002,"Block Group 2, Census Tract 105, Jasper County, Georgia",869,231,577,227,292,158
1500000US131590105003,131590105003,"Block Group 3, Census Tract 105, Jasper County, Georgia",3311,453,2576,519,735,385
1500000US131590105004,131590105004,"Block Group 4, Census Tract 105, Jasper County, Georgia",1699,329,781,281,918,347
1500000US131590105005,131590105005,"Block Group 5, Census Tract 105, Jasper County, Georgia",1364,379,906,343,458,237
1500000US131619601001,131619601001,"Block Group 1, Census Tract 9601, Jeff Davis County, Georgia",1746,383,1659,387,87,101
1500000US131619601002,131619601002,"Block Group 2, Census Tract 9601, Jeff Davis County, Georgia",959,368,860,364,99,137
1500000US131619601003,131619601003,"Block Group 3, Census Tract 9601, Jeff Davis County, Georgia",1147,444,841,367,306,301
1500000US131619601004,131619601004,"Block Group 4, Census Tract 9601, Jeff Davis County, Georgia",1181,459,627,323,554,342
1500000US131619601005,131619601005,"Block Group 5, Census Tract 9601, Jeff Davis County, Georgia",1478,494,968,424,510,385
1500000US131619602001,131619602001,"Block Group 1, Census Tract 9602, Jeff Davis County, Georgia",1399,456,1227,440,172,139
1500000US131619602002,131619602002,"Block Group 2, Census Tract 9602, Jeff Davis County, Georgia",2311,474,1684,461,627,260
1500000US131619602003,131619602003,"Block Group 3, Census Tract 9602, Jeff Davis County, Georgia",881,379,748,385,133,121
1500000US131619602004,131619602004,"Block Group 4, Census Tract 9602, Jeff Davis County, Georgia",1919,455,934,301,985,421
1500000US131619603001,131619603001,"Block Group 1, Census Tract 9603, Jeff Davis County, Georgia",1014,272,761,221,253,193
1500000US131619603002,131619603002,"Block Group 2, Census Tract 9603, Jeff Davis County, Georgia",831,178,650,160,181,121
1500000US131639601001,131639601001,"Block Group 1, Census Tract 9601, Jefferson County, Georgia",1193,274,823,233,370,211
1500000US131639601002,131639601002,"Block Group 2, Census Tract 9601, Jefferson County, Georgia",511,174,447,167,64,83
1500000US131639601003,131639601003,"Block Group 3, Census Tract 9601, Jefferson County, Georgia",780,247,360,117,420,208
1500000US131639601004,131639601004,"Block Group 4, Census Tract 9601, Jefferson County, Georgia",1154,333,909,351,245,171
1500000US131639601005,131639601005,"Block Group 5, Census Tract 9601, Jefferson County, Georgia",1200,356,307,161,893,330
1500000US131639602001,131639602001,"Block Group 1, Census Tract 9602, Jefferson County, Georgia",1192,282,1092,283,100,45
1500000US131639602002,131639602002,"Block Group 2, Census Tract 9602, Jefferson County, Georgia",991,221,766,167,225,146
1500000US131639603001,131639603001,"Block Group 1, Census Tract 9603, Jefferson County, Georgia",763,266,518,262,245,154
1500000US131639603002,131639603002,"Block Group 2, Census Tract 9603, Jefferson County, Georgia",466,167,222,92,244,161
1500000US131639603003,131639603003,"Block Group 3, Census Tract 9603, Jefferson County, Georgia",1049,350,724,294,325,273
1500000US131639603004,131639603004,"Block Group 4, Census Tract 9603, Jefferson County, Georgia",1345,426,732,327,613,377
1500000US131639603005,131639603005,"Block Group 5, Census Tract 9603, Jefferson County, Georgia",1075,338,608,363,467,266
1500000US131639603006,131639603006,"Block Group 6, Census Tract 9603, Jefferson County, Georgia",574,229,351,133,223,215
1500000US131639604001,131639604001,"Block Group 1, Census Tract 9604, Jefferson County, Georgia",1165,261,749,206,416,248
1500000US131639604002,131639604002,"Block Group 2, Census Tract 9604, Jefferson County, Georgia",822,233,463,155,359,152
1500000US131639604003,131639604003,"Block Group 3, Census Tract 9604, Jefferson County, Georgia",812,254,362,164,450,186
1500000US131639604004,131639604004,"Block Group 4, Census Tract 9604, Jefferson County, Georgia",699,190,592,182,107,59
1500000US131659601001,131659601001,"Block Group 1, Census Tract 9601, Jenkins County, Georgia",2029,527,1466,482,563,376
1500000US131659601002,131659601002,"Block Group 2, Census Tract 9601, Jenkins County, Georgia",1319,422,868,436,451,339
1500000US131659601003,131659601003,"Block Group 3, Census Tract 9601, Jenkins County, Georgia",728,340,474,324,254,216
1500000US131659601004,131659601004,"Block Group 4, Census Tract 9601, Jenkins County, Georgia",449,144,338,126,111,92
1500000US131659601005,131659601005,"Block Group 5, Census Tract 9601, Jenkins County, Georgia",824,355,551,369,273,185
1500000US131659601006,131659601006,"Block Group 6, Census Tract 9601, Jenkins County, Georgia",641,365,187,165,454,338
1500000US131659602001,131659602001,"Block Group 1, Census Tract 9602, Jenkins County, Georgia",1298,255,784,232,514,200
1500000US131659602002,131659602002,"Block Group 2, Census Tract 9602, Jenkins County, Georgia",1552,375,1187,312,365,233
1500000US131679601001,131679601001,"Block Group 1, Census Tract 9601, Johnson County, Georgia",1260,267,1047,259,213,91
1500000US131679601002,131679601002,"Block Group 2, Census Tract 9601, Johnson County, Georgia",1381,218,1106,233,275,103
1500000US131679602001,131679602001,"Block Group 1, Census Tract 9602, Johnson County, Georgia",525,172,473,167,52,64
1500000US131679602002,131679602002,"Block Group 2, Census Tract 9602, Johnson County, Georgia",1091,336,578,241,513,277
1500000US131679602003,131679602003,"Block Group 3, Census Tract 9602, Johnson County, Georgia",1732,325,837,274,895,255
1500000US131679602004,131679602004,"Block Group 4, Census Tract 9602, Johnson County, Georgia",1473,311,972,283,501,213
1500000US131679603001,131679603001,"Block Group 1, Census Tract 9603, Johnson County, Georgia",962,205,935,211,27,36
1500000US131679603002,131679603002,"Block Group 2, Census Tract 9603, Johnson County, Georgia",811,231,809,229,2,6
1500000US131690301011,131690301011,"Block Group 1, Census Tract 301.01, Jones County, Georgia",2598,317,2372,331,226,129
1500000US131690301031,131690301031,"Block Group 1, Census Tract 301.03, Jones County, Georgia",2474,308,2108,366,366,204
1500000US131690301041,131690301041,"Block Group 1, Census Tract 301.04, Jones County, Georgia",4738,682,3438,640,1300,543
1500000US131690301042,131690301042,"Block Group 2, Census Tract 301.04, Jones County, Georgia",2716,588,2276,591,440,205
1500000US131690302001,131690302001,"Block Group 1, Census Tract 302, Jones County, Georgia",2059,469,1470,336,589,433
1500000US131690302002,131690302002,"Block Group 2, Census Tract 302, Jones County, Georgia",1414,261,1250,279,164,116
1500000US131690303011,131690303011,"Block Group 1, Census Tract 303.01, Jones County, Georgia",1991,287,1086,264,905,272
1500000US131690303012,131690303012,"Block Group 2, Census Tract 303.01, Jones County, Georgia",4697,458,4126,481,571,215
1500000US131690303021,131690303021,"Block Group 1, Census Tract 303.02, Jones County, Georgia",938,320,753,284,185,144
1500000US131690303022,131690303022,"Block Group 2, Census Tract 303.02, Jones County, Georgia",2277,390,1816,370,461,285
1500000US131690303023,131690303023,"Block Group 3, Census Tract 303.02, Jones County, Georgia",2586,363,2402,406,184,168
1500000US131719701001,131719701001,"Block Group 1, Census Tract 9701, Lamar County, Georgia",2540,450,2220,456,320,206
1500000US131719701002,131719701002,"Block Group 2, Census Tract 9701, Lamar County, Georgia",2789,581,2029,424,760,452
1500000US131719701003,131719701003,"Block Group 3, Census Tract 9701, Lamar County, Georgia",1819,363,1741,360,78,66
1500000US131719702001,131719702001,"Block Group 1, Census Tract 9702, Lamar County, Georgia",2356,363,1717,372,639,277
1500000US131719702002,131719702002,"Block Group 2, Census Tract 9702, Lamar County, Georgia",646,298,286,144,360,311
1500000US131719702003,131719702003,"Block Group 3, Census Tract 9702, Lamar County, Georgia",1324,299,882,285,442,198
1500000US131719702004,131719702004,"Block Group 4, Census Tract 9702, Lamar County, Georgia",617,253,377,151,240,228
1500000US131719702005,131719702005,"Block Group 5, Census Tract 9702, Lamar County, Georgia",701,236,413,194,288,192
1500000US131719703001,131719703001,"Block Group 1, Census Tract 9703, Lamar County, Georgia",1214,348,379,132,835,335
1500000US131719703002,131719703002,"Block Group 2, Census Tract 9703, Lamar County, Georgia",961,268,745,238,216,133
1500000US131719703003,131719703003,"Block Group 3, Census Tract 9703, Lamar County, Georgia",854,283,351,226,503,205
1500000US131719703004,131719703004,"Block Group 4, Census Tract 9703, Lamar County, Georgia",1002,344,460,184,542,320
1500000US131739501001,131739501001,"Block Group 1, Census Tract 9501, Lanier County, Georgia",712,213,489,131,223,164
1500000US131739501002,131739501002,"Block Group 2, Census Tract 9501, Lanier County, Georgia",1254,264,1087,282,167,128
1500000US131739502001,131739502001,"Block Group 1, Census Tract 9502, Lanier County, Georgia",1279,360,643,199,636,329
1500000US131739502002,131739502002,"Block Group 2, Census Tract 9502, Lanier County, Georgia",1548,340,790,314,758,305
1500000US131739502003,131739502003,"Block Group 3, Census Tract 9502, Lanier County, Georgia",1137,318,366,232,771,379
1500000US131739502004,131739502004,"Block Group 4, Census Tract 9502, Lanier County, Georgia",3063,444,2364,465,699,398
1500000US131739502005,131739502005,"Block Group 5, Census Tract 9502, Lanier County, Georgia",1113,397,674,326,439,299
1500000US131759501001,131759501001,"Block Group 1, Census Tract 9501, Laurens County, Georgia",1847,317,1249,225,598,324
1500000US131759501002,131759501002,"Block Group 2, Census Tract 9501, Laurens County, Georgia",1317,309,1102,309,215,173
1500000US131759502011,131759502011,"Block Group 1, Census Tract 9502.01, Laurens County, Georgia",1921,357,1521,356,400,189
1500000US131759502012,131759502012,"Block Group 2, Census Tract 9502.01, Laurens County, Georgia",2750,354,1803,335,947,238
1500000US131759502021,131759502021,"Block Group 1, Census Tract 9502.02, Laurens County, Georgia",2023,320,1444,308,579,260
1500000US131759502022,131759502022,"Block Group 2, Census Tract 9502.02, Laurens County, Georgia",2321,355,1884,318,437,294
1500000US131759503001,131759503001,"Block Group 1, Census Tract 9503, Laurens County, Georgia",1138,270,359,116,779,259
1500000US131759503002,131759503002,"Block Group 2, Census Tract 9503, Laurens County, Georgia",551,170,232,88,319,148
1500000US131759504001,131759504001,"Block Group 1, Census Tract 9504, Laurens County, Georgia",816,238,346,140,470,183
1500000US131759504002,131759504002,"Block Group 2, Census Tract 9504, Laurens County, Georgia",1232,361,704,190,528,316
1500000US131759504003,131759504003,"Block Group 3, Census Tract 9504, Laurens County, Georgia",1355,342,83,66,1272,339
1500000US131759504004,131759504004,"Block Group 4, Census Tract 9504, Laurens County, Georgia",377,179,203,125,174,138
1500000US131759505001,131759505001,"Block Group 1, Census Tract 9505, Laurens County, Georgia",701,239,404,191,297,186
1500000US131759505002,131759505002,"Block Group 2, Census Tract 9505, Laurens County, Georgia",721,186,514,171,207,129
1500000US131759505003,131759505003,"Block Group 3, Census Tract 9505, Laurens County, Georgia",2225,464,1270,352,955,430
1500000US131759506001,131759506001,"Block Group 1, Census Tract 9506, Laurens County, Georgia",2129,227,1489,182,640,201
1500000US131759507001,131759507001,"Block Group 1, Census Tract 9507, Laurens County, Georgia",1737,282,1266,239,471,187
1500000US131759507002,131759507002,"Block Group 2, Census Tract 9507, Laurens County, Georgia",766,164,646,162,120,64
1500000US131759508001,131759508001,"Block Group 1, Census Tract 9508, Laurens County, Georgia",1077,249,595,275,482,253
1500000US131759508002,131759508002,"Block Group 2, Census Tract 9508, Laurens County, Georgia",654,230,269,137,385,201
1500000US131759508003,131759508003,"Block Group 3, Census Tract 9508, Laurens County, Georgia",1025,240,659,198,366,163
1500000US131759508004,131759508004,"Block Group 4, Census Tract 9508, Laurens County, Georgia",913,240,738,244,175,124
1500000US131759509001,131759509001,"Block Group 1, Census Tract 9509, Laurens County, Georgia",930,287,79,57,851,283
1500000US131759509002,131759509002,"Block Group 2, Census Tract 9509, Laurens County, Georgia",999,325,323,262,676,287
1500000US131759509003,131759509003,"Block Group 3, Census Tract 9509, Laurens County, Georgia",721,242,280,121,441,228
1500000US131759510001,131759510001,"Block Group 1, Census Tract 9510, Laurens County, Georgia",1188,425,1117,423,71,78
1500000US131759510002,131759510002,"Block Group 2, Census Tract 9510, Laurens County, Georgia",375,204,243,141,132,145
1500000US131759510003,131759510003,"Block Group 3, Census Tract 9510, Laurens County, Georgia",2250,580,1188,426,1062,550
1500000US131759510004,131759510004,"Block Group 4, Census Tract 9510, Laurens County, Georgia",882,286,314,127,568,249
1500000US131759510005,131759510005,"Block Group 5, Census Tract 9510, Laurens County, Georgia",954,304,545,300,409,194
1500000US131759510006,131759510006,"Block Group 6, Census Tract 9510, Laurens County, Georgia",1871,329,1026,270,845,275
1500000US131759511001,131759511001,"Block Group 1, Census Tract 9511, Laurens County, Georgia",3275,483,2474,446,801,307
1500000US131759511002,131759511002,"Block Group 2, Census Tract 9511, Laurens County, Georgia",1313,285,1058,260,255,122
1500000US131759514001,131759514001,"Block Group 1, Census Tract 9514, Laurens County, Georgia",983,279,878,240,105,147
1500000US131759514002,131759514002,"Block Group 2, Census Tract 9514, Laurens County, Georgia",769,174,554,172,215,116
1500000US131759514003,131759514003,"Block Group 3, Census Tract 9514, Laurens County, Georgia",634,164,488,147,146,98
1500000US131770201001,131770201001,"Block Group 1, Census Tract 201, Lee County, Georgia",1533,331,1377,360,156,99
1500000US131770201002,131770201002,"Block Group 2, Census Tract 201, Lee County, Georgia",2017,483,1451,412,566,322
1500000US131770201003,131770201003,"Block Group 3, Census Tract 201, Lee County, Georgia",2866,443,2466,454,400,309
1500000US131770202001,131770202001,"Block Group 1, Census Tract 202, Lee County, Georgia",1455,216,1076,178,379,187
1500000US131770203001,131770203001,"Block Group 1, Census Tract 203, Lee County, Georgia",3462,495,2108,517,1354,293
1500000US131770203002,131770203002,"Block Group 2, Census Tract 203, Lee County, Georgia",1659,359,1255,327,404,252
1500000US131770203003,131770203003,"Block Group 3, Census Tract 203, Lee County, Georgia",535,244,454,210,81,117
1500000US131770204021,131770204021,"Block Group 1, Census Tract 204.02, Lee County, Georgia",2483,583,1041,368,1442,489
1500000US131770204022,131770204022,"Block Group 2, Census Tract 204.02, Lee County, Georgia",3401,658,1648,420,1753,619
1500000US131770204023,131770204023,"Block Group 3, Census Tract 204.02, Lee County, Georgia",928,336,309,178,619,316
1500000US131770204024,131770204024,"Block Group 4, Census Tract 204.02, Lee County, Georgia",1400,285,1379,285,21,37
1500000US131770204031,131770204031,"Block Group 1, Census Tract 204.03, Lee County, Georgia",5050,566,4039,568,1011,609
1500000US131770204032,131770204032,"Block Group 2, Census Tract 204.03, Lee County, Georgia",871,342,871,342,0,13
1500000US131790101011,131790101011,"Block Group 1, Census Tract 101.01, Liberty County, Georgia",5182,450,17,27,5165,454
1500000US131790101012,131790101012,"Block Group 2, Census Tract 101.01, Liberty County, Georgia",1267,319,0,13,1267,319
1500000US131790101021,131790101021,"Block Group 1, Census Tract 101.02, Liberty County, Georgia",77,121,0,13,77,121
1500000US131790101022,131790101022,"Block Group 2, Census Tract 101.02, Liberty County, Georgia",681,253,0,13,681,253
1500000US131790101031,131790101031,"Block Group 1, Census Tract 101.03, Liberty County, Georgia",225,155,0,13,225,155
1500000US131790101032,131790101032,"Block Group 2, Census Tract 101.03, Liberty County, Georgia",1065,245,16,18,1049,248
1500000US131790102021,131790102021,"Block Group 1, Census Tract 102.02, Liberty County, Georgia",2749,483,1140,259,1609,459
1500000US131790102022,131790102022,"Block Group 2, Census Tract 102.02, Liberty County, Georgia",1456,355,663,202,793,304
1500000US131790102041,131790102041,"Block Group 1, Census Tract 102.04, Liberty County, Georgia",539,287,175,93,364,281
1500000US131790102042,131790102042,"Block Group 2, Census Tract 102.04, Liberty County, Georgia",2302,354,953,351,1349,327
1500000US131790102051,131790102051,"Block Group 1, Census Tract 102.05, Liberty County, Georgia",3606,530,1059,313,2547,564
1500000US131790102052,131790102052,"Block Group 2, Census Tract 102.05, Liberty County, Georgia",2270,387,1608,344,662,300
1500000US131790102061,131790102061,"Block Group 1, Census Tract 102.06, Liberty County, Georgia",1059,368,767,289,292,247
1500000US131790102062,131790102062,"Block Group 2, Census Tract 102.06, Liberty County, Georgia",4075,469,1697,364,2378,497
1500000US131790102071,131790102071,"Block Group 1, Census Tract 102.07, Liberty County, Georgia",2677,405,1492,446,1185,322
1500000US131790102072,131790102072,"Block Group 2, Census Tract 102.07, Liberty County, Georgia",2758,409,982,263,1776,380
1500000US131790102081,131790102081,"Block Group 1, Census Tract 102.08, Liberty County, Georgia",2288,571,1682,550,606,336
1500000US131790102082,131790102082,"Block Group 2, Census Tract 102.08, Liberty County, Georgia",3591,546,1929,448,1662,552
1500000US131790103001,131790103001,"Block Group 1, Census Tract 103, Liberty County, Georgia",866,312,718,334,148,140
1500000US131790103002,131790103002,"Block Group 2, Census Tract 103, Liberty County, Georgia",2629,497,1025,359,1604,405
1500000US131790103003,131790103003,"Block Group 3, Census Tract 103, Liberty County, Georgia",1215,330,177,159,1038,334
1500000US131790103004,131790103004,"Block Group 4, Census Tract 103, Liberty County, Georgia",2185,461,1051,289,1134,382
1500000US131790104001,131790104001,"Block Group 1, Census Tract 104, Liberty County, Georgia",2306,443,1583,308,723,305
1500000US131790104002,131790104002,"Block Group 2, Census Tract 104, Liberty County, Georgia",1829,520,534,242,1295,498
1500000US131790104003,131790104003,"Block Group 3, Census Tract 104, Liberty County, Georgia",3032,488,1675,393,1357,455
1500000US131790105011,131790105011,"Block Group 1, Census Tract 105.01, Liberty County, Georgia",915,229,712,165,203,173
1500000US131790105012,131790105012,"Block Group 2, Census Tract 105.01, Liberty County, Georgia",2569,308,1944,275,625,281
1500000US131790105021,131790105021,"Block Group 1, Census Tract 105.02, Liberty County, Georgia",2731,404,1815,321,916,319
1500000US131790105022,131790105022,"Block Group 2, Census Tract 105.02, Liberty County, Georgia",2384,385,1727,360,657,240
1500000US131790106001,131790106001,"Block Group 1, Census Tract 106, Liberty County, Georgia",1066,273,663,178,403,239
1500000US131790106002,131790106002,"Block Group 2, Census Tract 106, Liberty County, Georgia",836,170,647,152,189,116
1500000US131799900000,131799900000,"Block Group 0, Census Tract 9900, Liberty County, Georgia",0,13,0,13,0,13
1500000US131819701001,131819701001,"Block Group 1, Census Tract 9701, Lincoln County, Georgia",1344,241,1100,217,244,112
1500000US131819701002,131819701002,"Block Group 2, Census Tract 9701, Lincoln County, Georgia",562,187,483,173,79,78
1500000US131819701003,131819701003,"Block Group 3, Census Tract 9701, Lincoln County, Georgia",1133,233,712,177,421,132
1500000US131819701004,131819701004,"Block Group 4, Census Tract 9701, Lincoln County, Georgia",620,182,399,125,221,152
1500000US131819702001,131819702001,"Block Group 1, Census Tract 9702, Lincoln County, Georgia",1301,222,1043,182,258,141
1500000US131819702002,131819702002,"Block Group 2, Census Tract 9702, Lincoln County, Georgia",700,243,600,217,100,95
1500000US131819702003,131819702003,"Block Group 3, Census Tract 9702, Lincoln County, Georgia",1968,271,1511,275,457,192
1500000US131839701001,131839701001,"Block Group 1, Census Tract 9701, Long County, Georgia",1957,602,1483,644,474,233
1500000US131839701002,131839701002,"Block Group 2, Census Tract 9701, Long County, Georgia",4330,732,2867,748,1463,494
1500000US131839701003,131839701003,"Block Group 3, Census Tract 9701, Long County, Georgia",3260,581,2071,537,1189,365
1500000US131839702001,131839702001,"Block Group 1, Census Tract 9702, Long County, Georgia",904,334,423,227,481,229
1500000US131839702002,131839702002,"Block Group 2, Census Tract 9702, Long County, Georgia",1659,490,1040,435,619,205
1500000US131839702003,131839702003,"Block Group 3, Census Tract 9702, Long County, Georgia",4278,726,3085,720,1193,466
1500000US131839800001,131839800001,"Block Group 1, Census Tract 9800, Long County, Georgia",0,13,0,13,0,13
1500000US131850101011,131850101011,"Block Group 1, Census Tract 101.01, Lowndes County, Georgia",1094,215,874,209,220,135
1500000US131850101012,131850101012,"Block Group 2, Census Tract 101.01, Lowndes County, Georgia",2938,461,1097,341,1841,389
1500000US131850101021,131850101021,"Block Group 1, Census Tract 101.02, Lowndes County, Georgia",1574,386,1008,306,566,311
1500000US131850101022,131850101022,"Block Group 2, Census Tract 101.02, Lowndes County, Georgia",1671,326,1268,263,403,207
1500000US131850101023,131850101023,"Block Group 3, Census Tract 101.02, Lowndes County, Georgia",1183,319,570,223,613,288
1500000US131850101024,131850101024,"Block Group 4, Census Tract 101.02, Lowndes County, Georgia",675,290,137,93,538,281
1500000US131850101031,131850101031,"Block Group 1, Census Tract 101.03, Lowndes County, Georgia",2158,361,1720,374,438,226
1500000US131850101032,131850101032,"Block Group 2, Census Tract 101.03, Lowndes County, Georgia",1264,305,823,209,441,277
1500000US131850102011,131850102011,"Block Group 1, Census Tract 102.01, Lowndes County, Georgia",1159,192,1014,188,145,89
1500000US131850102012,131850102012,"Block Group 2, Census Tract 102.01, Lowndes County, Georgia",1197,209,846,185,351,192
1500000US131850102021,131850102021,"Block Group 1, Census Tract 102.02, Lowndes County, Georgia",1362,280,932,303,430,176
1500000US131850102022,131850102022,"Block Group 2, Census Tract 102.02, Lowndes County, Georgia",1961,250,1320,272,641,210
1500000US131850102023,131850102023,"Block Group 3, Census Tract 102.02, Lowndes County, Georgia",1927,522,1684,515,243,190
1500000US131850102024,131850102024,"Block Group 4, Census Tract 102.02, Lowndes County, Georgia",2237,590,1720,472,517,480
1500000US131850102025,131850102025,"Block Group 5, Census Tract 102.02, Lowndes County, Georgia",3188,614,2866,583,322,289
1500000US131850102026,131850102026,"Block Group 6, Census Tract 102.02, Lowndes County, Georgia",863,331,692,350,171,201
1500000US131850103011,131850103011,"Block Group 1, Census Tract 103.01, Lowndes County, Georgia",1022,259,196,127,826,239
1500000US131850103012,131850103012,"Block Group 2, Census Tract 103.01, Lowndes County, Georgia",2446,362,2305,351,141,111
1500000US131850103013,131850103013,"Block Group 3, Census Tract 103.01, Lowndes County, Georgia",1730,422,631,386,1099,400
1500000US131850103021,131850103021,"Block Group 1, Census Tract 103.02, Lowndes County, Georgia",1372,256,853,231,519,166
1500000US131850103022,131850103022,"Block Group 2, Census Tract 103.02, Lowndes County, Georgia",1247,248,1215,250,32,37
1500000US131850104011,131850104011,"Block Group 1, Census Tract 104.01, Lowndes County, Georgia",1001,161,542,157,459,128
1500000US131850104012,131850104012,"Block Group 2, Census Tract 104.01, Lowndes County, Georgia",551,116,285,115,266,131
1500000US131850104021,131850104021,"Block Group 1, Census Tract 104.02, Lowndes County, Georgia",825,338,221,174,604,277
1500000US131850104022,131850104022,"Block Group 2, Census Tract 104.02, Lowndes County, Georgia",3077,690,1257,500,1820,646
1500000US131850104023,131850104023,"Block Group 3, Census Tract 104.02, Lowndes County, Georgia",3136,884,1128,675,2008,731
1500000US131850105001,131850105001,"Block Group 1, Census Tract 105, Lowndes County, Georgia",1309,433,377,233,932,415
1500000US131850105002,131850105002,"Block Group 2, Census Tract 105, Lowndes County, Georgia",1587,404,528,211,1059,417
1500000US131850105003,131850105003,"Block Group 3, Census Tract 105, Lowndes County, Georgia",1894,435,218,120,1676,431
1500000US131850106011,131850106011,"Block Group 1, Census Tract 106.01, Lowndes County, Georgia",2843,611,368,271,2475,658
1500000US131850106012,131850106012,"Block Group 2, Census Tract 106.01, Lowndes County, Georgia",1161,363,489,278,672,342
1500000US131850106013,131850106013,"Block Group 3, Census Tract 106.01, Lowndes County, Georgia",1793,463,431,194,1362,429
1500000US131850106041,131850106041,"Block Group 1, Census Tract 106.04, Lowndes County, Georgia",485,180,186,79,299,182
1500000US131850106042,131850106042,"Block Group 2, Census Tract 106.04, Lowndes County, Georgia",2818,460,1699,452,1119,396
1500000US131850106043,131850106043,"Block Group 3, Census Tract 106.04, Lowndes County, Georgia",1886,395,1216,328,670,282
1500000US131850107001,131850107001,"Block Group 1, Census Tract 107, Lowndes County, Georgia",720,247,597,256,123,133
1500000US131850107002,131850107002,"Block Group 2, Census Tract 107, Lowndes County, Georgia",1068,480,1065,472,3,43
1500000US131850107003,131850107003,"Block Group 3, Census Tract 107, Lowndes County, Georgia",2076,372,1741,412,335,258
1500000US131850108001,131850108001,"Block Group 1, Census Tract 108, Lowndes County, Georgia",2563,676,907,324,1656,576
1500000US131850108002,131850108002,"Block Group 2, Census Tract 108, Lowndes County, Georgia",2109,639,535,345,1574,597
1500000US131850108003,131850108003,"Block Group 3, Census Tract 108, Lowndes County, Georgia",886,291,451,291,435,314
1500000US131850109001,131850109001,"Block Group 1, Census Tract 109, Lowndes County, Georgia",730,166,241,120,489,148
1500000US131850109002,131850109002,"Block Group 2, Census Tract 109, Lowndes County, Georgia",986,241,274,142,712,233
1500000US131850110001,131850110001,"Block Group 1, Census Tract 110, Lowndes County, Georgia",2132,458,452,261,1680,396
1500000US131850110002,131850110002,"Block Group 2, Census Tract 110, Lowndes County, Georgia",1280,374,488,266,792,334
1500000US131850111001,131850111001,"Block Group 1, Census Tract 111, Lowndes County, Georgia",879,164,479,124,400,132
1500000US131850111002,131850111002,"Block Group 2, Census Tract 111, Lowndes County, Georgia",1236,255,374,147,862,230
1500000US131850112001,131850112001,"Block Group 1, Census Tract 112, Lowndes County, Georgia",745,218,639,214,106,93
1500000US131850112002,131850112002,"Block Group 2, Census Tract 112, Lowndes County, Georgia",1556,467,481,178,1075,444
1500000US131850112003,131850112003,"Block Group 3, Census Tract 112, Lowndes County, Georgia",1242,325,577,223,665,362
1500000US131850112004,131850112004,"Block Group 4, Census Tract 112, Lowndes County, Georgia",1591,484,335,120,1256,481
1500000US131850113011,131850113011,"Block Group 1, Census Tract 113.01, Lowndes County, Georgia",2074,528,232,98,1842,531
1500000US131850113012,131850113012,"Block Group 2, Census Tract 113.01, Lowndes County, Georgia",1393,275,31,32,1362,277
1500000US131850113013,131850113013,"Block Group 3, Census Tract 113.01, Lowndes County, Georgia",1825,416,161,105,1664,413
1500000US131850113021,131850113021,"Block Group 1, Census Tract 113.02, Lowndes County, Georgia",1340,326,215,102,1125,320
1500000US131850113022,131850113022,"Block Group 2, Census Tract 113.02, Lowndes County, Georgia",1260,268,646,245,614,236
1500000US131850114011,131850114011,"Block Group 1, Census Tract 114.01, Lowndes County, Georgia",1723,184,1359,206,364,148
1500000US131850114012,131850114012,"Block Group 2, Census Tract 114.01, Lowndes County, Georgia",692,187,264,142,428,154
1500000US131850114021,131850114021,"Block Group 1, Census Tract 114.02, Lowndes County, Georgia",953,219,518,139,435,202
1500000US131850114022,131850114022,"Block Group 2, Census Tract 114.02, Lowndes County, Georgia",874,197,619,179,255,112
1500000US131850114031,131850114031,"Block Group 1, Census Tract 114.03, Lowndes County, Georgia",2392,748,1506,632,886,546
1500000US131850114032,131850114032,"Block Group 2, Census Tract 114.03, Lowndes County, Georgia",2201,498,1434,500,767,307
1500000US131850114033,131850114033,"Block Group 3, Census Tract 114.03, Lowndes County, Georgia",2150,744,1501,559,649,389
1500000US131850114034,131850114034,"Block Group 4, Census Tract 114.03, Lowndes County, Georgia",1724,548,1103,511,621,321
1500000US131850115001,131850115001,"Block Group 1, Census Tract 115, Lowndes County, Georgia",1200,343,956,326,244,170
1500000US131850115002,131850115002,"Block Group 2, Census Tract 115, Lowndes County, Georgia",2086,427,1406,345,680,324
1500000US131850115003,131850115003,"Block Group 3, Census Tract 115, Lowndes County, Georgia",833,228,756,236,77,48
1500000US131850116001,131850116001,"Block Group 1, Census Tract 116, Lowndes County, Georgia",2493,403,1338,255,1155,419
1500000US131850116002,131850116002,"Block Group 2, Census Tract 116, Lowndes County, Georgia",1685,224,1263,216,422,143
1500000US131879601011,131879601011,"Block Group 1, Census Tract 9601.01, Lumpkin County, Georgia",4636,686,3046,605,1590,604
1500000US131879601012,131879601012,"Block Group 2, Census Tract 9601.01, Lumpkin County, Georgia",2520,627,1495,461,1025,490
1500000US131879601021,131879601021,"Block Group 1, Census Tract 9601.02, Lumpkin County, Georgia",780,413,686,393,94,129
1500000US131879601022,131879601022,"Block Group 2, Census Tract 9601.02, Lumpkin County, Georgia",2766,667,2099,638,667,331
1500000US131879601023,131879601023,"Block Group 3, Census Tract 9601.02, Lumpkin County, Georgia",2166,607,1556,468,610,431
1500000US131879602011,131879602011,"Block Group 1, Census Tract 9602.01, Lumpkin County, Georgia",5211,764,4177,785,1034,541
1500000US131879602012,131879602012,"Block Group 2, Census Tract 9602.01, Lumpkin County, Georgia",2569,585,1898,504,671,407
1500000US131879602013,131879602013,"Block Group 3, Census Tract 9602.01, Lumpkin County, Georgia",1377,419,1106,405,271,152
1500000US131879602021,131879602021,"Block Group 1, Census Tract 9602.02, Lumpkin County, Georgia",2033,437,1459,390,574,361
1500000US131879602022,131879602022,"Block Group 2, Census Tract 9602.02, Lumpkin County, Georgia",2030,600,142,107,1888,602
1500000US131879602023,131879602023,"Block Group 3, Census Tract 9602.02, Lumpkin County, Georgia",1234,438,96,77,1138,428
1500000US131879602024,131879602024,"Block Group 4, Census Tract 9602.02, Lumpkin County, Georgia",2123,556,1622,480,501,315
1500000US131899501001,131899501001,"Block Group 1, Census Tract 9501, McDuffie County, Georgia",1447,275,1231,279,216,140
1500000US131899501002,131899501002,"Block Group 2, Census Tract 9501, McDuffie County, Georgia",981,211,949,212,32,26
1500000US131899502001,131899502001,"Block Group 1, Census Tract 9502, McDuffie County, Georgia",1580,459,893,420,687,381
1500000US131899502002,131899502002,"Block Group 2, Census Tract 9502, McDuffie County, Georgia",1485,305,768,243,717,220
1500000US131899502003,131899502003,"Block Group 3, Census Tract 9502, McDuffie County, Georgia",1418,430,921,399,497,248
1500000US131899502004,131899502004,"Block Group 4, Census Tract 9502, McDuffie County, Georgia",837,210,362,223,475,218
1500000US131899503001,131899503001,"Block Group 1, Census Tract 9503, McDuffie County, Georgia",1370,325,1136,311,234,168
1500000US131899503002,131899503002,"Block Group 2, Census Tract 9503, McDuffie County, Georgia",1043,333,766,336,277,128
1500000US131899503003,131899503003,"Block Group 3, Census Tract 9503, McDuffie County, Georgia",755,201,374,215,381,164
1500000US131899504001,131899504001,"Block Group 1, Census Tract 9504, McDuffie County, Georgia",1014,378,435,214,579,339
1500000US131899504002,131899504002,"Block Group 2, Census Tract 9504, McDuffie County, Georgia",825,287,567,203,258,216
1500000US131899504003,131899504003,"Block Group 3, Census Tract 9504, McDuffie County, Georgia",924,377,712,288,212,214
1500000US131899504004,131899504004,"Block Group 4, Census Tract 9504, McDuffie County, Georgia",981,337,413,232,568,288
1500000US131899504005,131899504005,"Block Group 5, Census Tract 9504, McDuffie County, Georgia",1109,339,64,60,1045,349
1500000US131899505001,131899505001,"Block Group 1, Census Tract 9505, McDuffie County, Georgia",1060,267,891,238,169,170
1500000US131899505002,131899505002,"Block Group 2, Census Tract 9505, McDuffie County, Georgia",1341,326,1011,288,330,169
1500000US131899505003,131899505003,"Block Group 3, Census Tract 9505, McDuffie County, Georgia",2073,398,1204,320,869,358
1500000US131899505004,131899505004,"Block Group 4, Census Tract 9505, McDuffie County, Georgia",1001,221,763,210,238,183
1500000US131911101001,131911101001,"Block Group 1, Census Tract 1101, McIntosh County, Georgia",1576,517,1329,498,247,179
1500000US131911101002,131911101002,"Block Group 2, Census Tract 1101, McIntosh County, Georgia",1425,379,1263,335,162,152
1500000US131911101003,131911101003,"Block Group 3, Census Tract 1101, McIntosh County, Georgia",899,274,826,250,73,110
1500000US131911102001,131911102001,"Block Group 1, Census Tract 1102, McIntosh County, Georgia",2486,638,1218,494,1268,477
1500000US131911102002,131911102002,"Block Group 2, Census Tract 1102, McIntosh County, Georgia",1046,457,1025,462,21,33
1500000US131911102003,131911102003,"Block Group 3, Census Tract 1102, McIntosh County, Georgia",1209,527,1113,538,96,109
1500000US131911103001,131911103001,"Block Group 1, Census Tract 1103, McIntosh County, Georgia",1310,399,902,275,408,311
1500000US131911103002,131911103002,"Block Group 2, Census Tract 1103, McIntosh County, Georgia",1855,457,1410,404,445,211
1500000US131911103003,131911103003,"Block Group 3, Census Tract 1103, McIntosh County, Georgia",2127,426,1357,449,770,382
1500000US131919800001,131919800001,"Block Group 1, Census Tract 9800, McIntosh County, Georgia",0,13,0,13,0,13
1500000US131919900000,131919900000,"Block Group 0, Census Tract 9900, McIntosh County, Georgia",0,13,0,13,0,13
1500000US131930001001,131930001001,"Block Group 1, Census Tract 1, Macon County, Georgia",1215,244,841,206,374,180
1500000US131930001002,131930001002,"Block Group 2, Census Tract 1, Macon County, Georgia",743,179,469,147,274,131
1500000US131930002001,131930002001,"Block Group 1, Census Tract 2, Macon County, Georgia",1086,267,848,263,238,112
1500000US131930002002,131930002002,"Block Group 2, Census Tract 2, Macon County, Georgia",784,195,564,160,220,104
1500000US131930003001,131930003001,"Block Group 1, Census Tract 3, Macon County, Georgia",1350,279,979,217,371,216
1500000US131930003002,131930003002,"Block Group 2, Census Tract 3, Macon County, Georgia",1129,321,739,297,390,161
1500000US131930003003,131930003003,"Block Group 3, Census Tract 3, Macon County, Georgia",880,252,469,203,411,174
1500000US131930004001,131930004001,"Block Group 1, Census Tract 4, Macon County, Georgia",1258,372,1029,307,229,230
1500000US131930004002,131930004002,"Block Group 2, Census Tract 4, Macon County, Georgia",592,279,215,198,377,283
1500000US131930004003,131930004003,"Block Group 3, Census Tract 4, Macon County, Georgia",531,235,393,228,138,89
1500000US131930004004,131930004004,"Block Group 4, Census Tract 4, Macon County, Georgia",1058,300,357,208,701,261
1500000US131930004005,131930004005,"Block Group 5, Census Tract 4, Macon County, Georgia",1082,331,719,302,363,232
1500000US131930004006,131930004006,"Block Group 6, Census Tract 4, Macon County, Georgia",582,297,266,192,316,263
1500000US131950201001,131950201001,"Block Group 1, Census Tract 201, Madison County, Georgia",2201,424,1722,390,479,262
1500000US131950201002,131950201002,"Block Group 2, Census Tract 201, Madison County, Georgia",1510,400,1038,355,472,331
1500000US131950201003,131950201003,"Block Group 3, Census Tract 201, Madison County, Georgia",1497,441,1067,397,430,288
1500000US131950202001,131950202001,"Block Group 1, Census Tract 202, Madison County, Georgia",2218,425,1905,436,313,209
1500000US131950202002,131950202002,"Block Group 2, Census Tract 202, Madison County, Georgia",2672,401,1616,355,1056,323
1500000US131950203001,131950203001,"Block Group 1, Census Tract 203, Madison County, Georgia",2227,396,1413,313,814,312
1500000US131950203002,131950203002,"Block Group 2, Census Tract 203, Madison County, Georgia",1206,282,960,232,246,193
1500000US131950203003,131950203003,"Block Group 3, Census Tract 203, Madison County, Georgia",816,216,615,182,201,120
1500000US131950204001,131950204001,"Block Group 1, Census Tract 204, Madison County, Georgia",2405,464,2086,456,319,226
1500000US131950204002,131950204002,"Block Group 2, Census Tract 204, Madison County, Georgia",1477,401,992,319,485,292
1500000US131950204003,131950204003,"Block Group 3, Census Tract 204, Madison County, Georgia",1584,436,885,276,699,438
1500000US131950205001,131950205001,"Block Group 1, Census Tract 205, Madison County, Georgia",2697,549,1454,426,1243,437
1500000US131950205002,131950205002,"Block Group 2, Census Tract 205, Madison County, Georgia",2201,366,1501,350,700,291
1500000US131950205003,131950205003,"Block Group 3, Census Tract 205, Madison County, Georgia",1114,300,786,273,328,234
1500000US131950206001,131950206001,"Block Group 1, Census Tract 206, Madison County, Georgia",1029,200,826,196,203,132
1500000US131950206002,131950206002,"Block Group 2, Census Tract 206, Madison County, Georgia",1132,172,808,158,324,172
1500000US131979201001,131979201001,"Block Group 1, Census Tract 9201, Marion County, Georgia",2014,421,1849,422,165,133
1500000US131979201002,131979201002,"Block Group 2, Census Tract 9201, Marion County, Georgia",2140,428,1946,424,194,123
1500000US131979202001,131979202001,"Block Group 1, Census Tract 9202, Marion County, Georgia",2153,459,1252,351,901,452
1500000US131979202002,131979202002,"Block Group 2, Census Tract 9202, Marion County, Georgia",1226,345,986,329,240,128
1500000US131979202003,131979202003,"Block Group 3, Census Tract 9202, Marion County, Georgia",1119,311,302,139,817,296
1500000US131999705001,131999705001,"Block Group 1, Census Tract 9705, Meriwether County, Georgia",871,431,344,205,527,398
1500000US131999705002,131999705002,"Block Group 2, Census Tract 9705, Meriwether County, Georgia",1259,409,517,184,742,412
1500000US131999705003,131999705003,"Block Group 3, Census Tract 9705, Meriwether County, Georgia",872,318,562,269,310,200
1500000US131999705004,131999705004,"Block Group 4, Census Tract 9705, Meriwether County, Georgia",803,355,382,263,421,334
1500000US131999705005,131999705005,"Block Group 5, Census Tract 9705, Meriwether County, Georgia",775,406,497,334,278,236
1500000US131999705006,131999705006,"Block Group 6, Census Tract 9705, Meriwether County, Georgia",958,378,587,339,371,330
1500000US131999706001,131999706001,"Block Group 1, Census Tract 9706, Meriwether County, Georgia",924,252,583,192,341,185
1500000US131999706002,131999706002,"Block Group 2, Census Tract 9706, Meriwether County, Georgia",1298,276,1004,280,294,151
1500000US131999706003,131999706003,"Block Group 3, Census Tract 9706, Meriwether County, Georgia",1044,290,736,222,308,201
1500000US131999707001,131999707001,"Block Group 1, Census Tract 9707, Meriwether County, Georgia",2311,505,1563,420,748,285
1500000US131999707002,131999707002,"Block Group 2, Census Tract 9707, Meriwether County, Georgia",1384,366,1222,338,162,181
1500000US131999707003,131999707003,"Block Group 3, Census Tract 9707, Meriwether County, Georgia",1347,438,1001,372,346,289
1500000US131999707004,131999707004,"Block Group 4, Census Tract 9707, Meriwether County, Georgia",1538,380,1175,342,363,196
1500000US131999707005,131999707005,"Block Group 5, Census Tract 9707, Meriwether County, Georgia",684,272,492,199,192,194
1500000US131999708001,131999708001,"Block Group 1, Census Tract 9708, Meriwether County, Georgia",1201,238,729,193,472,188
1500000US131999708002,131999708002,"Block Group 2, Census Tract 9708, Meriwether County, Georgia",593,167,491,154,102,104
1500000US131999708003,131999708003,"Block Group 3, Census Tract 9708, Meriwether County, Georgia",1012,353,797,356,215,142
1500000US131999708004,131999708004,"Block Group 4, Census Tract 9708, Meriwether County, Georgia",449,166,444,165,5,10
1500000US131999708005,131999708005,"Block Group 5, Census Tract 9708, Meriwether County, Georgia",1267,312,944,256,323,169
1500000US131999708006,131999708006,"Block Group 6, Census Tract 9708, Meriwether County, Georgia",434,150,223,99,211,110
1500000US132019501001,132019501001,"Block Group 1, Census Tract 9501, Miller County, Georgia",1599,167,1038,156,561,193
1500000US132019502001,132019502001,"Block Group 1, Census Tract 9502, Miller County, Georgia",635,165,470,142,165,98
1500000US132019502002,132019502002,"Block Group 2, Census Tract 9502, Miller County, Georgia",1133,197,492,158,641,163
1500000US132019503001,132019503001,"Block Group 1, Census Tract 9503, Miller County, Georgia",753,179,481,193,272,129
1500000US132019503002,132019503002,"Block Group 2, Census Tract 9503, Miller County, Georgia",1637,231,1087,198,550,184
1500000US132050901001,132050901001,"Block Group 1, Census Tract 901, Mitchell County, Georgia",1258,318,775,217,483,207
1500000US132050901002,132050901002,"Block Group 2, Census Tract 901, Mitchell County, Georgia",2210,311,1725,353,485,248
1500000US132050902001,132050902001,"Block Group 1, Census Tract 902, Mitchell County, Georgia",857,241,510,167,347,188
1500000US132050902002,132050902002,"Block Group 2, Census Tract 902, Mitchell County, Georgia",1320,265,906,241,414,168
1500000US132050902003,132050902003,"Block Group 3, Census Tract 902, Mitchell County, Georgia",1082,298,635,199,447,270
1500000US132050903001,132050903001,"Block Group 1, Census Tract 903, Mitchell County, Georgia",582,132,406,118,176,79
1500000US132050903002,132050903002,"Block Group 2, Census Tract 903, Mitchell County, Georgia",1435,323,581,176,854,327
1500000US132050903003,132050903003,"Block Group 3, Census Tract 903, Mitchell County, Georgia",465,208,226,174,239,120
1500000US132050904001,132050904001,"Block Group 1, Census Tract 904, Mitchell County, Georgia",1635,418,1191,339,444,304
1500000US132050904002,132050904002,"Block Group 2, Census Tract 904, Mitchell County, Georgia",1689,796,1208,841,481,250
1500000US132050904003,132050904003,"Block Group 3, Census Tract 904, Mitchell County, Georgia",939,253,811,269,128,87
1500000US132050904004,132050904004,"Block Group 4, Census Tract 904, Mitchell County, Georgia",1744,363,1089,359,655,296
1500000US132050905001,132050905001,"Block Group 1, Census Tract 905, Mitchell County, Georgia",762,219,557,202,205,157
1500000US132050905002,132050905002,"Block Group 2, Census Tract 905, Mitchell County, Georgia",1038,337,864,338,174,109
1500000US132050905003,132050905003,"Block Group 3, Census Tract 905, Mitchell County, Georgia",967,311,462,283,505,297
1500000US132050905004,132050905004,"Block Group 4, Census Tract 905, Mitchell County, Georgia",1211,298,954,308,257,165
1500000US132050905005,132050905005,"Block Group 5, Census Tract 905, Mitchell County, Georgia",1560,444,787,340,773,382
1500000US132070501011,132070501011,"Block Group 1, Census Tract 501.01, Monroe County, Georgia",2037,481,1320,351,717,353
1500000US132070501012,132070501012,"Block Group 2, Census Tract 501.01, Monroe County, Georgia",3258,518,2970,488,288,247
1500000US132070501013,132070501013,"Block Group 3, Census Tract 501.01, Monroe County, Georgia",600,307,483,272,117,139
1500000US132070501021,132070501021,"Block Group 1, Census Tract 501.02, Monroe County, Georgia",2434,394,1609,322,825,281
1500000US132070501022,132070501022,"Block Group 2, Census Tract 501.02, Monroe County, Georgia",1572,402,869,311,703,355
1500000US132070502001,132070502001,"Block Group 1, Census Tract 502, Monroe County, Georgia",1360,321,800,252,560,232
1500000US132070502002,132070502002,"Block Group 2, Census Tract 502, Monroe County, Georgia",767,250,501,225,266,141
1500000US132070502003,132070502003,"Block Group 3, Census Tract 502, Monroe County, Georgia",2704,454,1874,406,830,280
1500000US132070503011,132070503011,"Block Group 1, Census Tract 503.01, Monroe County, Georgia",1976,441,1829,442,147,98
1500000US132070503012,132070503012,"Block Group 2, Census Tract 503.01, Monroe County, Georgia",1278,370,971,323,307,221
1500000US132070503013,132070503013,"Block Group 3, Census Tract 503.01, Monroe County, Georgia",1439,396,1331,411,108,72
1500000US132070503021,132070503021,"Block Group 1, Census Tract 503.02, Monroe County, Georgia",1853,571,1588,649,265,218
1500000US132070503022,132070503022,"Block Group 2, Census Tract 503.02, Monroe County, Georgia",2393,393,2069,390,324,179
1500000US132070503023,132070503023,"Block Group 3, Census Tract 503.02, Monroe County, Georgia",1975,515,1793,530,182,185
1500000US132099501001,132099501001,"Block Group 1, Census Tract 9501, Montgomery County, Georgia",1346,155,1162,128,184,122
1500000US132099501002,132099501002,"Block Group 2, Census Tract 9501, Montgomery County, Georgia",722,144,556,129,166,106
1500000US132099502001,132099502001,"Block Group 1, Census Tract 9502, Montgomery County, Georgia",1307,256,881,220,426,203
1500000US132099502002,132099502002,"Block Group 2, Census Tract 9502, Montgomery County, Georgia",1473,238,868,219,605,200
1500000US132099502003,132099502003,"Block Group 3, Census Tract 9502, Montgomery County, Georgia",1312,235,824,197,488,155
1500000US132099503001,132099503001,"Block Group 1, Census Tract 9503, Montgomery County, Georgia",1146,177,815,141,331,134
1500000US132099503002,132099503002,"Block Group 2, Census Tract 9503, Montgomery County, Georgia",923,183,733,160,190,106
1500000US132110101001,132110101001,"Block Group 1, Census Tract 101, Morgan County, Georgia",2817,251,2278,277,539,210
1500000US132110102001,132110102001,"Block Group 1, Census Tract 102, Morgan County, Georgia",2684,280,2368,304,316,178
1500000US132110102002,132110102002,"Block Group 2, Census Tract 102, Morgan County, Georgia",1160,243,877,235,283,179
1500000US132110103001,132110103001,"Block Group 1, Census Tract 103, Morgan County, Georgia",2224,373,1614,372,610,343
1500000US132110103002,132110103002,"Block Group 2, Census Tract 103, Morgan County, Georgia",1154,291,943,280,211,231
1500000US132110103003,132110103003,"Block Group 3, Census Tract 103, Morgan County, Georgia",2317,538,1478,403,839,436
1500000US132110103004,132110103004,"Block Group 4, Census Tract 103, Morgan County, Georgia",954,399,616,328,338,291
1500000US132110104001,132110104001,"Block Group 1, Census Tract 104, Morgan County, Georgia",3004,294,2038,396,966,235
1500000US132110105001,132110105001,"Block Group 1, Census Tract 105, Morgan County, Georgia",1414,168,1251,159,163,101
1500000US132130101001,132130101001,"Block Group 1, Census Tract 101, Murray County, Georgia",841,193,613,170,228,122
1500000US132130101002,132130101002,"Block Group 2, Census Tract 101, Murray County, Georgia",539,176,497,172,42,65
1500000US132130101003,132130101003,"Block Group 3, Census Tract 101, Murray County, Georgia",956,268,637,270,319,236
1500000US132130101004,132130101004,"Block Group 4, Census Tract 101, Murray County, Georgia",930,237,827,254,103,88
1500000US132130102011,132130102011,"Block Group 1, Census Tract 102.01, Murray County, Georgia",1994,272,1640,283,354,127
1500000US132130102021,132130102021,"Block Group 1, Census Tract 102.02, Murray County, Georgia",3785,718,2358,641,1427,536
1500000US132130102022,132130102022,"Block Group 2, Census Tract 102.02, Murray County, Georgia",1635,547,1023,354,612,451
1500000US132130102023,132130102023,"Block Group 3, Census Tract 102.02, Murray County, Georgia",2658,723,1076,411,1582,670
1500000US132130102024,132130102024,"Block Group 4, Census Tract 102.02, Murray County, Georgia",973,408,876,378,97,145
1500000US132130103001,132130103001,"Block Group 1, Census Tract 103, Murray County, Georgia",553,236,267,101,286,223
1500000US132130103002,132130103002,"Block Group 2, Census Tract 103, Murray County, Georgia",1589,286,1318,299,271,153
1500000US132130103003,132130103003,"Block Group 3, Census Tract 103, Murray County, Georgia",1722,376,1023,289,699,314
1500000US132130104001,132130104001,"Block Group 1, Census Tract 104, Murray County, Georgia",1271,305,614,292,657,328
1500000US132130104002,132130104002,"Block Group 2, Census Tract 104, Murray County, Georgia",790,322,720,302,70,108
1500000US132130104003,132130104003,"Block Group 3, Census Tract 104, Murray County, Georgia",2607,650,1163,402,1444,697
1500000US132130104004,132130104004,"Block Group 4, Census Tract 104, Murray County, Georgia",1198,384,654,282,544,299
1500000US132130105001,132130105001,"Block Group 1, Census Tract 105, Murray County, Georgia",640,299,318,139,322,265
1500000US132130105002,132130105002,"Block Group 2, Census Tract 105, Murray County, Georgia",2147,372,1514,356,633,299
1500000US132130105003,132130105003,"Block Group 3, Census Tract 105, Murray County, Georgia",2527,378,2042,368,485,271
1500000US132130106001,132130106001,"Block Group 1, Census Tract 106, Murray County, Georgia",1454,392,885,317,569,243
1500000US132130106002,132130106002,"Block Group 2, Census Tract 106, Murray County, Georgia",1527,369,992,362,535,239
1500000US132130106003,132130106003,"Block Group 3, Census Tract 106, Murray County, Georgia",1161,304,1046,276,115,121
1500000US132130107001,132130107001,"Block Group 1, Census Tract 107, Murray County, Georgia",1905,331,1251,302,654,259
1500000US132130107002,132130107002,"Block Group 2, Census Tract 107, Murray County, Georgia",1754,439,1155,348,599,424
1500000US132130107003,132130107003,"Block Group 3, Census Tract 107, Murray County, Georgia",431,127,399,127,32,37
1500000US132130107004,132130107004,"Block Group 4, Census Tract 107, Murray County, Georgia",1572,473,1084,394,488,327
1500000US132150002001,132150002001,"Block Group 1, Census Tract 2, Muscogee County, Georgia",1636,237,643,173,993,285
1500000US132150002002,132150002002,"Block Group 2, Census Tract 2, Muscogee County, Georgia",1187,282,951,256,236,180
1500000US132150003001,132150003001,"Block Group 1, Census Tract 3, Muscogee County, Georgia",774,161,233,94,541,172
1500000US132150003002,132150003002,"Block Group 2, Census Tract 3, Muscogee County, Georgia",605,160,103,57,502,175
1500000US132150004001,132150004001,"Block Group 1, Census Tract 4, Muscogee County, Georgia",911,232,722,211,189,140
1500000US132150004002,132150004002,"Block Group 2, Census Tract 4, Muscogee County, Georgia",1114,223,893,226,221,149
1500000US132150004003,132150004003,"Block Group 3, Census Tract 4, Muscogee County, Georgia",736,230,554,180,182,150
1500000US132150008001,132150008001,"Block Group 1, Census Tract 8, Muscogee County, Georgia",1040,209,372,187,668,229
1500000US132150008002,132150008002,"Block Group 2, Census Tract 8, Muscogee County, Georgia",1349,263,465,205,884,290
1500000US132150009001,132150009001,"Block Group 1, Census Tract 9, Muscogee County, Georgia",886,281,335,150,551,269
1500000US132150009002,132150009002,"Block Group 2, Census Tract 9, Muscogee County, Georgia",1537,283,250,122,1287,274
1500000US132150010001,132150010001,"Block Group 1, Census Tract 10, Muscogee County, Georgia",1014,301,802,241,212,207
1500000US132150010002,132150010002,"Block Group 2, Census Tract 10, Muscogee County, Georgia",1828,366,771,240,1057,351
1500000US132150010003,132150010003,"Block Group 3, Census Tract 10, Muscogee County, Georgia",700,215,481,151,219,168
1500000US132150011001,132150011001,"Block Group 1, Census Tract 11, Muscogee County, Georgia",1683,177,1158,251,525,206
1500000US132150011002,132150011002,"Block Group 2, Census Tract 11, Muscogee County, Georgia",938,182,921,183,17,26
1500000US132150012001,132150012001,"Block Group 1, Census Tract 12, Muscogee County, Georgia",1167,237,584,200,583,150
1500000US132150012002,132150012002,"Block Group 2, Census Tract 12, Muscogee County, Georgia",1071,253,458,183,613,220
1500000US132150012003,132150012003,"Block Group 3, Census Tract 12, Muscogee County, Georgia",1153,305,355,164,798,296
1500000US132150014001,132150014001,"Block Group 1, Census Tract 14, Muscogee County, Georgia",1004,244,28,19,976,244
1500000US132150014002,132150014002,"Block Group 2, Census Tract 14, Muscogee County, Georgia",814,196,81,61,733,209
1500000US132150016001,132150016001,"Block Group 1, Census Tract 16, Muscogee County, Georgia",1305,289,249,138,1056,245
1500000US132150016002,132150016002,"Block Group 2, Census Tract 16, Muscogee County, Georgia",971,241,90,102,881,233
1500000US132150018001,132150018001,"Block Group 1, Census Tract 18, Muscogee County, Georgia",1086,179,262,111,824,176
1500000US132150020001,132150020001,"Block Group 1, Census Tract 20, Muscogee County, Georgia",2582,473,1411,341,1171,423
1500000US132150020002,132150020002,"Block Group 2, Census Tract 20, Muscogee County, Georgia",978,253,529,256,449,217
1500000US132150021001,132150021001,"Block Group 1, Census Tract 21, Muscogee County, Georgia",802,254,590,260,212,149
1500000US132150021002,132150021002,"Block Group 2, Census Tract 21, Muscogee County, Georgia",1740,322,961,305,779,229
1500000US132150022001,132150022001,"Block Group 1, Census Tract 22, Muscogee County, Georgia",990,502,729,508,261,99
1500000US132150022002,132150022002,"Block Group 2, Census Tract 22, Muscogee County, Georgia",835,258,355,234,480,241
1500000US132150022003,132150022003,"Block Group 3, Census Tract 22, Muscogee County, Georgia",342,142,260,129,82,74
1500000US132150022004,132150022004,"Block Group 4, Census Tract 22, Muscogee County, Georgia",1180,448,242,131,938,449
1500000US132150023001,132150023001,"Block Group 1, Census Tract 23, Muscogee County, Georgia",1454,199,584,112,870,169
1500000US132150024001,132150024001,"Block Group 1, Census Tract 24, Muscogee County, Georgia",1515,209,58,45,1457,206
1500000US132150025001,132150025001,"Block Group 1, Census Tract 25, Muscogee County, Georgia",1007,202,0,13,1007,202
1500000US132150025002,132150025002,"Block Group 2, Census Tract 25, Muscogee County, Georgia",582,179,4,6,578,180
1500000US132150027001,132150027001,"Block Group 1, Census Tract 27, Muscogee County, Georgia",2181,383,382,262,1799,381
1500000US132150028001,132150028001,"Block Group 1, Census Tract 28, Muscogee County, Georgia",840,213,146,84,694,210
1500000US132150028002,132150028002,"Block Group 2, Census Tract 28, Muscogee County, Georgia",995,200,369,139,626,200
1500000US132150029011,132150029011,"Block Group 1, Census Tract 29.01, Muscogee County, Georgia",803,258,333,132,470,252
1500000US132150029012,132150029012,"Block Group 2, Census Tract 29.01, Muscogee County, Georgia",2069,385,886,276,1183,299
1500000US132150029021,132150029021,"Block Group 1, Census Tract 29.02, Muscogee County, Georgia",1409,341,234,135,1175,323
1500000US132150029022,132150029022,"Block Group 2, Census Tract 29.02, Muscogee County, Georgia",955,233,590,168,365,163
1500000US132150030001,132150030001,"Block Group 1, Census Tract 30, Muscogee County, Georgia",444,274,314,258,130,112
1500000US132150030002,132150030002,"Block Group 2, Census Tract 30, Muscogee County, Georgia",1469,351,272,143,1197,340
1500000US132150030003,132150030003,"Block Group 3, Census Tract 30, Muscogee County, Georgia",687,262,200,143,487,241
1500000US132150032001,132150032001,"Block Group 1, Census Tract 32, Muscogee County, Georgia",340,92,16,18,324,90
1500000US132150032002,132150032002,"Block Group 2, Census Tract 32, Muscogee County, Georgia",732,249,72,58,660,244
1500000US132150032003,132150032003,"Block Group 3, Census Tract 32, Muscogee County, Georgia",699,268,259,135,440,228
1500000US132150033011,132150033011,"Block Group 1, Census Tract 33.01, Muscogee County, Georgia",1428,281,739,248,689,203
1500000US132150033021,132150033021,"Block Group 1, Census Tract 33.02, Muscogee County, Georgia",825,230,193,98,632,251
1500000US132150033022,132150033022,"Block Group 2, Census Tract 33.02, Muscogee County, Georgia",944,257,440,166,504,213
1500000US132150033023,132150033023,"Block Group 3, Census Tract 33.02, Muscogee County, Georgia",887,274,267,135,620,260
1500000US132150034001,132150034001,"Block Group 1, Census Tract 34, Muscogee County, Georgia",716,189,47,33,669,193
1500000US132150034002,132150034002,"Block Group 2, Census Tract 34, Muscogee County, Georgia",1609,298,233,91,1376,293
1500000US132150101041,132150101041,"Block Group 1, Census Tract 101.04, Muscogee County, Georgia",1655,421,451,235,1204,322
1500000US132150101042,132150101042,"Block Group 2, Census Tract 101.04, Muscogee County, Georgia",3004,486,1465,316,1539,448
1500000US132150101043,132150101043,"Block Group 3, Census Tract 101.04, Muscogee County, Georgia",1918,467,254,117,1664,485
1500000US132150101061,132150101061,"Block Group 1, Census Tract 101.06, Muscogee County, Georgia",698,247,499,211,199,252
1500000US132150101062,132150101062,"Block Group 2, Census Tract 101.06, Muscogee County, Georgia",1875,436,1246,424,629,263
1500000US132150101063,132150101063,"Block Group 3, Census Tract 101.06, Muscogee County, Georgia",2937,714,2337,635,600,315
1500000US132150101071,132150101071,"Block Group 1, Census Tract 101.07, Muscogee County, Georgia",3299,541,2994,540,305,257
1500000US132150101072,132150101072,"Block Group 2, Census Tract 101.07, Muscogee County, Georgia",4456,567,3490,625,966,406
1500000US132150102011,132150102011,"Block Group 1, Census Tract 102.01, Muscogee County, Georgia",4448,700,2110,592,2338,603
1500000US132150102012,132150102012,"Block Group 2, Census Tract 102.01, Muscogee County, Georgia",2290,418,2234,410,56,87
1500000US132150102031,132150102031,"Block Group 1, Census Tract 102.03, Muscogee County, Georgia",3717,609,2319,556,1398,397
1500000US132150102032,132150102032,"Block Group 2, Census Tract 102.03, Muscogee County, Georgia",5076,611,2922,532,2154,516
1500000US132150102041,132150102041,"Block Group 1, Census Tract 102.04, Muscogee County, Georgia",2230,468,1475,423,755,374
1500000US132150102042,132150102042,"Block Group 2, Census Tract 102.04, Muscogee County, Georgia",1536,334,398,158,1138,341
1500000US132150102043,132150102043,"Block Group 3, Census Tract 102.04, Muscogee County, Georgia",2724,536,1786,472,938,460
1500000US132150102051,132150102051,"Block Group 1, Census Tract 102.05, Muscogee County, Georgia",1523,350,470,147,1053,319
1500000US132150102052,132150102052,"Block Group 2, Census Tract 102.05, Muscogee County, Georgia",1981,245,1110,241,871,283
1500000US132150103011,132150103011,"Block Group 1, Census Tract 103.01, Muscogee County, Georgia",2469,177,2244,180,225,127
1500000US132150103021,132150103021,"Block Group 1, Census Tract 103.02, Muscogee County, Georgia",1702,446,1164,365,538,282
1500000US132150103022,132150103022,"Block Group 2, Census Tract 103.02, Muscogee County, Georgia",2729,579,1363,371,1366,515
1500000US132150103023,132150103023,"Block Group 3, Census Tract 103.02, Muscogee County, Georgia",2515,410,2186,385,329,216
1500000US132150104011,132150104011,"Block Group 1, Census Tract 104.01, Muscogee County, Georgia",2165,527,1726,535,439,305
1500000US132150104012,132150104012,"Block Group 2, Census Tract 104.01, Muscogee County, Georgia",2936,724,2560,657,376,350
1500000US132150104013,132150104013,"Block Group 3, Census Tract 104.01, Muscogee County, Georgia",1545,336,761,254,784,341
1500000US132150104021,132150104021,"Block Group 1, Census Tract 104.02, Muscogee County, Georgia",1097,338,124,91,973,345
1500000US132150104022,132150104022,"Block Group 2, Census Tract 104.02, Muscogee County, Georgia",1430,377,526,189,904,359
1500000US132150104023,132150104023,"Block Group 3, Census Tract 104.02, Muscogee County, Georgia",1699,276,1022,271,677,310
1500000US132150105011,132150105011,"Block Group 1, Census Tract 105.01, Muscogee County, Georgia",1128,343,841,250,287,274
1500000US132150105012,132150105012,"Block Group 2, Census Tract 105.01, Muscogee County, Georgia",1759,465,1230,373,529,391
1500000US132150105013,132150105013,"Block Group 3, Census Tract 105.01, Muscogee County, Georgia",1598,372,1262,364,336,286
1500000US132150105014,132150105014,"Block Group 4, Census Tract 105.01, Muscogee County, Georgia",1533,444,442,151,1091,440
1500000US132150105021,132150105021,"Block Group 1, Census Tract 105.02, Muscogee County, Georgia",1593,179,319,122,1274,178
1500000US132150106021,132150106021,"Block Group 1, Census Tract 106.02, Muscogee County, Georgia",2280,460,1375,432,905,314
1500000US132150106022,132150106022,"Block Group 2, Census Tract 106.02, Muscogee County, Georgia",493,165,441,151,52,58
1500000US132150106023,132150106023,"Block Group 3, Census Tract 106.02, Muscogee County, Georgia",2610,511,1386,448,1224,381
1500000US132150106051,132150106051,"Block Group 1, Census Tract 106.05, Muscogee County, Georgia",2190,504,1438,402,752,377
1500000US132150106052,132150106052,"Block Group 2, Census Tract 106.05, Muscogee County, Georgia",2302,493,1514,327,788,396
1500000US132150106061,132150106061,"Block Group 1, Census Tract 106.06, Muscogee County, Georgia",17,13,3,6,14,12
1500000US132150106071,132150106071,"Block Group 1, Census Tract 106.07, Muscogee County, Georgia",1292,373,856,351,436,240
1500000US132150106072,132150106072,"Block Group 2, Census Tract 106.07, Muscogee County, Georgia",2002,495,1403,470,599,259
1500000US132150106073,132150106073,"Block Group 3, Census Tract 106.07, Muscogee County, Georgia",2669,478,1319,329,1350,537
1500000US132150106081,132150106081,"Block Group 1, Census Tract 106.08, Muscogee County, Georgia",2373,470,1718,406,655,344
1500000US132150106082,132150106082,"Block Group 2, Census Tract 106.08, Muscogee County, Georgia",2211,517,1394,415,817,414
1500000US132150107011,132150107011,"Block Group 1, Census Tract 107.01, Muscogee County, Georgia",2091,654,1550,637,541,322
1500000US132150107012,132150107012,"Block Group 2, Census Tract 107.01, Muscogee County, Georgia",2165,503,1636,458,529,343
1500000US132150107013,132150107013,"Block Group 3, Census Tract 107.01, Muscogee County, Georgia",1876,571,761,397,1115,496
1500000US132150107021,132150107021,"Block Group 1, Census Tract 107.02, Muscogee County, Georgia",769,235,544,180,225,250
1500000US132150107022,132150107022,"Block Group 2, Census Tract 107.02, Muscogee County, Georgia",2328,444,1730,380,598,244
1500000US132150107023,132150107023,"Block Group 3, Census Tract 107.02, Muscogee County, Georgia",1828,341,1248,298,580,227
1500000US132150107031,132150107031,"Block Group 1, Census Tract 107.03, Muscogee County, Georgia",1782,417,1283,344,499,302
1500000US132150107032,132150107032,"Block Group 2, Census Tract 107.03, Muscogee County, Georgia",2271,626,833,424,1438,529
1500000US132150107033,132150107033,"Block Group 3, Census Tract 107.03, Muscogee County, Georgia",1151,297,782,313,369,227
1500000US132150107034,132150107034,"Block Group 4, Census Tract 107.03, Muscogee County, Georgia",945,301,492,158,453,279
1500000US132150108011,132150108011,"Block Group 1, Census Tract 108.01, Muscogee County, Georgia",308,99,0,13,308,99
1500000US132150108012,132150108012,"Block Group 2, Census Tract 108.01, Muscogee County, Georgia",1288,292,0,13,1288,292
1500000US132150108021,132150108021,"Block Group 1, Census Tract 108.02, Muscogee County, Georgia",2390,439,0,13,2390,439
1500000US132150108022,132150108022,"Block Group 2, Census Tract 108.02, Muscogee County, Georgia",2430,457,0,18,2430,457
1500000US132150108023,132150108023,"Block Group 3, Census Tract 108.02, Muscogee County, Georgia",343,166,0,13,343,166
1500000US132150111001,132150111001,"Block Group 1, Census Tract 111, Muscogee County, Georgia",1005,123,227,80,778,108
1500000US132150111002,132150111002,"Block Group 2, Census Tract 111, Muscogee County, Georgia",371,159,9,11,362,158
1500000US132150112001,132150112001,"Block Group 1, Census Tract 112, Muscogee County, Georgia",1181,206,538,135,643,206
1500000US132150112002,132150112002,"Block Group 2, Census Tract 112, Muscogee County, Georgia",1041,309,108,99,933,307
1500000US132150114001,132150114001,"Block Group 1, Census Tract 114, Muscogee County, Georgia",1535,242,277,131,1258,243
1500000US132150114002,132150114002,"Block Group 2, Census Tract 114, Muscogee County, Georgia",732,202,242,81,490,192
1500000US132150115001,132150115001,"Block Group 1, Census Tract 115, Muscogee County, Georgia",1027,351,635,237,392,280
1500000US132150115002,132150115002,"Block Group 2, Census Tract 115, Muscogee County, Georgia",488,199,224,120,264,170
1500000US132150115003,132150115003,"Block Group 3, Census Tract 115, Muscogee County, Georgia",1657,417,947,256,710,338
1500000US132150115004,132150115004,"Block Group 4, Census Tract 115, Muscogee County, Georgia",1241,284,352,195,889,256
1500000US132150115005,132150115005,"Block Group 5, Census Tract 115, Muscogee County, Georgia",1127,504,453,358,674,395
1500000US132150115006,132150115006,"Block Group 6, Census Tract 115, Muscogee County, Georgia",538,163,416,145,122,95
1500000US132171001001,132171001001,"Block Group 1, Census Tract 1001, Newton County, Georgia",2455,559,2396,548,59,92
1500000US132171001002,132171001002,"Block Group 2, Census Tract 1001, Newton County, Georgia",3098,905,2294,584,804,817
1500000US132171001003,132171001003,"Block Group 3, Census Tract 1001, Newton County, Georgia",2792,639,2504,640,288,232
1500000US132171001004,132171001004,"Block Group 4, Census Tract 1001, Newton County, Georgia",2576,541,1758,461,818,424
1500000US132171002011,132171002011,"Block Group 1, Census Tract 1002.01, Newton County, Georgia",1971,436,1739,454,232,218
1500000US132171002012,132171002012,"Block Group 2, Census Tract 1002.01, Newton County, Georgia",1269,283,1006,286,263,131
1500000US132171002013,132171002013,"Block Group 3, Census Tract 1002.01, Newton County, Georgia",2777,477,2368,515,409,200
1500000US132171002021,132171002021,"Block Group 1, Census Tract 1002.02, Newton County, Georgia",2885,354,2483,365,402,157
1500000US132171002022,132171002022,"Block Group 2, Census Tract 1002.02, Newton County, Georgia",2153,377,1877,393,276,284
1500000US132171003001,132171003001,"Block Group 1, Census Tract 1003, Newton County, Georgia",2498,627,1878,620,620,356
1500000US132171003002,132171003002,"Block Group 2, Census Tract 1003, Newton County, Georgia",3125,659,2462,618,663,331
1500000US132171003003,132171003003,"Block Group 3, Census Tract 1003, Newton County, Georgia",2436,605,122,67,2314,619
1500000US132171003004,132171003004,"Block Group 4, Census Tract 1003, Newton County, Georgia",1103,266,599,199,504,278
1500000US132171004001,132171004001,"Block Group 1, Census Tract 1004, Newton County, Georgia",1913,361,892,275,1021,350
1500000US132171004002,132171004002,"Block Group 2, Census Tract 1004, Newton County, Georgia",945,216,477,146,468,222
1500000US132171005011,132171005011,"Block Group 1, Census Tract 1005.01, Newton County, Georgia",5602,1316,3069,992,2533,1245
1500000US132171005012,132171005012,"Block Group 2, Census Tract 1005.01, Newton County, Georgia",8924,1200,5308,1154,3616,1411
1500000US132171005013,132171005013,"Block Group 3, Census Tract 1005.01, Newton County, Georgia",960,455,862,367,98,222
1500000US132171005021,132171005021,"Block Group 1, Census Tract 1005.02, Newton County, Georgia",5292,923,3592,717,1700,668
1500000US132171005022,132171005022,"Block Group 2, Census Tract 1005.02, Newton County, Georgia",3012,933,1352,685,1660,764
1500000US132171006001,132171006001,"Block Group 1, Census Tract 1006, Newton County, Georgia",3640,536,2555,564,1085,437
1500000US132171006002,132171006002,"Block Group 2, Census Tract 1006, Newton County, Georgia",1879,430,771,243,1108,431
1500000US132171007001,132171007001,"Block Group 1, Census Tract 1007, Newton County, Georgia",980,279,675,290,305,290
1500000US132171007002,132171007002,"Block Group 2, Census Tract 1007, Newton County, Georgia",2435,633,1543,550,892,416
1500000US132171007003,132171007003,"Block Group 3, Census Tract 1007, Newton County, Georgia",2714,687,850,411,1864,571
1500000US132171008001,132171008001,"Block Group 1, Census Tract 1008, Newton County, Georgia",3842,686,3022,593,820,485
1500000US132171008002,132171008002,"Block Group 2, Census Tract 1008, Newton County, Georgia",5899,824,3991,797,1908,702
1500000US132171009011,132171009011,"Block Group 1, Census Tract 1009.01, Newton County, Georgia",4170,792,3442,773,728,421
1500000US132171009012,132171009012,"Block Group 2, Census Tract 1009.01, Newton County, Georgia",3441,895,2735,872,706,491
1500000US132171009013,132171009013,"Block Group 3, Census Tract 1009.01, Newton County, Georgia",2410,536,2175,528,235,184
1500000US132171009021,132171009021,"Block Group 1, Census Tract 1009.02, Newton County, Georgia",2960,824,2517,789,443,297
1500000US132171009022,132171009022,"Block Group 2, Census Tract 1009.02, Newton County, Georgia",2901,717,1845,521,1056,565
1500000US132171009031,132171009031,"Block Group 1, Census Tract 1009.03, Newton County, Georgia",4924,619,3391,761,1533,632
1500000US132171009032,132171009032,"Block Group 2, Census Tract 1009.03, Newton County, Georgia",1211,556,922,435,289,315
1500000US132190301001,132190301001,"Block Group 1, Census Tract 301, Oconee County, Georgia",3854,561,3314,451,540,328
1500000US132190301002,132190301002,"Block Group 2, Census Tract 301, Oconee County, Georgia",4170,607,3194,565,976,510
1500000US132190301003,132190301003,"Block Group 3, Census Tract 301, Oconee County, Georgia",2061,291,1558,276,503,169
1500000US132190301004,132190301004,"Block Group 4, Census Tract 301, Oconee County, Georgia",1492,462,1259,457,233,174
1500000US132190302001,132190302001,"Block Group 1, Census Tract 302, Oconee County, Georgia",2637,397,1715,360,922,298
1500000US132190302002,132190302002,"Block Group 2, Census Tract 302, Oconee County, Georgia",2876,366,2314,367,562,207
1500000US132190303001,132190303001,"Block Group 1, Census Tract 303, Oconee County, Georgia",2951,333,2747,328,204,114
1500000US132190303002,132190303002,"Block Group 2, Census Tract 303, Oconee County, Georgia",2141,306,1432,220,709,319
1500000US132190304001,132190304001,"Block Group 1, Census Tract 304, Oconee County, Georgia",1855,363,1387,321,468,182
1500000US132190304002,132190304002,"Block Group 2, Census Tract 304, Oconee County, Georgia",2160,339,2001,310,159,204
1500000US132190304003,132190304003,"Block Group 3, Census Tract 304, Oconee County, Georgia",3096,353,2304,376,792,294
1500000US132190305001,132190305001,"Block Group 1, Census Tract 305, Oconee County, Georgia",2118,241,1931,231,187,136
1500000US132190306001,132190306001,"Block Group 1, Census Tract 306, Oconee County, Georgia",1923,258,1605,188,318,213
1500000US132190306002,132190306002,"Block Group 2, Census Tract 306, Oconee County, Georgia",851,178,761,177,90,70
1500000US132219601001,132219601001,"Block Group 1, Census Tract 9601, Oglethorpe County, Georgia",816,175,720,168,96,85
1500000US132219601002,132219601002,"Block Group 2, Census Tract 9601, Oglethorpe County, Georgia",927,166,708,169,219,115
1500000US132219602011,132219602011,"Block Group 1, Census Tract 9602.01, Oglethorpe County, Georgia",1879,351,1413,415,466,223
1500000US132219602012,132219602012,"Block Group 2, Census Tract 9602.01, Oglethorpe County, Georgia",1352,294,1124,314,228,120
1500000US132219602013,132219602013,"Block Group 3, Census Tract 9602.01, Oglethorpe County, Georgia",3454,469,2572,477,882,429
1500000US132219602021,132219602021,"Block Group 1, Census Tract 9602.02, Oglethorpe County, Georgia",1635,305,1320,311,315,206
1500000US132219602022,132219602022,"Block Group 2, Census Tract 9602.02, Oglethorpe County, Georgia",990,237,723,204,267,137
1500000US132219602023,132219602023,"Block Group 3, Census Tract 9602.02, Oglethorpe County, Georgia",1813,384,1256,258,557,330
1500000US132219603001,132219603001,"Block Group 1, Census Tract 9603, Oglethorpe County, Georgia",1683,197,1250,208,433,176
1500000US132231201011,132231201011,"Block Group 1, Census Tract 1201.01, Paulding County, Georgia",5869,769,4931,848,938,644
1500000US132231201012,132231201012,"Block Group 2, Census Tract 1201.01, Paulding County, Georgia",4608,967,3754,947,854,996
1500000US132231201013,132231201013,"Block Group 3, Census Tract 1201.01, Paulding County, Georgia",1419,542,1290,583,129,163
1500000US132231201021,132231201021,"Block Group 1, Census Tract 1201.02, Paulding County, Georgia",5504,1064,4898,1017,606,405
1500000US132231201022,132231201022,"Block Group 2, Census Tract 1201.02, Paulding County, Georgia",5993,930,5627,951,366,247
1500000US132231201031,132231201031,"Block Group 1, Census Tract 1201.03, Paulding County, Georgia",2665,578,2235,601,430,240
1500000US132231201032,132231201032,"Block Group 2, Census Tract 1201.03, Paulding County, Georgia",6987,749,6066,992,921,621
1500000US132231201041,132231201041,"Block Group 1, Census Tract 1201.04, Paulding County, Georgia",2367,231,2075,200,292,163
1500000US132231202021,132231202021,"Block Group 1, Census Tract 1202.02, Paulding County, Georgia",5187,795,4271,704,916,610
1500000US132231202022,132231202022,"Block Group 2, Census Tract 1202.02, Paulding County, Georgia",2557,507,2046,501,511,244
1500000US132231202031,132231202031,"Block Group 1, Census Tract 1202.03, Paulding County, Georgia",2432,448,1863,354,569,310
1500000US132231202032,132231202032,"Block Group 2, Census Tract 1202.03, Paulding County, Georgia",2621,575,2014,397,607,585
1500000US132231202041,132231202041,"Block Group 1, Census Tract 1202.04, Paulding County, Georgia",3950,540,2316,523,1634,414
1500000US132231202042,132231202042,"Block Group 2, Census Tract 1202.04, Paulding County, Georgia",2711,706,2628,697,83,106
1500000US132231203011,132231203011,"Block Group 1, Census Tract 1203.01, Paulding County, Georgia",3743,606,1813,454,1930,493
1500000US132231203012,132231203012,"Block Group 2, Census Tract 1203.01, Paulding County, Georgia",1546,418,1263,367,283,305
1500000US132231203021,132231203021,"Block Group 1, Census Tract 1203.02, Paulding County, Georgia",2286,1245,1985,1303,301,261
1500000US132231203022,132231203022,"Block Group 2, Census Tract 1203.02, Paulding County, Georgia",3949,913,2059,745,1890,806
1500000US132231203023,132231203023,"Block Group 3, Census Tract 1203.02, Paulding County, Georgia",3845,1316,3066,1236,779,584
1500000US132231203024,132231203024,"Block Group 4, Census Tract 1203.02, Paulding County, Georgia",3740,988,1123,544,2617,1002
1500000US132231203031,132231203031,"Block Group 1, Census Tract 1203.03, Paulding County, Georgia",1833,243,1269,260,564,198
1500000US132231204001,132231204001,"Block Group 1, Census Tract 1204, Paulding County, Georgia",7050,1762,5650,1791,1400,721
1500000US132231204002,132231204002,"Block Group 2, Census Tract 1204, Paulding County, Georgia",5743,786,4403,935,1340,644
1500000US132231204003,132231204003,"Block Group 3, Census Tract 1204, Paulding County, Georgia",1775,545,1360,440,415,402
1500000US132231204004,132231204004,"Block Group 4, Census Tract 1204, Paulding County, Georgia",3735,1058,3264,1047,471,378
1500000US132231205011,132231205011,"Block Group 1, Census Tract 1205.01, Paulding County, Georgia",3706,802,2744,707,962,609
1500000US132231205012,132231205012,"Block Group 2, Census Tract 1205.01, Paulding County, Georgia",2499,447,1638,484,861,418
1500000US132231205021,132231205021,"Block Group 1, Census Tract 1205.02, Paulding County, Georgia",1589,566,897,273,692,527
1500000US132231205022,132231205022,"Block Group 2, Census Tract 1205.02, Paulding County, Georgia",1459,465,1286,445,173,259
1500000US132231205023,132231205023,"Block Group 3, Census Tract 1205.02, Paulding County, Georgia",2899,691,2175,621,724,420
1500000US132231205024,132231205024,"Block Group 4, Census Tract 1205.02, Paulding County, Georgia",1675,600,1272,579,403,484
1500000US132231205025,132231205025,"Block Group 5, Census Tract 1205.02, Paulding County, Georgia",1401,401,1181,387,220,193
1500000US132231205031,132231205031,"Block Group 1, Census Tract 1205.03, Paulding County, Georgia",3938,480,3559,540,379,267
1500000US132231205032,132231205032,"Block Group 2, Census Tract 1205.03, Paulding County, Georgia",1318,373,919,344,399,281
1500000US132231206011,132231206011,"Block Group 1, Census Tract 1206.01, Paulding County, Georgia",2504,568,2326,592,178,123
1500000US132231206012,132231206012,"Block Group 2, Census Tract 1206.01, Paulding County, Georgia",1888,418,1714,410,174,82
1500000US132231206021,132231206021,"Block Group 1, Census Tract 1206.02, Paulding County, Georgia",1035,461,712,248,323,374
1500000US132231206022,132231206022,"Block Group 2, Census Tract 1206.02, Paulding County, Georgia",3506,740,2989,614,517,555
1500000US132231206023,132231206023,"Block Group 3, Census Tract 1206.02, Paulding County, Georgia",1904,591,1812,583,92,115
1500000US132231206024,132231206024,"Block Group 4, Census Tract 1206.02, Paulding County, Georgia",3272,663,3021,690,251,255
1500000US132231206031,132231206031,"Block Group 1, Census Tract 1206.03, Paulding County, Georgia",3578,687,2304,632,1274,352
1500000US132231206032,132231206032,"Block Group 2, Census Tract 1206.03, Paulding County, Georgia",2622,771,2072,671,550,499
1500000US132231206041,132231206041,"Block Group 1, Census Tract 1206.04, Paulding County, Georgia",2501,427,2414,456,87,99
1500000US132231206042,132231206042,"Block Group 2, Census Tract 1206.04, Paulding County, Georgia",3142,415,2724,485,418,224
1500000US132231206051,132231206051,"Block Group 1, Census Tract 1206.05, Paulding County, Georgia",4715,616,3699,506,1016,526
1500000US132231206052,132231206052,"Block Group 2, Census Tract 1206.05, Paulding County, Georgia",1502,452,1347,470,155,134
1500000US132250401011,132250401011,"Block Group 1, Census Tract 401.01, Peach County, Georgia",1695,258,1521,296,174,135
1500000US132250401021,132250401021,"Block Group 1, Census Tract 401.02, Peach County, Georgia",3609,589,2475,586,1134,391
1500000US132250401022,132250401022,"Block Group 2, Census Tract 401.02, Peach County, Georgia",1682,434,1584,426,98,104
1500000US132250401023,132250401023,"Block Group 3, Census Tract 401.02, Peach County, Georgia",3420,632,2780,569,640,295
1500000US132250401024,132250401024,"Block Group 4, Census Tract 401.02, Peach County, Georgia",1303,496,717,283,586,494
1500000US132250402001,132250402001,"Block Group 1, Census Tract 402, Peach County, Georgia",2140,462,1239,388,901,343
1500000US132250402002,132250402002,"Block Group 2, Census Tract 402, Peach County, Georgia",2262,369,1554,350,708,320
1500000US132250403011,132250403011,"Block Group 1, Census Tract 403.01, Peach County, Georgia",1624,309,1342,295,282,155
1500000US132250403012,132250403012,"Block Group 2, Census Tract 403.01, Peach County, Georgia",1016,248,799,243,217,121
1500000US132250403021,132250403021,"Block Group 1, Census Tract 403.02, Peach County, Georgia",2084,290,699,212,1385,276
1500000US132250404001,132250404001,"Block Group 1, Census Tract 404, Peach County, Georgia",2265,337,1405,299,860,304
1500000US132250404002,132250404002,"Block Group 2, Census Tract 404, Peach County, Georgia",1710,318,410,146,1300,307
1500000US132270501001,132270501001,"Block Group 1, Census Tract 501, Pickens County, Georgia",2017,424,1979,420,38,31
1500000US132270501002,132270501002,"Block Group 2, Census Tract 501, Pickens County, Georgia",1747,392,1503,367,244,165
1500000US132270501003,132270501003,"Block Group 3, Census Tract 501, Pickens County, Georgia",1343,327,967,241,376,317
1500000US132270502001,132270502001,"Block Group 1, Census Tract 502, Pickens County, Georgia",1462,418,1077,369,385,213
1500000US132270502002,132270502002,"Block Group 2, Census Tract 502, Pickens County, Georgia",1997,377,1385,367,612,310
1500000US132270502003,132270502003,"Block Group 3, Census Tract 502, Pickens County, Georgia",997,394,470,221,527,341
1500000US132270502004,132270502004,"Block Group 4, Census Tract 502, Pickens County, Georgia",1588,409,1066,445,522,216
1500000US132270503001,132270503001,"Block Group 1, Census Tract 503, Pickens County, Georgia",1761,317,1426,311,335,183
1500000US132270503002,132270503002,"Block Group 2, Census Tract 503, Pickens County, Georgia",2478,413,2173,391,305,229
1500000US132270504001,132270504001,"Block Group 1, Census Tract 504, Pickens County, Georgia",1888,370,1702,353,186,177
1500000US132270504002,132270504002,"Block Group 2, Census Tract 504, Pickens County, Georgia",2014,414,1179,291,835,467
1500000US132270505001,132270505001,"Block Group 1, Census Tract 505, Pickens County, Georgia",1694,392,1017,343,677,292
1500000US132270505002,132270505002,"Block Group 2, Census Tract 505, Pickens County, Georgia",2686,397,2234,354,452,295
1500000US132270506001,132270506001,"Block Group 1, Census Tract 506, Pickens County, Georgia",1750,503,1108,372,642,412
1500000US132270506002,132270506002,"Block Group 2, Census Tract 506, Pickens County, Georgia",518,277,425,254,93,85
1500000US132270506003,132270506003,"Block Group 3, Census Tract 506, Pickens County, Georgia",1741,446,1484,432,257,193
1500000US132270506004,132270506004,"Block Group 4, Census Tract 506, Pickens County, Georgia",1732,501,977,249,755,436
1500000US132299601001,132299601001,"Block Group 1, Census Tract 9601, Pierce County, Georgia",1349,236,988,219,361,190
1500000US132299601002,132299601002,"Block Group 2, Census Tract 9601, Pierce County, Georgia",1283,244,827,202,456,238
1500000US132299602001,132299602001,"Block Group 1, Census Tract 9602, Pierce County, Georgia",988,209,649,178,339,157
1500000US132299602002,132299602002,"Block Group 2, Census Tract 9602, Pierce County, Georgia",899,170,598,125,301,154
1500000US132299603001,132299603001,"Block Group 1, Census Tract 9603, Pierce County, Georgia",2194,383,1706,334,488,266
1500000US132299603002,132299603002,"Block Group 2, Census Tract 9603, Pierce County, Georgia",1424,396,1257,371,167,193
1500000US132299603003,132299603003,"Block Group 3, Census Tract 9603, Pierce County, Georgia",1504,375,567,276,937,380
1500000US132299603004,132299603004,"Block Group 4, Census Tract 9603, Pierce County, Georgia",1425,357,1087,338,338,214
1500000US132299604001,132299604001,"Block Group 1, Census Tract 9604, Pierce County, Georgia",1685,408,1119,363,566,336
1500000US132299604002,132299604002,"Block Group 2, Census Tract 9604, Pierce County, Georgia",1502,358,1366,361,136,117
1500000US132299604003,132299604003,"Block Group 3, Census Tract 9604, Pierce County, Georgia",1383,354,1253,348,130,111
1500000US132299604004,132299604004,"Block Group 4, Census Tract 9604, Pierce County, Georgia",3127,528,2544,532,583,391
1500000US132310101001,132310101001,"Block Group 1, Census Tract 101, Pike County, Georgia",2455,445,2163,444,292,205
1500000US132310101002,132310101002,"Block Group 2, Census Tract 101, Pike County, Georgia",2290,390,1836,345,454,277
1500000US132310101003,132310101003,"Block Group 3, Census Tract 101, Pike County, Georgia",1993,424,1351,349,642,201
1500000US132310102001,132310102001,"Block Group 1, Census Tract 102, Pike County, Georgia",3516,293,3153,328,363,211
1500000US132310103001,132310103001,"Block Group 1, Census Tract 103, Pike County, Georgia",1531,294,1163,272,368,141
1500000US132310103002,132310103002,"Block Group 2, Census Tract 103, Pike County, Georgia",2549,286,2115,286,434,159
1500000US132310104001,132310104001,"Block Group 1, Census Tract 104, Pike County, Georgia",1386,341,1286,348,100,68
1500000US132310104002,132310104002,"Block Group 2, Census Tract 104, Pike County, Georgia",1837,280,1646,308,191,123
1500000US132330101001,132330101001,"Block Group 1, Census Tract 101, Polk County, Georgia",1342,393,931,349,411,190
1500000US132330101002,132330101002,"Block Group 2, Census Tract 101, Polk County, Georgia",852,210,549,141,303,176
1500000US132330101003,132330101003,"Block Group 3, Census Tract 101, Polk County, Georgia",1510,411,1426,407,84,63
1500000US132330101004,132330101004,"Block Group 4, Census Tract 101, Polk County, Georgia",1265,314,1089,315,176,136
1500000US132330102001,132330102001,"Block Group 1, Census Tract 102, Polk County, Georgia",1679,404,1255,414,424,297
1500000US132330102002,132330102002,"Block Group 2, Census Tract 102, Polk County, Georgia",1810,408,1749,405,61,56
1500000US132330102003,132330102003,"Block Group 3, Census Tract 102, Polk County, Georgia",1887,613,1185,586,702,375
1500000US132330102004,132330102004,"Block Group 4, Census Tract 102, Polk County, Georgia",1415,423,948,270,467,341
1500000US132330102005,132330102005,"Block Group 5, Census Tract 102, Polk County, Georgia",1126,516,462,184,664,540
1500000US132330103001,132330103001,"Block Group 1, Census Tract 103, Polk County, Georgia",1428,307,1142,298,286,178
1500000US132330103002,132330103002,"Block Group 2, Census Tract 103, Polk County, Georgia",1318,314,1091,305,227,243
1500000US132330103003,132330103003,"Block Group 3, Census Tract 103, Polk County, Georgia",2152,497,1113,387,1039,530
1500000US132330104001,132330104001,"Block Group 1, Census Tract 104, Polk County, Georgia",1341,356,1001,318,340,190
1500000US132330104002,132330104002,"Block Group 2, Census Tract 104, Polk County, Georgia",1101,381,718,318,383,312
1500000US132330104003,132330104003,"Block Group 3, Census Tract 104, Polk County, Georgia",1351,553,643,480,708,413
1500000US132330104004,132330104004,"Block Group 4, Census Tract 104, Polk County, Georgia",984,358,248,168,736,389
1500000US132330104005,132330104005,"Block Group 5, Census Tract 104, Polk County, Georgia",1355,547,290,165,1065,551
1500000US132330105001,132330105001,"Block Group 1, Census Tract 105, Polk County, Georgia",1517,373,1285,394,232,198
1500000US132330105002,132330105002,"Block Group 2, Census Tract 105, Polk County, Georgia",1065,366,588,296,477,289
1500000US132330105003,132330105003,"Block Group 3, Census Tract 105, Polk County, Georgia",522,309,120,119,402,305
1500000US132330105004,132330105004,"Block Group 4, Census Tract 105, Polk County, Georgia",888,456,301,197,587,438
1500000US132330105005,132330105005,"Block Group 5, Census Tract 105, Polk County, Georgia",711,370,472,329,239,179
1500000US132330105006,132330105006,"Block Group 6, Census Tract 105, Polk County, Georgia",828,250,664,240,164,139
1500000US132330106001,132330106001,"Block Group 1, Census Tract 106, Polk County, Georgia",1194,496,865,480,329,220
1500000US132330106002,132330106002,"Block Group 2, Census Tract 106, Polk County, Georgia",1988,484,1386,387,602,411
1500000US132330106003,132330106003,"Block Group 3, Census Tract 106, Polk County, Georgia",1455,451,1386,440,69,70
1500000US132330106004,132330106004,"Block Group 4, Census Tract 106, Polk County, Georgia",1279,277,1133,297,146,110
1500000US132330107001,132330107001,"Block Group 1, Census Tract 107, Polk County, Georgia",1585,417,1281,360,304,230
1500000US132330107002,132330107002,"Block Group 2, Census Tract 107, Polk County, Georgia",954,394,421,186,533,367
1500000US132330107003,132330107003,"Block Group 3, Census Tract 107, Polk County, Georgia",930,435,588,288,342,316
1500000US132330107004,132330107004,"Block Group 4, Census Tract 107, Polk County, Georgia",1053,374,402,319,651,315
1500000US132330107005,132330107005,"Block Group 5, Census Tract 107, Polk County, Georgia",970,460,446,433,524,288
1500000US132359501001,132359501001,"Block Group 1, Census Tract 9501, Pulaski County, Georgia",797,271,522,227,275,233
1500000US132359501002,132359501002,"Block Group 2, Census Tract 9501, Pulaski County, Georgia",767,204,591,184,176,103
1500000US132359502001,132359502001,"Block Group 1, Census Tract 9502, Pulaski County, Georgia",1373,312,1126,278,247,151
1500000US132359502002,132359502002,"Block Group 2, Census Tract 9502, Pulaski County, Georgia",702,432,281,273,421,407
1500000US132359502003,132359502003,"Block Group 3, Census Tract 9502, Pulaski County, Georgia",941,373,123,127,818,366
1500000US132359502004,132359502004,"Block Group 4, Census Tract 9502, Pulaski County, Georgia",1013,376,315,171,698,365
1500000US132359502005,132359502005,"Block Group 5, Census Tract 9502, Pulaski County, Georgia",1098,414,709,359,389,222
1500000US132359502006,132359502006,"Block Group 6, Census Tract 9502, Pulaski County, Georgia",1906,500,1113,372,793,452
1500000US132359503001,132359503001,"Block Group 1, Census Tract 9503, Pulaski County, Georgia",1454,248,1197,251,257,127
1500000US132379601011,132379601011,"Block Group 1, Census Tract 9601.01, Putnam County, Georgia",1047,224,934,211,113,83
1500000US132379601012,132379601012,"Block Group 2, Census Tract 9601.01, Putnam County, Georgia",764,362,468,198,296,304
1500000US132379601013,132379601013,"Block Group 3, Census Tract 9601.01, Putnam County, Georgia",1402,270,958,301,444,209
1500000US132379601021,132379601021,"Block Group 1, Census Tract 9601.02, Putnam County, Georgia",2615,526,2171,513,444,225
1500000US132379601022,132379601022,"Block Group 2, Census Tract 9601.02, Putnam County, Georgia",2881,522,2386,491,495,304
1500000US132379602011,132379602011,"Block Group 1, Census Tract 9602.01, Putnam County, Georgia",1131,289,875,294,256,149
1500000US132379602021,132379602021,"Block Group 1, Census Tract 9602.02, Putnam County, Georgia",867,411,542,423,325,336
1500000US132379602022,132379602022,"Block Group 2, Census Tract 9602.02, Putnam County, Georgia",1907,479,1353,431,554,338
1500000US132379602023,132379602023,"Block Group 3, Census Tract 9602.02, Putnam County, Georgia",910,368,636,253,274,287
1500000US132379602024,132379602024,"Block Group 4, Census Tract 9602.02, Putnam County, Georgia",1024,427,585,300,439,327
1500000US132379602025,132379602025,"Block Group 5, Census Tract 9602.02, Putnam County, Georgia",1105,480,434,258,671,485
1500000US132379602026,132379602026,"Block Group 6, Census Tract 9602.02, Putnam County, Georgia",555,289,346,178,209,246
1500000US132379602027,132379602027,"Block Group 7, Census Tract 9602.02, Putnam County, Georgia",582,155,554,159,28,34
1500000US132379603001,132379603001,"Block Group 1, Census Tract 9603, Putnam County, Georgia",1355,375,1212,413,143,132
1500000US132379603002,132379603002,"Block Group 2, Census Tract 9603, Putnam County, Georgia",715,315,610,285,105,140
1500000US132379603003,132379603003,"Block Group 3, Census Tract 9603, Putnam County, Georgia",581,229,410,206,171,154
1500000US132379603004,132379603004,"Block Group 4, Census Tract 9603, Putnam County, Georgia",1614,461,1293,416,321,242
1500000US132399603001,132399603001,"Block Group 1, Census Tract 9603, Quitman County, Georgia",1181,207,877,207,304,129
1500000US132399603002,132399603002,"Block Group 2, Census Tract 9603, Quitman County, Georgia",1145,191,813,181,332,150
1500000US132419701001,132419701001,"Block Group 1, Census Tract 9701, Rabun County, Georgia",510,115,423,101,87,74
1500000US132419701002,132419701002,"Block Group 2, Census Tract 9701, Rabun County, Georgia",2031,326,1150,261,881,286
1500000US132419701003,132419701003,"Block Group 3, Census Tract 9701, Rabun County, Georgia",1549,370,1245,348,304,209
1500000US132419701004,132419701004,"Block Group 4, Census Tract 9701, Rabun County, Georgia",1369,284,827,294,542,217
1500000US132419702011,132419702011,"Block Group 1, Census Tract 9702.01, Rabun County, Georgia",1866,315,1067,284,799,254
1500000US132419702012,132419702012,"Block Group 2, Census Tract 9702.01, Rabun County, Georgia",470,178,462,178,8,12
1500000US132419702013,132419702013,"Block Group 3, Census Tract 9702.01, Rabun County, Georgia",833,196,739,207,94,58
1500000US132419702021,132419702021,"Block Group 1, Census Tract 9702.02, Rabun County, Georgia",1158,233,957,245,201,110
1500000US132419702022,132419702022,"Block Group 2, Census Tract 9702.02, Rabun County, Georgia",1335,294,926,244,409,242
1500000US132419703011,132419703011,"Block Group 1, Census Tract 9703.01, Rabun County, Georgia",484,170,484,170,0,13
1500000US132419703012,132419703012,"Block Group 2, Census Tract 9703.01, Rabun County, Georgia",671,250,568,246,103,78
1500000US132419703013,132419703013,"Block Group 3, Census Tract 9703.01, Rabun County, Georgia",1998,322,1627,262,371,175
1500000US132419703021,132419703021,"Block Group 1, Census Tract 9703.02, Rabun County, Georgia",1618,290,1221,267,397,206
1500000US132437901001,132437901001,"Block Group 1, Census Tract 7901, Randolph County, Georgia",1162,260,1008,259,154,120
1500000US132437901002,132437901002,"Block Group 2, Census Tract 7901, Randolph County, Georgia",615,196,436,178,179,100
1500000US132437902001,132437902001,"Block Group 1, Census Tract 7902, Randolph County, Georgia",839,343,666,303,173,240
1500000US132437902002,132437902002,"Block Group 2, Census Tract 7902, Randolph County, Georgia",1207,459,639,236,568,368
1500000US132437902003,132437902003,"Block Group 3, Census Tract 7902, Randolph County, Georgia",1115,379,871,394,244,156
1500000US132437902004,132437902004,"Block Group 4, Census Tract 7902, Randolph County, Georgia",1678,468,366,204,1312,502
1500000US132437902005,132437902005,"Block Group 5, Census Tract 7902, Randolph County, Georgia",492,286,253,171,239,236
1500000US132450001001,132450001001,"Block Group 1, Census Tract 1, Richmond County, Georgia",705,232,464,154,241,172
1500000US132450001002,132450001002,"Block Group 2, Census Tract 1, Richmond County, Georgia",1337,302,802,266,535,277
1500000US132450001003,132450001003,"Block Group 3, Census Tract 1, Richmond County, Georgia",682,157,265,102,417,129
1500000US132450001004,132450001004,"Block Group 4, Census Tract 1, Richmond County, Georgia",579,258,238,142,341,240
1500000US132450001005,132450001005,"Block Group 5, Census Tract 1, Richmond County, Georgia",616,232,493,223,123,93
1500000US132450002001,132450002001,"Block Group 1, Census Tract 2, Richmond County, Georgia",951,261,451,221,500,219
1500000US132450002002,132450002002,"Block Group 2, Census Tract 2, Richmond County, Georgia",606,236,26,54,580,228
1500000US132450002003,132450002003,"Block Group 3, Census Tract 2, Richmond County, Georgia",750,288,169,128,581,279
1500000US132450003001,132450003001,"Block Group 1, Census Tract 3, Richmond County, Georgia",383,126,110,113,273,106
1500000US132450003002,132450003002,"Block Group 2, Census Tract 3, Richmond County, Georgia",581,165,246,150,335,134
1500000US132450006001,132450006001,"Block Group 1, Census Tract 6, Richmond County, Georgia",645,186,285,216,360,130
1500000US132450006002,132450006002,"Block Group 2, Census Tract 6, Richmond County, Georgia",1037,297,72,75,965,336
1500000US132450006003,132450006003,"Block Group 3, Census Tract 6, Richmond County, Georgia",553,212,177,111,376,178
1500000US132450007001,132450007001,"Block Group 1, Census Tract 7, Richmond County, Georgia",577,243,162,77,415,248
1500000US132450007002,132450007002,"Block Group 2, Census Tract 7, Richmond County, Georgia",391,130,249,114,142,86
1500000US132450009001,132450009001,"Block Group 1, Census Tract 9, Richmond County, Georgia",616,195,123,89,493,188
1500000US132450009002,132450009002,"Block Group 2, Census Tract 9, Richmond County, Georgia",0,13,0,13,0,13
1500000US132450009003,132450009003,"Block Group 3, Census Tract 9, Richmond County, Georgia",499,141,201,110,298,126
1500000US132450010001,132450010001,"Block Group 1, Census Tract 10, Richmond County, Georgia",645,391,92,64,553,391
1500000US132450010002,132450010002,"Block Group 2, Census Tract 10, Richmond County, Georgia",585,178,208,96,377,157
1500000US132450010003,132450010003,"Block Group 3, Census Tract 10, Richmond County, Georgia",768,206,416,135,352,161
1500000US132450010004,132450010004,"Block Group 4, Census Tract 10, Richmond County, Georgia",201,145,84,125,117,85
1500000US132450011001,132450011001,"Block Group 1, Census Tract 11, Richmond County, Georgia",1077,182,754,183,323,99
1500000US132450011002,132450011002,"Block Group 2, Census Tract 11, Richmond County, Georgia",724,127,614,130,110,56
1500000US132450012001,132450012001,"Block Group 1, Census Tract 12, Richmond County, Georgia",308,227,78,97,230,208
1500000US132450012002,132450012002,"Block Group 2, Census Tract 12, Richmond County, Georgia",678,245,532,247,146,125
1500000US132450012003,132450012003,"Block Group 3, Census Tract 12, Richmond County, Georgia",843,310,223,121,620,318
1500000US132450012004,132450012004,"Block Group 4, Census Tract 12, Richmond County, Georgia",326,130,245,129,81,77
1500000US132450012005,132450012005,"Block Group 5, Census Tract 12, Richmond County, Georgia",1404,526,569,266,835,442
1500000US132450012006,132450012006,"Block Group 6, Census Tract 12, Richmond County, Georgia",629,291,173,117,456,308
1500000US132450013001,132450013001,"Block Group 1, Census Tract 13, Richmond County, Georgia",798,178,635,160,163,94
1500000US132450013002,132450013002,"Block Group 2, Census Tract 13, Richmond County, Georgia",758,193,577,200,181,76
1500000US132450014001,132450014001,"Block Group 1, Census Tract 14, Richmond County, Georgia",428,156,84,69,344,144
1500000US132450014002,132450014002,"Block Group 2, Census Tract 14, Richmond County, Georgia",628,160,294,90,334,129
1500000US132450014003,132450014003,"Block Group 3, Census Tract 14, Richmond County, Georgia",801,286,116,98,685,272
1500000US132450015001,132450015001,"Block Group 1, Census Tract 15, Richmond County, Georgia",180,85,66,49,114,70
1500000US132450015002,132450015002,"Block Group 2, Census Tract 15, Richmond County, Georgia",580,167,144,77,436,166
1500000US132450016011,132450016011,"Block Group 1, Census Tract 16.01, Richmond County, Georgia",1996,604,408,303,1588,632
1500000US132450016012,132450016012,"Block Group 2, Census Tract 16.01, Richmond County, Georgia",1674,604,634,329,1040,532
1500000US132450016013,132450016013,"Block Group 3, Census Tract 16.01, Richmond County, Georgia",368,256,113,113,255,229
1500000US132450016021,132450016021,"Block Group 1, Census Tract 16.02, Richmond County, Georgia",1916,338,1399,302,517,230
1500000US132450016022,132450016022,"Block Group 2, Census Tract 16.02, Richmond County, Georgia",905,227,852,231,53,81
1500000US132450016023,132450016023,"Block Group 3, Census Tract 16.02, Richmond County, Georgia",1129,287,539,247,590,190
1500000US132450101011,132450101011,"Block Group 1, Census Tract 101.01, Richmond County, Georgia",1835,281,1291,256,544,253
1500000US132450101012,132450101012,"Block Group 2, Census Tract 101.01, Richmond County, Georgia",1598,496,673,405,925,287
1500000US132450101041,132450101041,"Block Group 1, Census Tract 101.04, Richmond County, Georgia",1996,638,664,263,1332,633
1500000US132450101042,132450101042,"Block Group 2, Census Tract 101.04, Richmond County, Georgia",887,300,439,255,448,172
1500000US132450101043,132450101043,"Block Group 3, Census Tract 101.04, Richmond County, Georgia",1044,389,661,193,383,362
1500000US132450101051,132450101051,"Block Group 1, Census Tract 101.05, Richmond County, Georgia",871,283,585,213,286,218
1500000US132450101052,132450101052,"Block Group 2, Census Tract 101.05, Richmond County, Georgia",2196,499,1623,354,573,439
1500000US132450101053,132450101053,"Block Group 3, Census Tract 101.05, Richmond County, Georgia",1707,406,727,277,980,361
1500000US132450101061,132450101061,"Block Group 1, Census Tract 101.06, Richmond County, Georgia",836,280,729,275,107,90
1500000US132450101062,132450101062,"Block Group 2, Census Tract 101.06, Richmond County, Georgia",2133,422,518,220,1615,401
1500000US132450101063,132450101063,"Block Group 3, Census Tract 101.06, Richmond County, Georgia",2051,619,353,357,1698,648
1500000US132450101071,132450101071,"Block Group 1, Census Tract 101.07, Richmond County, Georgia",1247,344,244,97,1003,334
1500000US132450101072,132450101072,"Block Group 2, Census Tract 101.07, Richmond County, Georgia",1215,387,456,123,759,369
1500000US132450102011,132450102011,"Block Group 1, Census Tract 102.01, Richmond County, Georgia",1694,399,1115,267,579,347
1500000US132450102012,132450102012,"Block Group 2, Census Tract 102.01, Richmond County, Georgia",664,214,546,168,118,138
1500000US132450102013,132450102013,"Block Group 3, Census Tract 102.01, Richmond County, Georgia",2105,490,1640,379,465,300
1500000US132450102031,132450102031,"Block Group 1, Census Tract 102.03, Richmond County, Georgia",1347,343,539,160,808,320
1500000US132450102032,132450102032,"Block Group 2, Census Tract 102.03, Richmond County, Georgia",1667,397,1013,366,654,208
1500000US132450102033,132450102033,"Block Group 3, Census Tract 102.03, Richmond County, Georgia",1113,243,446,176,667,227
1500000US132450102041,132450102041,"Block Group 1, Census Tract 102.04, Richmond County, Georgia",6491,1333,5161,1179,1330,834
1500000US132450102042,132450102042,"Block Group 2, Census Tract 102.04, Richmond County, Georgia",796,318,76,80,720,308
1500000US132450102043,132450102043,"Block Group 3, Census Tract 102.04, Richmond County, Georgia",3463,912,1383,643,2080,586
1500000US132450102044,132450102044,"Block Group 4, Census Tract 102.04, Richmond County, Georgia",2108,509,1249,489,859,468
1500000US132450103001,132450103001,"Block Group 1, Census Tract 103, Richmond County, Georgia",1462,585,176,238,1286,542
1500000US132450103002,132450103002,"Block Group 2, Census Tract 103, Richmond County, Georgia",433,286,238,205,195,275
1500000US132450103003,132450103003,"Block Group 3, Census Tract 103, Richmond County, Georgia",2224,651,1359,612,865,503
1500000US132450103004,132450103004,"Block Group 4, Census Tract 103, Richmond County, Georgia",485,210,92,117,393,205
1500000US132450103005,132450103005,"Block Group 5, Census Tract 103, Richmond County, Georgia",612,394,348,344,264,237
1500000US132450104001,132450104001,"Block Group 1, Census Tract 104, Richmond County, Georgia",964,331,391,209,573,286
1500000US132450104002,132450104002,"Block Group 2, Census Tract 104, Richmond County, Georgia",854,390,270,172,584,377
1500000US132450104003,132450104003,"Block Group 3, Census Tract 104, Richmond County, Georgia",732,266,8,12,724,266
1500000US132450104004,132450104004,"Block Group 4, Census Tract 104, Richmond County, Georgia",712,204,410,132,302,222
1500000US132450104005,132450104005,"Block Group 5, Census Tract 104, Richmond County, Georgia",1037,435,367,275,670,364
1500000US132450105041,132450105041,"Block Group 1, Census Tract 105.04, Richmond County, Georgia",2156,529,955,438,1201,515
1500000US132450105042,132450105042,"Block Group 2, Census Tract 105.04, Richmond County, Georgia",2764,797,728,402,2036,801
1500000US132450105043,132450105043,"Block Group 3, Census Tract 105.04, Richmond County, Georgia",810,361,550,241,260,292
1500000US132450105044,132450105044,"Block Group 4, Census Tract 105.04, Richmond County, Georgia",1424,506,669,326,755,364
1500000US132450105061,132450105061,"Block Group 1, Census Tract 105.06, Richmond County, Georgia",1748,479,269,124,1479,454
1500000US132450105062,132450105062,"Block Group 2, Census Tract 105.06, Richmond County, Georgia",1178,354,509,205,669,327
1500000US132450105063,132450105063,"Block Group 3, Census Tract 105.06, Richmond County, Georgia",1971,434,1019,285,952,412
1500000US132450105071,132450105071,"Block Group 1, Census Tract 105.07, Richmond County, Georgia",1422,586,674,474,748,457
1500000US132450105072,132450105072,"Block Group 2, Census Tract 105.07, Richmond County, Georgia",951,380,479,257,472,319
1500000US132450105073,132450105073,"Block Group 3, Census Tract 105.07, Richmond County, Georgia",2899,683,1497,496,1402,804
1500000US132450105074,132450105074,"Block Group 4, Census Tract 105.07, Richmond County, Georgia",394,219,191,145,203,155
1500000US132450105081,132450105081,"Block Group 1, Census Tract 105.08, Richmond County, Georgia",3036,674,1266,372,1770,700
1500000US132450105082,132450105082,"Block Group 2, Census Tract 105.08, Richmond County, Georgia",1264,393,632,297,632,297
1500000US132450105091,132450105091,"Block Group 1, Census Tract 105.09, Richmond County, Georgia",1144,201,945,213,199,98
1500000US132450105092,132450105092,"Block Group 2, Census Tract 105.09, Richmond County, Georgia",2939,485,1278,320,1661,435
1500000US132450105101,132450105101,"Block Group 1, Census Tract 105.10, Richmond County, Georgia",1049,344,628,215,421,306
1500000US132450105102,132450105102,"Block Group 2, Census Tract 105.10, Richmond County, Georgia",357,128,271,118,86,65
1500000US132450105103,132450105103,"Block Group 3, Census Tract 105.10, Richmond County, Georgia",2208,399,1115,300,1093,413
1500000US132450105104,132450105104,"Block Group 4, Census Tract 105.10, Richmond County, Georgia",1311,409,806,254,505,337
1500000US132450105111,132450105111,"Block Group 1, Census Tract 105.11, Richmond County, Georgia",2062,462,1025,298,1037,459
1500000US132450105112,132450105112,"Block Group 2, Census Tract 105.11, Richmond County, Georgia",1451,278,648,229,803,260
1500000US132450105121,132450105121,"Block Group 1, Census Tract 105.12, Richmond County, Georgia",1339,450,810,311,529,369
1500000US132450105122,132450105122,"Block Group 2, Census Tract 105.12, Richmond County, Georgia",1533,465,768,283,765,450
1500000US132450105123,132450105123,"Block Group 3, Census Tract 105.12, Richmond County, Georgia",1568,435,620,251,948,375
1500000US132450105131,132450105131,"Block Group 1, Census Tract 105.13, Richmond County, Georgia",1999,378,1276,345,723,236
1500000US132450105132,132450105132,"Block Group 2, Census Tract 105.13, Richmond County, Georgia",1097,441,706,333,391,318
1500000US132450106001,132450106001,"Block Group 1, Census Tract 106, Richmond County, Georgia",853,272,255,146,598,242
1500000US132450106002,132450106002,"Block Group 2, Census Tract 106, Richmond County, Georgia",841,286,655,211,186,164
1500000US132450106003,132450106003,"Block Group 3, Census Tract 106, Richmond County, Georgia",1799,340,631,201,1168,332
1500000US132450106004,132450106004,"Block Group 4, Census Tract 106, Richmond County, Georgia",848,314,195,123,653,303
1500000US132450107061,132450107061,"Block Group 1, Census Tract 107.06, Richmond County, Georgia",1828,369,1332,339,496,281
1500000US132450107062,132450107062,"Block Group 2, Census Tract 107.06, Richmond County, Georgia",1712,630,827,280,885,634
1500000US132450107063,132450107063,"Block Group 3, Census Tract 107.06, Richmond County, Georgia",1305,349,629,266,676,410
1500000US132450107071,132450107071,"Block Group 1, Census Tract 107.07, Richmond County, Georgia",2436,461,1199,386,1237,453
1500000US132450107072,132450107072,"Block Group 2, Census Tract 107.07, Richmond County, Georgia",470,168,216,86,254,172
1500000US132450107081,132450107081,"Block Group 1, Census Tract 107.08, Richmond County, Georgia",2038,574,1162,358,876,510
1500000US132450107082,132450107082,"Block Group 2, Census Tract 107.08, Richmond County, Georgia",1484,447,921,451,563,281
1500000US132450107083,132450107083,"Block Group 3, Census Tract 107.08, Richmond County, Georgia",2136,671,1267,645,869,321
1500000US132450107091,132450107091,"Block Group 1, Census Tract 107.09, Richmond County, Georgia",3390,707,2532,708,858,501
1500000US132450107092,132450107092,"Block Group 2, Census Tract 107.09, Richmond County, Georgia",2681,527,1449,264,1232,541
1500000US132450107101,132450107101,"Block Group 1, Census Tract 107.10, Richmond County, Georgia",1373,422,937,393,436,286
1500000US132450107102,132450107102,"Block Group 2, Census Tract 107.10, Richmond County, Georgia",1321,486,432,206,889,516
1500000US132450107103,132450107103,"Block Group 3, Census Tract 107.10, Richmond County, Georgia",3101,825,1412,423,1689,741
1500000US132450107111,132450107111,"Block Group 1, Census Tract 107.11, Richmond County, Georgia",1253,376,960,326,293,247
1500000US132450107112,132450107112,"Block Group 2, Census Tract 107.11, Richmond County, Georgia",1655,442,1192,355,463,338
1500000US132450107121,132450107121,"Block Group 1, Census Tract 107.12, Richmond County, Georgia",2278,616,1510,528,768,469
1500000US132450107122,132450107122,"Block Group 2, Census Tract 107.12, Richmond County, Georgia",3405,649,2538,633,867,342
1500000US132450107123,132450107123,"Block Group 3, Census Tract 107.12, Richmond County, Georgia",3036,676,2382,640,654,513
1500000US132450108001,132450108001,"Block Group 1, Census Tract 108, Richmond County, Georgia",0,13,0,13,0,13
1500000US132450108002,132450108002,"Block Group 2, Census Tract 108, Richmond County, Georgia",3123,377,0,13,3123,377
1500000US132450108003,132450108003,"Block Group 3, Census Tract 108, Richmond County, Georgia",0,13,0,13,0,13
1500000US132450108004,132450108004,"Block Group 4, Census Tract 108, Richmond County, Georgia",1194,338,15,23,1179,341
1500000US132450109031,132450109031,"Block Group 1, Census Tract 109.03, Richmond County, Georgia",2244,425,1873,405,371,167
1500000US132450109032,132450109032,"Block Group 2, Census Tract 109.03, Richmond County, Georgia",2934,352,2378,349,556,271
1500000US132450109041,132450109041,"Block Group 1, Census Tract 109.04, Richmond County, Georgia",884,254,525,207,359,214
1500000US132450109042,132450109042,"Block Group 2, Census Tract 109.04, Richmond County, Georgia",2542,404,1762,436,780,348
1500000US132450109051,132450109051,"Block Group 1, Census Tract 109.05, Richmond County, Georgia",1172,313,1103,314,69,67
1500000US132450109052,132450109052,"Block Group 2, Census Tract 109.05, Richmond County, Georgia",2051,529,1831,539,220,180
1500000US132450109053,132450109053,"Block Group 3, Census Tract 109.05, Richmond County, Georgia",1845,647,1165,401,680,568
1500000US132450109061,132450109061,"Block Group 1, Census Tract 109.06, Richmond County, Georgia",855,309,813,304,42,82
1500000US132450109062,132450109062,"Block Group 2, Census Tract 109.06, Richmond County, Georgia",3050,758,1828,555,1222,642
1500000US132450109063,132450109063,"Block Group 3, Census Tract 109.06, Richmond County, Georgia",3274,553,2482,557,792,336
1500000US132450110001,132450110001,"Block Group 1, Census Tract 110, Richmond County, Georgia",372,125,43,32,329,126
1500000US132450110002,132450110002,"Block Group 2, Census Tract 110, Richmond County, Georgia",888,164,157,99,731,144
1500000US132470601011,132470601011,"Block Group 1, Census Tract 601.01, Rockdale County, Georgia",828,223,604,206,224,136
1500000US132470601012,132470601012,"Block Group 2, Census Tract 601.01, Rockdale County, Georgia",1016,397,555,203,461,397
1500000US132470601013,132470601013,"Block Group 3, Census Tract 601.01, Rockdale County, Georgia",1424,321,1116,233,308,272
1500000US132470601021,132470601021,"Block Group 1, Census Tract 601.02, Rockdale County, Georgia",1122,361,923,362,199,293
1500000US132470601022,132470601022,"Block Group 2, Census Tract 601.02, Rockdale County, Georgia",852,320,604,311,248,189
1500000US132470601023,132470601023,"Block Group 3, Census Tract 601.02, Rockdale County, Georgia",3281,598,2231,566,1050,452
1500000US132470602011,132470602011,"Block Group 1, Census Tract 602.01, Rockdale County, Georgia",2819,501,1112,472,1707,452
1500000US132470602012,132470602012,"Block Group 2, Census Tract 602.01, Rockdale County, Georgia",1224,375,1118,381,106,90
1500000US132470602013,132470602013,"Block Group 3, Census Tract 602.01, Rockdale County, Georgia",635,180,610,176,25,40
1500000US132470602021,132470602021,"Block Group 1, Census Tract 602.02, Rockdale County, Georgia",2471,610,790,295,1681,585
1500000US132470602022,132470602022,"Block Group 2, Census Tract 602.02, Rockdale County, Georgia",2444,607,1993,498,451,449
1500000US132470602023,132470602023,"Block Group 3, Census Tract 602.02, Rockdale County, Georgia",1912,466,1703,505,209,287
1500000US132470602024,132470602024,"Block Group 4, Census Tract 602.02, Rockdale County, Georgia",3011,538,2518,530,493,294
1500000US132470603041,132470603041,"Block Group 1, Census Tract 603.04, Rockdale County, Georgia",637,351,73,60,564,359
1500000US132470603042,132470603042,"Block Group 2, Census Tract 603.04, Rockdale County, Georgia",1318,369,1005,322,313,217
1500000US132470603043,132470603043,"Block Group 3, Census Tract 603.04, Rockdale County, Georgia",1915,551,829,286,1086,536
1500000US132470603044,132470603044,"Block Group 4, Census Tract 603.04, Rockdale County, Georgia",1330,674,433,276,897,620
1500000US132470603051,132470603051,"Block Group 1, Census Tract 603.05, Rockdale County, Georgia",1029,333,491,217,538,259
1500000US132470603052,132470603052,"Block Group 2, Census Tract 603.05, Rockdale County, Georgia",1941,478,101,56,1840,479
1500000US132470603053,132470603053,"Block Group 3, Census Tract 603.05, Rockdale County, Georgia",2351,448,1068,248,1283,408
1500000US132470603061,132470603061,"Block Group 1, Census Tract 603.06, Rockdale County, Georgia",3090,373,2625,360,465,256
1500000US132470603071,132470603071,"Block Group 1, Census Tract 603.07, Rockdale County, Georgia",2477,710,1149,435,1328,637
1500000US132470603072,132470603072,"Block Group 2, Census Tract 603.07, Rockdale County, Georgia",2329,487,2295,496,34,56
1500000US132470603073,132470603073,"Block Group 3, Census Tract 603.07, Rockdale County, Georgia",4276,816,3209,662,1067,602
1500000US132470603074,132470603074,"Block Group 4, Census Tract 603.07, Rockdale County, Georgia",1301,382,1222,375,79,83
1500000US132470603081,132470603081,"Block Group 1, Census Tract 603.08, Rockdale County, Georgia",3743,853,2386,759,1357,439
1500000US132470603082,132470603082,"Block Group 2, Census Tract 603.08, Rockdale County, Georgia",1840,476,261,116,1579,474
1500000US132470603083,132470603083,"Block Group 3, Census Tract 603.08, Rockdale County, Georgia",2666,678,677,392,1989,621
1500000US132470603091,132470603091,"Block Group 1, Census Tract 603.09, Rockdale County, Georgia",1067,226,867,230,200,186
1500000US132470603092,132470603092,"Block Group 2, Census Tract 603.09, Rockdale County, Georgia",1827,461,774,223,1053,450
1500000US132470603093,132470603093,"Block Group 3, Census Tract 603.09, Rockdale County, Georgia",2384,521,1193,286,1191,480
1500000US132470604031,132470604031,"Block Group 1, Census Tract 604.03, Rockdale County, Georgia",1900,343,1711,369,189,175
1500000US132470604032,132470604032,"Block Group 2, Census Tract 604.03, Rockdale County, Georgia",561,185,420,184,141,86
1500000US132470604033,132470604033,"Block Group 3, Census Tract 604.03, Rockdale County, Georgia",1030,231,835,227,195,185
1500000US132470604041,132470604041,"Block Group 1, Census Tract 604.04, Rockdale County, Georgia",2696,576,1747,459,949,526
1500000US132470604042,132470604042,"Block Group 2, Census Tract 604.04, Rockdale County, Georgia",1386,406,1201,399,185,144
1500000US132470604043,132470604043,"Block Group 3, Census Tract 604.04, Rockdale County, Georgia",1923,372,1864,382,59,60
1500000US132470604051,132470604051,"Block Group 1, Census Tract 604.05, Rockdale County, Georgia",2806,516,2490,551,316,264
1500000US132470604052,132470604052,"Block Group 2, Census Tract 604.05, Rockdale County, Georgia",2995,812,2524,716,471,464
1500000US132470604053,132470604053,"Block Group 3, Census Tract 604.05, Rockdale County, Georgia",1369,463,1349,465,20,33
1500000US132470604061,132470604061,"Block Group 1, Census Tract 604.06, Rockdale County, Georgia",1139,377,1054,374,85,85
1500000US132470604062,132470604062,"Block Group 2, Census Tract 604.06, Rockdale County, Georgia",2772,398,1989,421,783,372
1500000US132470604063,132470604063,"Block Group 3, Census Tract 604.06, Rockdale County, Georgia",1752,449,1520,424,232,253
1500000US132470604071,132470604071,"Block Group 1, Census Tract 604.07, Rockdale County, Georgia",1281,247,1054,269,227,111
1500000US132470604072,132470604072,"Block Group 2, Census Tract 604.07, Rockdale County, Georgia",1177,303,856,258,321,228
1500000US132470604073,132470604073,"Block Group 3, Census Tract 604.07, Rockdale County, Georgia",758,212,671,245,87,131
1500000US132499601001,132499601001,"Block Group 1, Census Tract 9601, Schley County, Georgia",1280,201,732,177,548,130
1500000US132499601002,132499601002,"Block Group 2, Census Tract 9601, Schley County, Georgia",1686,247,1160,270,526,209
1500000US132499602001,132499602001,"Block Group 1, Census Tract 9602, Schley County, Georgia",2104,160,1344,215,760,215
1500000US132519702001,132519702001,"Block Group 1, Census Tract 9702, Screven County, Georgia",1146,195,941,195,205,119
1500000US132519702002,132519702002,"Block Group 2, Census Tract 9702, Screven County, Georgia",685,234,505,229,180,134
1500000US132519703001,132519703001,"Block Group 1, Census Tract 9703, Screven County, Georgia",804,199,657,191,147,101
1500000US132519703002,132519703002,"Block Group 2, Census Tract 9703, Screven County, Georgia",1031,358,900,339,131,129
1500000US132519703003,132519703003,"Block Group 3, Census Tract 9703, Screven County, Georgia",847,270,545,235,302,153
1500000US132519703004,132519703004,"Block Group 4, Census Tract 9703, Screven County, Georgia",373,130,156,81,217,134
1500000US132519704001,132519704001,"Block Group 1, Census Tract 9704, Screven County, Georgia",993,238,920,225,73,77
1500000US132519704002,132519704002,"Block Group 2, Census Tract 9704, Screven County, Georgia",1556,396,832,307,724,312
1500000US132519704003,132519704003,"Block Group 3, Census Tract 9704, Screven County, Georgia",859,233,370,193,489,226
1500000US132519704004,132519704004,"Block Group 4, Census Tract 9704, Screven County, Georgia",1098,223,679,209,419,138
1500000US132519705001,132519705001,"Block Group 1, Census Tract 9705, Screven County, Georgia",1702,262,1318,271,384,152
1500000US132519705002,132519705002,"Block Group 2, Census Tract 9705, Screven County, Georgia",987,250,823,250,164,106
1500000US132519706001,132519706001,"Block Group 1, Census Tract 9706, Screven County, Georgia",1039,294,881,285,158,126
1500000US132519706002,132519706002,"Block Group 2, Census Tract 9706, Screven County, Georgia",682,125,517,107,165,80
1500000US132532001001,132532001001,"Block Group 1, Census Tract 2001, Seminole County, Georgia",831,266,627,227,204,180
1500000US132532001002,132532001002,"Block Group 2, Census Tract 2001, Seminole County, Georgia",835,179,620,136,215,133
1500000US132532001003,132532001003,"Block Group 3, Census Tract 2001, Seminole County, Georgia",837,235,763,220,74,52
1500000US132532002001,132532002001,"Block Group 1, Census Tract 2002, Seminole County, Georgia",1871,313,912,285,959,308
1500000US132532002002,132532002002,"Block Group 2, Census Tract 2002, Seminole County, Georgia",891,274,606,231,285,154
1500000US132532002003,132532002003,"Block Group 3, Census Tract 2002, Seminole County, Georgia",875,253,727,224,148,98
1500000US132532003001,132532003001,"Block Group 1, Census Tract 2003, Seminole County, Georgia",1023,241,651,195,372,217
1500000US132532003002,132532003002,"Block Group 2, Census Tract 2003, Seminole County, Georgia",390,157,345,140,45,69
1500000US132532003003,132532003003,"Block Group 3, Census Tract 2003, Seminole County, Georgia",1110,233,923,222,187,115
1500000US132551601001,132551601001,"Block Group 1, Census Tract 1601, Spalding County, Georgia",3007,457,2390,505,617,336
1500000US132551601002,132551601002,"Block Group 2, Census Tract 1601, Spalding County, Georgia",956,332,856,317,100,105
1500000US132551601003,132551601003,"Block Group 3, Census Tract 1601, Spalding County, Georgia",1810,644,725,323,1085,618
1500000US132551602001,132551602001,"Block Group 1, Census Tract 1602, Spalding County, Georgia",1567,597,1457,609,110,92
1500000US132551602002,132551602002,"Block Group 2, Census Tract 1602, Spalding County, Georgia",1660,389,1390,381,270,174
1500000US132551602003,132551602003,"Block Group 3, Census Tract 1602, Spalding County, Georgia",3045,525,2440,456,605,344
1500000US132551603001,132551603001,"Block Group 1, Census Tract 1603, Spalding County, Georgia",1484,356,1199,279,285,220
1500000US132551603002,132551603002,"Block Group 2, Census Tract 1603, Spalding County, Georgia",1719,374,821,259,898,284
1500000US132551604001,132551604001,"Block Group 1, Census Tract 1604, Spalding County, Georgia",1868,536,720,256,1148,486
1500000US132551604002,132551604002,"Block Group 2, Census Tract 1604, Spalding County, Georgia",1246,549,474,314,772,619
1500000US132551604003,132551604003,"Block Group 3, Census Tract 1604, Spalding County, Georgia",914,443,11,19,903,442
1500000US132551604004,132551604004,"Block Group 4, Census Tract 1604, Spalding County, Georgia",327,312,208,303,119,109
1500000US132551604005,132551604005,"Block Group 5, Census Tract 1604, Spalding County, Georgia",1070,380,239,168,831,357
1500000US132551605001,132551605001,"Block Group 1, Census Tract 1605, Spalding County, Georgia",3637,725,2144,439,1493,578
1500000US132551605002,132551605002,"Block Group 2, Census Tract 1605, Spalding County, Georgia",2704,726,1822,562,882,431
1500000US132551606001,132551606001,"Block Group 1, Census Tract 1606, Spalding County, Georgia",1480,356,1184,308,296,244
1500000US132551606002,132551606002,"Block Group 2, Census Tract 1606, Spalding County, Georgia",2411,319,1868,301,543,257
1500000US132551607001,132551607001,"Block Group 1, Census Tract 1607, Spalding County, Georgia",2428,782,1329,403,1099,621
1500000US132551607002,132551607002,"Block Group 2, Census Tract 1607, Spalding County, Georgia",1662,551,334,209,1328,524
1500000US132551607003,132551607003,"Block Group 3, Census Tract 1607, Spalding County, Georgia",2560,682,1149,797,1411,529
1500000US132551608001,132551608001,"Block Group 1, Census Tract 1608, Spalding County, Georgia",1559,517,300,214,1259,506
1500000US132551608002,132551608002,"Block Group 2, Census Tract 1608, Spalding County, Georgia",1385,538,180,173,1205,517
1500000US132551608003,132551608003,"Block Group 3, Census Tract 1608, Spalding County, Georgia",1889,536,360,221,1529,500
1500000US132551609001,132551609001,"Block Group 1, Census Tract 1609, Spalding County, Georgia",725,185,338,114,387,143
1500000US132551609002,132551609002,"Block Group 2, Census Tract 1609, Spalding County, Georgia",1230,235,615,200,615,266
1500000US132551609003,132551609003,"Block Group 3, Census Tract 1609, Spalding County, Georgia",737,228,180,126,557,213
1500000US132551610001,132551610001,"Block Group 1, Census Tract 1610, Spalding County, Georgia",996,364,927,366,69,79
1500000US132551610002,132551610002,"Block Group 2, Census Tract 1610, Spalding County, Georgia",1323,298,1157,303,166,98
1500000US132551610003,132551610003,"Block Group 3, Census Tract 1610, Spalding County, Georgia",2824,464,2337,465,487,354
1500000US132551611001,132551611001,"Block Group 1, Census Tract 1611, Spalding County, Georgia",1173,238,803,212,370,196
1500000US132551611002,132551611002,"Block Group 2, Census Tract 1611, Spalding County, Georgia",2756,389,1702,238,1054,375
1500000US132551612001,132551612001,"Block Group 1, Census Tract 1612, Spalding County, Georgia",2568,450,2288,493,280,199
1500000US132551612002,132551612002,"Block Group 2, Census Tract 1612, Spalding County, Georgia",617,354,0,13,617,354
1500000US132551612003,132551612003,"Block Group 3, Census Tract 1612, Spalding County, Georgia",1027,459,130,153,897,477
1500000US132551612004,132551612004,"Block Group 4, Census Tract 1612, Spalding County, Georgia",4242,614,2810,560,1432,623
1500000US132579701001,132579701001,"Block Group 1, Census Tract 9701, Stephens County, Georgia",1336,399,1190,410,146,121
1500000US132579701002,132579701002,"Block Group 2, Census Tract 9701, Stephens County, Georgia",978,322,804,343,174,96
1500000US132579701003,132579701003,"Block Group 3, Census Tract 9701, Stephens County, Georgia",799,467,589,440,210,187
1500000US132579701004,132579701004,"Block Group 4, Census Tract 9701, Stephens County, Georgia",1364,416,625,518,739,391
1500000US132579701005,132579701005,"Block Group 5, Census Tract 9701, Stephens County, Georgia",1548,378,1225,304,323,252
1500000US132579702001,132579702001,"Block Group 1, Census Tract 9702, Stephens County, Georgia",2400,590,1610,557,790,396
1500000US132579702002,132579702002,"Block Group 2, Census Tract 9702, Stephens County, Georgia",1945,466,1842,450,103,93
1500000US132579702003,132579702003,"Block Group 3, Census Tract 9702, Stephens County, Georgia",1794,536,1158,390,636,441
1500000US132579703011,132579703011,"Block Group 1, Census Tract 9703.01, Stephens County, Georgia",348,166,182,123,166,117
1500000US132579703012,132579703012,"Block Group 2, Census Tract 9703.01, Stephens County, Georgia",1015,320,585,217,430,298
1500000US132579703013,132579703013,"Block Group 3, Census Tract 9703.01, Stephens County, Georgia",555,228,293,216,262,117
1500000US132579703014,132579703014,"Block Group 4, Census Tract 9703.01, Stephens County, Georgia",1075,327,516,196,559,277
1500000US132579703021,132579703021,"Block Group 1, Census Tract 9703.02, Stephens County, Georgia",1212,386,456,248,756,334
1500000US132579703022,132579703022,"Block Group 2, Census Tract 9703.02, Stephens County, Georgia",1517,453,1168,448,349,173
1500000US132579704001,132579704001,"Block Group 1, Census Tract 9704, Stephens County, Georgia",1879,405,1475,410,404,167
1500000US132579704002,132579704002,"Block Group 2, Census Tract 9704, Stephens County, Georgia",1505,434,1338,417,167,227
1500000US132579704003,132579704003,"Block Group 3, Census Tract 9704, Stephens County, Georgia",1962,458,1532,460,430,225
1500000US132579704004,132579704004,"Block Group 4, Census Tract 9704, Stephens County, Georgia",1648,462,1539,453,109,110
1500000US132599501001,132599501001,"Block Group 1, Census Tract 9501, Stewart County, Georgia",1229,231,732,205,497,143
1500000US132599501002,132599501002,"Block Group 2, Census Tract 9501, Stewart County, Georgia",791,169,648,159,143,99
1500000US132599504001,132599504001,"Block Group 1, Census Tract 9504, Stewart County, Georgia",597,212,310,140,287,163
1500000US132599504002,132599504002,"Block Group 2, Census Tract 9504, Stewart County, Georgia",960,202,510,208,450,201
1500000US132599504003,132599504003,"Block Group 3, Census Tract 9504, Stewart County, Georgia",724,178,470,121,254,125
1500000US132619501001,132619501001,"Block Group 1, Census Tract 9501, Sumter County, Georgia",1245,184,982,170,263,100
1500000US132619502001,132619502001,"Block Group 1, Census Tract 9502, Sumter County, Georgia",1675,507,708,265,967,448
1500000US132619502002,132619502002,"Block Group 2, Census Tract 9502, Sumter County, Georgia",937,547,782,546,155,168
1500000US132619502003,132619502003,"Block Group 3, Census Tract 9502, Sumter County, Georgia",1343,449,694,255,649,513
1500000US132619502004,132619502004,"Block Group 4, Census Tract 9502, Sumter County, Georgia",1056,344,250,218,806,351
1500000US132619503001,132619503001,"Block Group 1, Census Tract 9503, Sumter County, Georgia",1801,506,1392,499,409,239
1500000US132619503002,132619503002,"Block Group 2, Census Tract 9503, Sumter County, Georgia",1269,310,1087,312,182,155
1500000US132619503003,132619503003,"Block Group 3, Census Tract 9503, Sumter County, Georgia",533,286,279,189,254,262
1500000US132619503004,132619503004,"Block Group 4, Census Tract 9503, Sumter County, Georgia",1068,483,180,98,888,488
1500000US132619503005,132619503005,"Block Group 5, Census Tract 9503, Sumter County, Georgia",1894,510,822,302,1072,478
1500000US132619504001,132619504001,"Block Group 1, Census Tract 9504, Sumter County, Georgia",837,230,614,190,223,152
1500000US132619504002,132619504002,"Block Group 2, Census Tract 9504, Sumter County, Georgia",798,193,515,137,283,134
1500000US132619504003,132619504003,"Block Group 3, Census Tract 9504, Sumter County, Georgia",899,257,776,256,123,127
1500000US132619505001,132619505001,"Block Group 1, Census Tract 9505, Sumter County, Georgia",979,237,796,221,183,137
1500000US132619505002,132619505002,"Block Group 2, Census Tract 9505, Sumter County, Georgia",989,282,683,247,306,185
1500000US132619505003,132619505003,"Block Group 3, Census Tract 9505, Sumter County, Georgia",1357,392,1072,404,285,184
1500000US132619506001,132619506001,"Block Group 1, Census Tract 9506, Sumter County, Georgia",514,171,158,84,356,151
1500000US132619506002,132619506002,"Block Group 2, Census Tract 9506, Sumter County, Georgia",764,200,368,115,396,163
1500000US132619506003,132619506003,"Block Group 3, Census Tract 9506, Sumter County, Georgia",832,247,459,174,373,179
1500000US132619507001,132619507001,"Block Group 1, Census Tract 9507, Sumter County, Georgia",1770,524,725,375,1045,484
1500000US132619507002,132619507002,"Block Group 2, Census Tract 9507, Sumter County, Georgia",1783,515,1349,484,434,298
1500000US132619507003,132619507003,"Block Group 3, Census Tract 9507, Sumter County, Georgia",1498,353,405,254,1093,305
1500000US132619507004,132619507004,"Block Group 4, Census Tract 9507, Sumter County, Georgia",703,270,424,231,279,218
1500000US132619508001,132619508001,"Block Group 1, Census Tract 9508, Sumter County, Georgia",927,318,753,313,174,106
1500000US132619508002,132619508002,"Block Group 2, Census Tract 9508, Sumter County, Georgia",931,178,468,146,463,200
1500000US132619508003,132619508003,"Block Group 3, Census Tract 9508, Sumter County, Georgia",969,333,528,186,441,268
1500000US132639601001,132639601001,"Block Group 1, Census Tract 9601, Talbot County, Georgia",774,248,586,250,188,78
1500000US132639601002,132639601002,"Block Group 2, Census Tract 9601, Talbot County, Georgia",1665,242,1494,253,171,128
1500000US132639602001,132639602001,"Block Group 1, Census Tract 9602, Talbot County, Georgia",961,172,583,145,378,146
1500000US132639602002,132639602002,"Block Group 2, Census Tract 9602, Talbot County, Georgia",1409,210,1124,188,285,117
1500000US132639603001,132639603001,"Block Group 1, Census Tract 9603, Talbot County, Georgia",514,113,401,105,113,65
1500000US132639603002,132639603002,"Block Group 2, Census Tract 9603, Talbot County, Georgia",1147,163,1050,169,97,50
1500000US132650102001,132650102001,"Block Group 1, Census Tract 102, Taliaferro County, Georgia",672,108,485,112,187,74
1500000US132650102002,132650102002,"Block Group 2, Census Tract 102, Taliaferro County, Georgia",607,137,392,119,215,99
1500000US132650102003,132650102003,"Block Group 3, Census Tract 102, Taliaferro County, Georgia",433,105,406,102,27,23
1500000US132679501001,132679501001,"Block Group 1, Census Tract 9501, Tattnall County, Georgia",1012,279,890,275,122,93
1500000US132679501002,132679501002,"Block Group 2, Census Tract 9501, Tattnall County, Georgia",549,166,451,167,98,69
1500000US132679501003,132679501003,"Block Group 3, Census Tract 9501, Tattnall County, Georgia",988,324,658,304,330,138
1500000US132679501004,132679501004,"Block Group 4, Census Tract 9501, Tattnall County, Georgia",882,287,613,199,269,208
1500000US132679502011,132679502011,"Block Group 1, Census Tract 9502.01, Tattnall County, Georgia",1814,349,1353,313,461,340
1500000US132679502012,132679502012,"Block Group 2, Census Tract 9502.01, Tattnall County, Georgia",2640,207,1461,326,1179,308
1500000US132679502021,132679502021,"Block Group 1, Census Tract 9502.02, Tattnall County, Georgia",469,184,129,83,340,181
1500000US132679502022,132679502022,"Block Group 2, Census Tract 9502.02, Tattnall County, Georgia",3220,360,2031,486,1189,444
1500000US132679503001,132679503001,"Block Group 1, Census Tract 9503, Tattnall County, Georgia",1251,305,920,246,331,193
1500000US132679503002,132679503002,"Block Group 2, Census Tract 9503, Tattnall County, Georgia",1122,315,696,161,426,285
1500000US132679503003,132679503003,"Block Group 3, Census Tract 9503, Tattnall County, Georgia",1155,272,871,233,284,170
1500000US132679503004,132679503004,"Block Group 4, Census Tract 9503, Tattnall County, Georgia",390,157,174,137,216,136
1500000US132679504001,132679504001,"Block Group 1, Census Tract 9504, Tattnall County, Georgia",816,266,761,273,55,48
1500000US132679504002,132679504002,"Block Group 2, Census Tract 9504, Tattnall County, Georgia",716,261,625,248,91,100
1500000US132679504003,132679504003,"Block Group 3, Census Tract 9504, Tattnall County, Georgia",386,154,308,145,78,72
1500000US132679504004,132679504004,"Block Group 4, Census Tract 9504, Tattnall County, Georgia",1969,383,1209,344,760,366
1500000US132699501001,132699501001,"Block Group 1, Census Tract 9501, Taylor County, Georgia",1418,175,1054,198,364,139
1500000US132699502001,132699502001,"Block Group 1, Census Tract 9502, Taylor County, Georgia",1080,249,698,185,382,177
1500000US132699502002,132699502002,"Block Group 2, Census Tract 9502, Taylor County, Georgia",1242,212,1038,199,204,96
1500000US132699503001,132699503001,"Block Group 1, Census Tract 9503, Taylor County, Georgia",1567,281,1000,229,567,253
1500000US132699503002,132699503002,"Block Group 2, Census Tract 9503, Taylor County, Georgia",1058,357,499,281,559,288
1500000US132699503003,132699503003,"Block Group 3, Census Tract 9503, Taylor County, Georgia",895,207,559,155,336,142
1500000US132699503004,132699503004,"Block Group 4, Census Tract 9503, Taylor County, Georgia",886,236,643,224,243,187
1500000US132719501001,132719501001,"Block Group 1, Census Tract 9501, Telfair County, Georgia",2158,444,1413,397,745,348
1500000US132719501002,132719501002,"Block Group 2, Census Tract 9501, Telfair County, Georgia",1077,351,476,184,601,292
1500000US132719501003,132719501003,"Block Group 3, Census Tract 9501, Telfair County, Georgia",1428,329,960,302,468,263
1500000US132719501004,132719501004,"Block Group 4, Census Tract 9501, Telfair County, Georgia",1069,364,407,220,662,293
1500000US132719501005,132719501005,"Block Group 5, Census Tract 9501, Telfair County, Georgia",1953,445,815,242,1138,376
1500000US132719502001,132719502001,"Block Group 1, Census Tract 9502, Telfair County, Georgia",743,207,491,151,252,126
1500000US132719502002,132719502002,"Block Group 2, Census Tract 9502, Telfair County, Georgia",1041,224,853,184,188,133
1500000US132719505001,132719505001,"Block Group 1, Census Tract 9505, Telfair County, Georgia",1098,270,790,248,308,179
1500000US132719505002,132719505002,"Block Group 2, Census Tract 9505, Telfair County, Georgia",926,234,529,222,397,196
1500000US132719505003,132719505003,"Block Group 3, Census Tract 9505, Telfair County, Georgia",1025,284,513,193,512,204
1500000US132731202001,132731202001,"Block Group 1, Census Tract 1202, Terrell County, Georgia",679,147,434,124,245,95
1500000US132731202002,132731202002,"Block Group 2, Census Tract 1202, Terrell County, Georgia",911,167,657,155,254,144
1500000US132731203001,132731203001,"Block Group 1, Census Tract 1203, Terrell County, Georgia",673,172,434,138,239,136
1500000US132731203002,132731203002,"Block Group 2, Census Tract 1203, Terrell County, Georgia",1132,281,324,146,808,257
1500000US132731203003,132731203003,"Block Group 3, Census Tract 1203, Terrell County, Georgia",703,293,60,84,643,305
1500000US132731203004,132731203004,"Block Group 4, Census Tract 1203, Terrell County, Georgia",464,203,184,74,280,206
1500000US132731204001,132731204001,"Block Group 1, Census Tract 1204, Terrell County, Georgia",1065,273,634,182,431,231
1500000US132731204002,132731204002,"Block Group 2, Census Tract 1204, Terrell County, Georgia",687,180,395,150,292,147
1500000US132731204003,132731204003,"Block Group 3, Census Tract 1204, Terrell County, Georgia",939,275,261,116,678,266
1500000US132731205001,132731205001,"Block Group 1, Census Tract 1205, Terrell County, Georgia",1637,148,1175,187,462,160
1500000US132759601001,132759601001,"Block Group 1, Census Tract 9601, Thomas County, Georgia",574,115,351,83,223,93
1500000US132759601002,132759601002,"Block Group 2, Census Tract 9601, Thomas County, Georgia",638,160,364,111,274,108
1500000US132759602001,132759602001,"Block Group 1, Census Tract 9602, Thomas County, Georgia",2634,338,2293,359,341,132
1500000US132759602002,132759602002,"Block Group 2, Census Tract 9602, Thomas County, Georgia",1286,291,692,191,594,225
1500000US132759603001,132759603001,"Block Group 1, Census Tract 9603, Thomas County, Georgia",1194,222,759,190,435,155
1500000US132759603002,132759603002,"Block Group 2, Census Tract 9603, Thomas County, Georgia",1045,134,772,162,273,113
1500000US132759604001,132759604001,"Block Group 1, Census Tract 9604, Thomas County, Georgia",863,157,705,124,158,101
1500000US132759604002,132759604002,"Block Group 2, Census Tract 9604, Thomas County, Georgia",1288,189,878,152,410,144
1500000US132759605001,132759605001,"Block Group 1, Census Tract 9605, Thomas County, Georgia",3155,500,1532,441,1623,526
1500000US132759605002,132759605002,"Block Group 2, Census Tract 9605, Thomas County, Georgia",1531,417,901,307,630,353
1500000US132759605003,132759605003,"Block Group 3, Census Tract 9605, Thomas County, Georgia",2060,473,868,304,1192,425
1500000US132759606001,132759606001,"Block Group 1, Census Tract 9606, Thomas County, Georgia",1596,370,1021,352,575,301
1500000US132759606002,132759606002,"Block Group 2, Census Tract 9606, Thomas County, Georgia",1011,292,984,300,27,48
1500000US132759606003,132759606003,"Block Group 3, Census Tract 9606, Thomas County, Georgia",348,186,178,113,170,215
1500000US132759606004,132759606004,"Block Group 4, Census Tract 9606, Thomas County, Georgia",1684,441,319,194,1365,402
1500000US132759606005,132759606005,"Block Group 5, Census Tract 9606, Thomas County, Georgia",856,305,309,264,547,167
1500000US132759607001,132759607001,"Block Group 1, Census Tract 9607, Thomas County, Georgia",1970,404,1346,375,624,435
1500000US132759607002,132759607002,"Block Group 2, Census Tract 9607, Thomas County, Georgia",1517,559,210,134,1307,557
1500000US132759607003,132759607003,"Block Group 3, Census Tract 9607, Thomas County, Georgia",1312,418,736,319,576,317
1500000US132759607004,132759607004,"Block Group 4, Census Tract 9607, Thomas County, Georgia",911,362,463,283,448,261
1500000US132759607005,132759607005,"Block Group 5, Census Tract 9607, Thomas County, Georgia",781,403,341,336,440,224
1500000US132759607006,132759607006,"Block Group 6, Census Tract 9607, Thomas County, Georgia",350,232,186,142,164,187
1500000US132759608001,132759608001,"Block Group 1, Census Tract 9608, Thomas County, Georgia",932,277,899,279,33,53
1500000US132759608002,132759608002,"Block Group 2, Census Tract 9608, Thomas County, Georgia",1457,623,832,672,625,323
1500000US132759608003,132759608003,"Block Group 3, Census Tract 9608, Thomas County, Georgia",564,238,81,84,483,218
1500000US132759608004,132759608004,"Block Group 4, Census Tract 9608, Thomas County, Georgia",846,393,357,208,489,336
1500000US132759608005,132759608005,"Block Group 5, Census Tract 9608, Thomas County, Georgia",1471,472,1242,455,229,136
1500000US132759609001,132759609001,"Block Group 1, Census Tract 9609, Thomas County, Georgia",705,272,456,265,249,147
1500000US132759609002,132759609002,"Block Group 2, Census Tract 9609, Thomas County, Georgia",1883,426,1198,255,685,360
1500000US132759609003,132759609003,"Block Group 3, Census Tract 9609, Thomas County, Georgia",934,205,741,215,193,126
1500000US132759610001,132759610001,"Block Group 1, Census Tract 9610, Thomas County, Georgia",1984,320,1513,296,471,247
1500000US132759610002,132759610002,"Block Group 2, Census Tract 9610, Thomas County, Georgia",970,370,480,188,490,335
1500000US132759610003,132759610003,"Block Group 3, Census Tract 9610, Thomas County, Georgia",775,212,571,213,204,130
1500000US132759611001,132759611001,"Block Group 1, Census Tract 9611, Thomas County, Georgia",892,257,618,208,274,167
1500000US132759611002,132759611002,"Block Group 2, Census Tract 9611, Thomas County, Georgia",1072,247,611,183,461,230
1500000US132759611003,132759611003,"Block Group 3, Census Tract 9611, Thomas County, Georgia",847,225,619,193,228,134
1500000US132779601001,132779601001,"Block Group 1, Census Tract 9601, Tift County, Georgia",1346,334,992,230,354,290
1500000US132779601002,132779601002,"Block Group 2, Census Tract 9601, Tift County, Georgia",1157,231,1035,224,122,106
1500000US132779602001,132779602001,"Block Group 1, Census Tract 9602, Tift County, Georgia",1419,303,1313,299,106,81
1500000US132779602002,132779602002,"Block Group 2, Census Tract 9602, Tift County, Georgia",1565,268,1140,249,425,164
1500000US132779603001,132779603001,"Block Group 1, Census Tract 9603, Tift County, Georgia",512,225,350,176,162,169
1500000US132779603002,132779603002,"Block Group 2, Census Tract 9603, Tift County, Georgia",998,343,436,194,562,331
1500000US132779603003,132779603003,"Block Group 3, Census Tract 9603, Tift County, Georgia",2985,525,1304,308,1681,450
1500000US132779603004,132779603004,"Block Group 4, Census Tract 9603, Tift County, Georgia",549,511,154,139,395,489
1500000US132779603005,132779603005,"Block Group 5, Census Tract 9603, Tift County, Georgia",849,287,542,210,307,231
1500000US132779603006,132779603006,"Block Group 6, Census Tract 9603, Tift County, Georgia",492,222,49,61,443,225
1500000US132779604001,132779604001,"Block Group 1, Census Tract 9604, Tift County, Georgia",304,187,285,192,19,30
1500000US132779604002,132779604002,"Block Group 2, Census Tract 9604, Tift County, Georgia",944,311,279,143,665,285
1500000US132779604003,132779604003,"Block Group 3, Census Tract 9604, Tift County, Georgia",2256,705,558,387,1698,679
1500000US132779604004,132779604004,"Block Group 4, Census Tract 9604, Tift County, Georgia",982,365,862,336,120,134
1500000US132779604005,132779604005,"Block Group 5, Census Tract 9604, Tift County, Georgia",401,172,118,90,283,157
1500000US132779604006,132779604006,"Block Group 6, Census Tract 9604, Tift County, Georgia",1193,330,633,250,560,329
1500000US132779605001,132779605001,"Block Group 1, Census Tract 9605, Tift County, Georgia",2766,354,2496,384,270,200
1500000US132779605002,132779605002,"Block Group 2, Census Tract 9605, Tift County, Georgia",1775,297,1415,296,360,183
1500000US132779606001,132779606001,"Block Group 1, Census Tract 9606, Tift County, Georgia",1278,542,44,47,1234,545
1500000US132779606002,132779606002,"Block Group 2, Census Tract 9606, Tift County, Georgia",2842,817,990,426,1852,609
1500000US132779606003,132779606003,"Block Group 3, Census Tract 9606, Tift County, Georgia",1011,466,379,248,632,416
1500000US132779606004,132779606004,"Block Group 4, Census Tract 9606, Tift County, Georgia",639,268,349,178,290,199
1500000US132779607001,132779607001,"Block Group 1, Census Tract 9607, Tift County, Georgia",830,310,239,138,591,296
1500000US132779607002,132779607002,"Block Group 2, Census Tract 9607, Tift County, Georgia",2639,471,1424,352,1215,415
1500000US132779607003,132779607003,"Block Group 3, Census Tract 9607, Tift County, Georgia",383,169,181,98,202,162
1500000US132779607004,132779607004,"Block Group 4, Census Tract 9607, Tift County, Georgia",805,575,79,79,726,569
1500000US132779608001,132779608001,"Block Group 1, Census Tract 9608, Tift County, Georgia",1238,257,800,206,438,209
1500000US132779608002,132779608002,"Block Group 2, Census Tract 9608, Tift County, Georgia",1333,402,861,285,472,291
1500000US132779609001,132779609001,"Block Group 1, Census Tract 9609, Tift County, Georgia",840,273,449,172,391,240
1500000US132779609002,132779609002,"Block Group 2, Census Tract 9609, Tift County, Georgia",1221,394,1016,408,205,143
1500000US132779609003,132779609003,"Block Group 3, Census Tract 9609, Tift County, Georgia",1396,338,1361,330,35,50
1500000US132799701001,132799701001,"Block Group 1, Census Tract 9701, Toombs County, Georgia",2331,570,1592,584,739,362
1500000US132799701002,132799701002,"Block Group 2, Census Tract 9701, Toombs County, Georgia",898,405,442,313,456,271
1500000US132799701003,132799701003,"Block Group 3, Census Tract 9701, Toombs County, Georgia",1068,352,338,213,730,320
1500000US132799701004,132799701004,"Block Group 4, Census Tract 9701, Toombs County, Georgia",1174,366,687,237,487,322
1500000US132799702001,132799702001,"Block Group 1, Census Tract 9702, Toombs County, Georgia",1535,365,1222,378,313,207
1500000US132799702002,132799702002,"Block Group 2, Census Tract 9702, Toombs County, Georgia",964,365,648,233,316,322
1500000US132799702003,132799702003,"Block Group 3, Census Tract 9702, Toombs County, Georgia",901,306,486,208,415,287
1500000US132799702004,132799702004,"Block Group 4, Census Tract 9702, Toombs County, Georgia",765,303,67,67,698,305
1500000US132799702005,132799702005,"Block Group 5, Census Tract 9702, Toombs County, Georgia",305,139,78,77,227,137
1500000US132799703001,132799703001,"Block Group 1, Census Tract 9703, Toombs County, Georgia",1219,390,1083,389,136,117
1500000US132799703002,132799703002,"Block Group 2, Census Tract 9703, Toombs County, Georgia",1407,636,393,333,1014,579
1500000US132799703003,132799703003,"Block Group 3, Census Tract 9703, Toombs County, Georgia",1212,299,974,306,238,223
1500000US132799703004,132799703004,"Block Group 4, Census Tract 9703, Toombs County, Georgia",683,360,425,221,258,309
1500000US132799703005,132799703005,"Block Group 5, Census Tract 9703, Toombs County, Georgia",1751,548,1712,548,39,71
1500000US132799704001,132799704001,"Block Group 1, Census Tract 9704, Toombs County, Georgia",689,304,175,87,514,312
1500000US132799704002,132799704002,"Block Group 2, Census Tract 9704, Toombs County, Georgia",525,257,298,240,227,118
1500000US132799704003,132799704003,"Block Group 3, Census Tract 9704, Toombs County, Georgia",1136,335,931,340,205,191
1500000US132799704004,132799704004,"Block Group 4, Census Tract 9704, Toombs County, Georgia",1800,436,685,324,1115,351
1500000US132799705001,132799705001,"Block Group 1, Census Tract 9705, Toombs County, Georgia",398,160,203,129,195,126
1500000US132799705002,132799705002,"Block Group 2, Census Tract 9705, Toombs County, Georgia",1642,364,1149,298,493,216
1500000US132799705003,132799705003,"Block Group 3, Census Tract 9705, Toombs County, Georgia",1500,324,966,291,534,260
1500000US132799706001,132799706001,"Block Group 1, Census Tract 9706, Toombs County, Georgia",1012,259,856,241,156,148
1500000US132799706002,132799706002,"Block Group 2, Census Tract 9706, Toombs County, Georgia",1256,287,984,202,272,216
1500000US132799706003,132799706003,"Block Group 3, Census Tract 9706, Toombs County, Georgia",574,208,424,204,150,111
1500000US132819601001,132819601001,"Block Group 1, Census Tract 9601, Towns County, Georgia",1778,285,1410,281,368,174
1500000US132819601002,132819601002,"Block Group 2, Census Tract 9601, Towns County, Georgia",1294,367,1094,350,200,181
1500000US132819601003,132819601003,"Block Group 3, Census Tract 9601, Towns County, Georgia",676,184,396,151,280,97
1500000US132819602001,132819602001,"Block Group 1, Census Tract 9602, Towns County, Georgia",1249,269,1021,257,228,139
1500000US132819602002,132819602002,"Block Group 2, Census Tract 9602, Towns County, Georgia",1463,296,1297,282,166,113
1500000US132819603001,132819603001,"Block Group 1, Census Tract 9603, Towns County, Georgia",1227,214,969,223,258,124
1500000US132819603002,132819603002,"Block Group 2, Census Tract 9603, Towns County, Georgia",1191,229,999,199,192,145
1500000US132819603003,132819603003,"Block Group 3, Census Tract 9603, Towns County, Georgia",1110,261,678,183,432,169
1500000US132839601001,132839601001,"Block Group 1, Census Tract 9601, Treutlen County, Georgia",582,165,419,144,163,93
1500000US132839601002,132839601002,"Block Group 2, Census Tract 9601, Treutlen County, Georgia",559,157,428,148,131,110
1500000US132839602001,132839602001,"Block Group 1, Census Tract 9602, Treutlen County, Georgia",924,274,542,197,382,234
1500000US132839602002,132839602002,"Block Group 2, Census Tract 9602, Treutlen County, Georgia",809,242,496,172,313,191
1500000US132839602003,132839602003,"Block Group 3, Census Tract 9602, Treutlen County, Georgia",1432,296,1067,271,365,182
1500000US132839602004,132839602004,"Block Group 4, Census Tract 9602, Treutlen County, Georgia",640,205,440,192,200,97
1500000US132839602005,132839602005,"Block Group 5, Census Tract 9602, Treutlen County, Georgia",1307,255,998,253,309,164
1500000US132859601001,132859601001,"Block Group 1, Census Tract 9601, Troup County, Georgia",1349,291,854,277,495,228
1500000US132859601002,132859601002,"Block Group 2, Census Tract 9601, Troup County, Georgia",1310,288,822,277,488,244
1500000US132859601003,132859601003,"Block Group 3, Census Tract 9601, Troup County, Georgia",1220,177,671,159,549,163
1500000US132859601004,132859601004,"Block Group 4, Census Tract 9601, Troup County, Georgia",2189,387,1660,344,529,307
1500000US132859602011,132859602011,"Block Group 1, Census Tract 9602.01, Troup County, Georgia",3046,308,2744,387,302,183
1500000US132859602021,132859602021,"Block Group 1, Census Tract 9602.02, Troup County, Georgia",2346,307,1717,353,629,212
1500000US132859603001,132859603001,"Block Group 1, Census Tract 9603, Troup County, Georgia",718,228,589,230,129,75
1500000US132859603002,132859603002,"Block Group 2, Census Tract 9603, Troup County, Georgia",992,162,857,164,135,69
1500000US132859603003,132859603003,"Block Group 3, Census Tract 9603, Troup County, Georgia",1851,241,1600,230,251,155
1500000US132859604001,132859604001,"Block Group 1, Census Tract 9604, Troup County, Georgia",807,267,283,121,524,258
1500000US132859604002,132859604002,"Block Group 2, Census Tract 9604, Troup County, Georgia",1852,559,839,267,1013,519
1500000US132859604003,132859604003,"Block Group 3, Census Tract 9604, Troup County, Georgia",3021,474,1710,352,1311,450
1500000US132859605011,132859605011,"Block Group 1, Census Tract 9605.01, Troup County, Georgia",1402,317,792,168,610,296
1500000US132859605012,132859605012,"Block Group 2, Census Tract 9605.01, Troup County, Georgia",651,277,93,58,558,275
1500000US132859605013,132859605013,"Block Group 3, Census Tract 9605.01, Troup County, Georgia",1272,307,547,194,725,307
1500000US132859605014,132859605014,"Block Group 4, Census Tract 9605.01, Troup County, Georgia",1379,465,183,115,1196,455
1500000US132859605021,132859605021,"Block Group 1, Census Tract 9605.02, Troup County, Georgia",2383,458,1927,453,456,256
1500000US132859605022,132859605022,"Block Group 2, Census Tract 9605.02, Troup County, Georgia",4974,612,2099,523,2875,552
1500000US132859606001,132859606001,"Block Group 1, Census Tract 9606, Troup County, Georgia",1447,346,1214,332,233,191
1500000US132859606002,132859606002,"Block Group 2, Census Tract 9606, Troup County, Georgia",1640,406,772,254,868,380
1500000US132859606003,132859606003,"Block Group 3, Census Tract 9606, Troup County, Georgia",899,308,97,65,802,326
1500000US132859606004,132859606004,"Block Group 4, Census Tract 9606, Troup County, Georgia",1577,494,252,184,1325,524
1500000US132859607001,132859607001,"Block Group 1, Census Tract 9607, Troup County, Georgia",1744,502,422,225,1322,502
1500000US132859607002,132859607002,"Block Group 2, Census Tract 9607, Troup County, Georgia",1792,352,1190,348,602,278
1500000US132859607003,132859607003,"Block Group 3, Census Tract 9607, Troup County, Georgia",1372,372,877,306,495,253
1500000US132859607004,132859607004,"Block Group 4, Census Tract 9607, Troup County, Georgia",606,337,267,132,339,316
1500000US132859608001,132859608001,"Block Group 1, Census Tract 9608, Troup County, Georgia",1262,304,432,225,830,255
1500000US132859608002,132859608002,"Block Group 2, Census Tract 9608, Troup County, Georgia",1170,390,452,263,718,334
1500000US132859608003,132859608003,"Block Group 3, Census Tract 9608, Troup County, Georgia",1003,296,198,110,805,308
1500000US132859609011,132859609011,"Block Group 1, Census Tract 9609.01, Troup County, Georgia",882,279,370,229,512,284
1500000US132859609012,132859609012,"Block Group 2, Census Tract 9609.01, Troup County, Georgia",1494,388,260,129,1234,386
1500000US132859609013,132859609013,"Block Group 3, Census Tract 9609.01, Troup County, Georgia",1935,433,780,329,1155,405
1500000US132859609021,132859609021,"Block Group 1, Census Tract 9609.02, Troup County, Georgia",2192,749,2063,753,129,127
1500000US132859609022,132859609022,"Block Group 2, Census Tract 9609.02, Troup County, Georgia",2837,441,2362,510,475,304
1500000US132859609023,132859609023,"Block Group 3, Census Tract 9609.02, Troup County, Georgia",1686,446,1237,370,449,317
1500000US132859610001,132859610001,"Block Group 1, Census Tract 9610, Troup County, Georgia",2005,572,1441,406,564,466
1500000US132859610002,132859610002,"Block Group 2, Census Tract 9610, Troup County, Georgia",1671,456,1401,462,270,193
1500000US132859610003,132859610003,"Block Group 3, Census Tract 9610, Troup County, Georgia",1084,494,331,203,753,451
1500000US132859610004,132859610004,"Block Group 4, Census Tract 9610, Troup County, Georgia",1448,356,134,124,1314,388
1500000US132859611001,132859611001,"Block Group 1, Census Tract 9611, Troup County, Georgia",1353,268,1050,230,303,192
1500000US132859611002,132859611002,"Block Group 2, Census Tract 9611, Troup County, Georgia",1403,266,1291,260,112,88
1500000US132879702001,132879702001,"Block Group 1, Census Tract 9702, Turner County, Georgia",887,298,621,236,266,230
1500000US132879702002,132879702002,"Block Group 2, Census Tract 9702, Turner County, Georgia",1013,289,847,309,166,192
1500000US132879702003,132879702003,"Block Group 3, Census Tract 9702, Turner County, Georgia",1005,333,793,323,212,160
1500000US132879702004,132879702004,"Block Group 4, Census Tract 9702, Turner County, Georgia",1563,368,846,302,717,318
1500000US132879702005,132879702005,"Block Group 5, Census Tract 9702, Turner County, Georgia",803,184,385,206,418,185
1500000US132879703001,132879703001,"Block Group 1, Census Tract 9703, Turner County, Georgia",779,201,427,157,352,147
1500000US132879703002,132879703002,"Block Group 2, Census Tract 9703, Turner County, Georgia",499,180,476,172,23,34
1500000US132879703003,132879703003,"Block Group 3, Census Tract 9703, Turner County, Georgia",686,214,625,217,61,63
1500000US132879703004,132879703004,"Block Group 4, Census Tract 9703, Turner County, Georgia",699,216,482,185,217,154
1500000US132890601001,132890601001,"Block Group 1, Census Tract 601, Twiggs County, Georgia",1019,311,522,222,497,252
1500000US132890601002,132890601002,"Block Group 2, Census Tract 601, Twiggs County, Georgia",1392,447,1173,437,219,124
1500000US132890601003,132890601003,"Block Group 3, Census Tract 601, Twiggs County, Georgia",512,257,500,256,12,19
1500000US132890601004,132890601004,"Block Group 4, Census Tract 601, Twiggs County, Georgia",2048,394,1886,384,162,134
1500000US132890602001,132890602001,"Block Group 1, Census Tract 602, Twiggs County, Georgia",1108,328,764,254,344,234
1500000US132890602002,132890602002,"Block Group 2, Census Tract 602, Twiggs County, Georgia",1209,316,893,275,316,189
1500000US132890602003,132890602003,"Block Group 3, Census Tract 602, Twiggs County, Georgia",725,246,578,237,147,109
1500000US132890602004,132890602004,"Block Group 4, Census Tract 602, Twiggs County, Georgia",409,132,256,101,153,101
1500000US132910001011,132910001011,"Block Group 1, Census Tract 1.01, Union County, Georgia",2652,463,2338,418,314,222
1500000US132910001021,132910001021,"Block Group 1, Census Tract 1.02, Union County, Georgia",1922,529,1048,704,874,446
1500000US132910001022,132910001022,"Block Group 2, Census Tract 1.02, Union County, Georgia",1023,347,1008,347,15,23
1500000US132910001023,132910001023,"Block Group 3, Census Tract 1.02, Union County, Georgia",2164,663,1965,693,199,171
1500000US132910002011,132910002011,"Block Group 1, Census Tract 2.01, Union County, Georgia",925,379,744,269,181,214
1500000US132910002012,132910002012,"Block Group 2, Census Tract 2.01, Union County, Georgia",1839,432,1558,389,281,223
1500000US132910002031,132910002031,"Block Group 1, Census Tract 2.03, Union County, Georgia",1526,410,1207,464,319,228
1500000US132910002032,132910002032,"Block Group 2, Census Tract 2.03, Union County, Georgia",752,317,680,301,72,83
1500000US132910002041,132910002041,"Block Group 1, Census Tract 2.04, Union County, Georgia",735,321,559,269,176,165
1500000US132910002042,132910002042,"Block Group 2, Census Tract 2.04, Union County, Georgia",2375,703,1916,727,459,317
1500000US132910002051,132910002051,"Block Group 1, Census Tract 2.05, Union County, Georgia",958,379,874,372,84,90
1500000US132910002052,132910002052,"Block Group 2, Census Tract 2.05, Union County, Georgia",2106,494,1608,445,498,298
1500000US132910002053,132910002053,"Block Group 3, Census Tract 2.05, Union County, Georgia",1116,420,374,241,742,413
1500000US132910002054,132910002054,"Block Group 4, Census Tract 2.05, Union County, Georgia",1159,482,764,367,395,315
1500000US132930101001,132930101001,"Block Group 1, Census Tract 101, Upson County, Georgia",1928,254,1347,295,581,233
1500000US132930101002,132930101002,"Block Group 2, Census Tract 101, Upson County, Georgia",1045,227,795,217,250,149
1500000US132930102011,132930102011,"Block Group 1, Census Tract 102.01, Upson County, Georgia",1645,261,996,269,649,228
1500000US132930102012,132930102012,"Block Group 2, Census Tract 102.01, Upson County, Georgia",2116,481,1150,278,966,452
1500000US132930102013,132930102013,"Block Group 3, Census Tract 102.01, Upson County, Georgia",1330,393,831,182,499,354
1500000US132930102021,132930102021,"Block Group 1, Census Tract 102.02, Upson County, Georgia",1228,231,919,188,309,181
1500000US132930102022,132930102022,"Block Group 2, Census Tract 102.02, Upson County, Georgia",1410,260,1159,227,251,158
1500000US132930103001,132930103001,"Block Group 1, Census Tract 103, Upson County, Georgia",1835,351,1368,248,467,272
1500000US132930103002,132930103002,"Block Group 2, Census Tract 103, Upson County, Georgia",1290,273,1137,274,153,145
1500000US132930104001,132930104001,"Block Group 1, Census Tract 104, Upson County, Georgia",1137,377,473,292,664,309
1500000US132930104002,132930104002,"Block Group 2, Census Tract 104, Upson County, Georgia",1555,475,781,314,774,491
1500000US132930104003,132930104003,"Block Group 3, Census Tract 104, Upson County, Georgia",1115,305,398,235,717,274
1500000US132930104004,132930104004,"Block Group 4, Census Tract 104, Upson County, Georgia",933,334,756,290,177,199
1500000US132930104005,132930104005,"Block Group 5, Census Tract 104, Upson County, Georgia",494,210,377,202,117,95
1500000US132930104006,132930104006,"Block Group 6, Census Tract 104, Upson County, Georgia",489,190,263,154,226,160
1500000US132930105001,132930105001,"Block Group 1, Census Tract 105, Upson County, Georgia",1573,502,426,192,1147,521
1500000US132930105002,132930105002,"Block Group 2, Census Tract 105, Upson County, Georgia",1331,371,1107,361,224,170
1500000US132930105003,132930105003,"Block Group 3, Census Tract 105, Upson County, Georgia",498,189,142,108,356,194
1500000US132930105004,132930105004,"Block Group 4, Census Tract 105, Upson County, Georgia",571,252,243,142,328,253
1500000US132930105005,132930105005,"Block Group 5, Census Tract 105, Upson County, Georgia",1232,331,577,250,655,320
1500000US132930106001,132930106001,"Block Group 1, Census Tract 106, Upson County, Georgia",1187,174,1009,180,178,104
1500000US132950201001,132950201001,"Block Group 1, Census Tract 201, Walker County, Georgia",909,245,691,217,218,190
1500000US132950201002,132950201002,"Block Group 2, Census Tract 201, Walker County, Georgia",1701,451,1221,453,480,344
1500000US132950201003,132950201003,"Block Group 3, Census Tract 201, Walker County, Georgia",951,297,653,305,298,223
1500000US132950201004,132950201004,"Block Group 4, Census Tract 201, Walker County, Georgia",830,256,505,193,325,199
1500000US132950201005,132950201005,"Block Group 5, Census Tract 201, Walker County, Georgia",995,272,780,260,215,134
1500000US132950201006,132950201006,"Block Group 6, Census Tract 201, Walker County, Georgia",1207,391,467,171,740,377
1500000US132950202001,132950202001,"Block Group 1, Census Tract 202, Walker County, Georgia",2389,401,1045,290,1344,395
1500000US132950202002,132950202002,"Block Group 2, Census Tract 202, Walker County, Georgia",1547,317,499,171,1048,292
1500000US132950203011,132950203011,"Block Group 1, Census Tract 203.01, Walker County, Georgia",2046,502,1050,312,996,440
1500000US132950203012,132950203012,"Block Group 2, Census Tract 203.01, Walker County, Georgia",999,356,568,276,431,255
1500000US132950203013,132950203013,"Block Group 3, Census Tract 203.01, Walker County, Georgia",981,358,596,254,385,274
1500000US132950203014,132950203014,"Block Group 4, Census Tract 203.01, Walker County, Georgia",693,292,693,292,0,13
1500000US132950203021,132950203021,"Block Group 1, Census Tract 203.02, Walker County, Georgia",915,309,617,298,298,203
1500000US132950203022,132950203022,"Block Group 2, Census Tract 203.02, Walker County, Georgia",454,167,393,175,61,69
1500000US132950203023,132950203023,"Block Group 3, Census Tract 203.02, Walker County, Georgia",675,299,609,302,66,78
1500000US132950203024,132950203024,"Block Group 4, Census Tract 203.02, Walker County, Georgia",784,291,481,193,303,240
1500000US132950203025,132950203025,"Block Group 5, Census Tract 203.02, Walker County, Georgia",2262,481,1560,441,702,322
1500000US132950204001,132950204001,"Block Group 1, Census Tract 204, Walker County, Georgia",738,163,633,166,105,53
1500000US132950204002,132950204002,"Block Group 2, Census Tract 204, Walker County, Georgia",924,170,808,159,116,67
1500000US132950204003,132950204003,"Block Group 3, Census Tract 204, Walker County, Georgia",1543,418,1030,280,513,338
1500000US132950205011,132950205011,"Block Group 1, Census Tract 205.01, Walker County, Georgia",1636,326,1175,301,461,216
1500000US132950205012,132950205012,"Block Group 2, Census Tract 205.01, Walker County, Georgia",2429,270,1725,387,704,296
1500000US132950205013,132950205013,"Block Group 3, Census Tract 205.01, Walker County, Georgia",4089,733,3138,702,951,556
1500000US132950205021,132950205021,"Block Group 1, Census Tract 205.02, Walker County, Georgia",1317,398,884,260,433,368
1500000US132950205022,132950205022,"Block Group 2, Census Tract 205.02, Walker County, Georgia",3221,425,2589,497,632,314
1500000US132950205023,132950205023,"Block Group 3, Census Tract 205.02, Walker County, Georgia",2008,375,1158,305,850,438
1500000US132950206011,132950206011,"Block Group 1, Census Tract 206.01, Walker County, Georgia",2322,516,2005,515,317,198
1500000US132950206012,132950206012,"Block Group 2, Census Tract 206.01, Walker County, Georgia",1712,396,1241,360,471,309
1500000US132950206013,132950206013,"Block Group 3, Census Tract 206.01, Walker County, Georgia",2086,475,1881,427,205,181
1500000US132950206021,132950206021,"Block Group 1, Census Tract 206.02, Walker County, Georgia",2481,380,2294,393,187,152
1500000US132950206022,132950206022,"Block Group 2, Census Tract 206.02, Walker County, Georgia",1883,304,1669,308,214,112
1500000US132950207001,132950207001,"Block Group 1, Census Tract 207, Walker County, Georgia",1808,412,1249,402,559,295
1500000US132950207002,132950207002,"Block Group 2, Census Tract 207, Walker County, Georgia",1124,590,528,528,596,384
1500000US132950207003,132950207003,"Block Group 3, Census Tract 207, Walker County, Georgia",586,288,225,234,361,179
1500000US132950207004,132950207004,"Block Group 4, Census Tract 207, Walker County, Georgia",689,298,374,254,315,210
1500000US132950207005,132950207005,"Block Group 5, Census Tract 207, Walker County, Georgia",2099,498,1097,386,1002,360
1500000US132950207006,132950207006,"Block Group 6, Census Tract 207, Walker County, Georgia",579,382,385,318,194,204
1500000US132950208001,132950208001,"Block Group 1, Census Tract 208, Walker County, Georgia",1141,255,931,224,210,194
1500000US132950208002,132950208002,"Block Group 2, Census Tract 208, Walker County, Georgia",958,224,847,222,111,95
1500000US132950208003,132950208003,"Block Group 3, Census Tract 208, Walker County, Georgia",1112,287,747,222,365,262
1500000US132950209011,132950209011,"Block Group 1, Census Tract 209.01, Walker County, Georgia",2904,514,2651,517,253,180
1500000US132950209012,132950209012,"Block Group 2, Census Tract 209.01, Walker County, Georgia",1944,689,1686,673,258,183
1500000US132950209013,132950209013,"Block Group 3, Census Tract 209.01, Walker County, Georgia",673,350,496,257,177,275
1500000US132950209014,132950209014,"Block Group 4, Census Tract 209.01, Walker County, Georgia",746,280,746,280,0,13
1500000US132950209021,132950209021,"Block Group 1, Census Tract 209.02, Walker County, Georgia",660,145,571,146,89,51
1500000US132950209022,132950209022,"Block Group 2, Census Tract 209.02, Walker County, Georgia",1172,209,1040,207,132,85
1500000US132971101001,132971101001,"Block Group 1, Census Tract 1101, Walton County, Georgia",2813,595,2218,541,595,344
1500000US132971101002,132971101002,"Block Group 2, Census Tract 1101, Walton County, Georgia",1868,462,1528,425,340,249
1500000US132971101003,132971101003,"Block Group 3, Census Tract 1101, Walton County, Georgia",4191,614,3940,605,251,201
1500000US132971102001,132971102001,"Block Group 1, Census Tract 1102, Walton County, Georgia",1663,325,1019,259,644,292
1500000US132971102002,132971102002,"Block Group 2, Census Tract 1102, Walton County, Georgia",2549,338,2298,351,251,168
1500000US132971103001,132971103001,"Block Group 1, Census Tract 1103, Walton County, Georgia",1822,541,887,375,935,500
1500000US132971103002,132971103002,"Block Group 2, Census Tract 1103, Walton County, Georgia",3869,702,1843,586,2026,586
1500000US132971103003,132971103003,"Block Group 3, Census Tract 1103, Walton County, Georgia",1238,377,534,255,704,309
1500000US132971104001,132971104001,"Block Group 1, Census Tract 1104, Walton County, Georgia",2348,375,1430,355,918,377
1500000US132971104002,132971104002,"Block Group 2, Census Tract 1104, Walton County, Georgia",2198,551,730,257,1468,545
1500000US132971104003,132971104003,"Block Group 3, Census Tract 1104, Walton County, Georgia",1951,445,1014,395,937,431
1500000US132971105031,132971105031,"Block Group 1, Census Tract 1105.03, Walton County, Georgia",3466,358,2750,327,716,348
1500000US132971105041,132971105041,"Block Group 1, Census Tract 1105.04, Walton County, Georgia",2085,432,1715,351,370,292
1500000US132971105042,132971105042,"Block Group 2, Census Tract 1105.04, Walton County, Georgia",2857,543,1459,419,1398,367
1500000US132971105051,132971105051,"Block Group 1, Census Tract 1105.05, Walton County, Georgia",4223,428,3652,447,571,276
1500000US132971105061,132971105061,"Block Group 1, Census Tract 1105.06, Walton County, Georgia",1417,317,1052,288,365,181
1500000US132971105062,132971105062,"Block Group 2, Census Tract 1105.06, Walton County, Georgia",1459,362,1154,364,305,248
1500000US132971105063,132971105063,"Block Group 3, Census Tract 1105.06, Walton County, Georgia",2267,377,1967,377,300,255
1500000US132971105071,132971105071,"Block Group 1, Census Tract 1105.07, Walton County, Georgia",1478,480,1381,494,97,127
1500000US132971105072,132971105072,"Block Group 2, Census Tract 1105.07, Walton County, Georgia",1155,318,1155,318,0,13
1500000US132971105073,132971105073,"Block Group 3, Census Tract 1105.07, Walton County, Georgia",4979,513,3837,604,1142,444
1500000US132971105081,132971105081,"Block Group 1, Census Tract 1105.08, Walton County, Georgia",1978,472,1675,447,303,229
1500000US132971105082,132971105082,"Block Group 2, Census Tract 1105.08, Walton County, Georgia",1822,385,1669,381,153,129
1500000US132971105083,132971105083,"Block Group 3, Census Tract 1105.08, Walton County, Georgia",1310,474,800,390,510,363
1500000US132971106011,132971106011,"Block Group 1, Census Tract 1106.01, Walton County, Georgia",2057,353,1830,279,227,262
1500000US132971106012,132971106012,"Block Group 2, Census Tract 1106.01, Walton County, Georgia",2580,409,2482,412,98,82
1500000US132971106021,132971106021,"Block Group 1, Census Tract 1106.02, Walton County, Georgia",2745,406,2022,400,723,290
1500000US132971106022,132971106022,"Block Group 2, Census Tract 1106.02, Walton County, Georgia",2580,432,2127,475,453,289
1500000US132971106031,132971106031,"Block Group 1, Census Tract 1106.03, Walton County, Georgia",869,261,670,260,199,96
1500000US132971106032,132971106032,"Block Group 2, Census Tract 1106.03, Walton County, Georgia",3683,367,2793,385,890,319
1500000US132971107001,132971107001,"Block Group 1, Census Tract 1107, Walton County, Georgia",1804,527,829,393,975,521
1500000US132971107002,132971107002,"Block Group 2, Census Tract 1107, Walton County, Georgia",2877,438,2271,470,606,299
1500000US132971107003,132971107003,"Block Group 3, Census Tract 1107, Walton County, Georgia",1503,448,189,110,1314,478
1500000US132971107004,132971107004,"Block Group 4, Census Tract 1107, Walton County, Georgia",907,372,506,267,401,278
1500000US132971108001,132971108001,"Block Group 1, Census Tract 1108, Walton County, Georgia",1792,480,1284,438,508,328
1500000US132971108002,132971108002,"Block Group 2, Census Tract 1108, Walton County, Georgia",1616,643,860,438,756,522
1500000US132971108003,132971108003,"Block Group 3, Census Tract 1108, Walton County, Georgia",1753,481,1492,409,261,293
1500000US132971108004,132971108004,"Block Group 4, Census Tract 1108, Walton County, Georgia",1723,448,1180,341,543,377
1500000US132999501001,132999501001,"Block Group 1, Census Tract 9501, Ware County, Georgia",1616,205,1344,187,272,150
1500000US132999502001,132999502001,"Block Group 1, Census Tract 9502, Ware County, Georgia",1303,457,866,373,437,316
1500000US132999502002,132999502002,"Block Group 2, Census Tract 9502, Ware County, Georgia",1403,322,1037,319,366,262
1500000US132999502003,132999502003,"Block Group 3, Census Tract 9502, Ware County, Georgia",1834,464,1218,441,616,345
1500000US132999502004,132999502004,"Block Group 4, Census Tract 9502, Ware County, Georgia",980,382,857,421,123,140
1500000US132999503001,132999503001,"Block Group 1, Census Tract 9503, Ware County, Georgia",750,202,464,169,286,126
1500000US132999503002,132999503002,"Block Group 2, Census Tract 9503, Ware County, Georgia",834,180,480,159,354,152
1500000US132999503003,132999503003,"Block Group 3, Census Tract 9503, Ware County, Georgia",343,131,262,123,81,53
1500000US132999504001,132999504001,"Block Group 1, Census Tract 9504, Ware County, Georgia",481,153,111,49,370,152
1500000US132999504002,132999504002,"Block Group 2, Census Tract 9504, Ware County, Georgia",545,149,228,74,317,132
1500000US132999504003,132999504003,"Block Group 3, Census Tract 9504, Ware County, Georgia",742,226,338,152,404,221
1500000US132999505001,132999505001,"Block Group 1, Census Tract 9505, Ware County, Georgia",1895,443,1475,450,420,244
1500000US132999505002,132999505002,"Block Group 2, Census Tract 9505, Ware County, Georgia",919,448,662,350,257,239
1500000US132999505003,132999505003,"Block Group 3, Census Tract 9505, Ware County, Georgia",974,318,508,302,466,325
1500000US132999505004,132999505004,"Block Group 4, Census Tract 9505, Ware County, Georgia",739,280,472,248,267,159
1500000US132999505005,132999505005,"Block Group 5, Census Tract 9505, Ware County, Georgia",798,407,544,314,254,295
1500000US132999506001,132999506001,"Block Group 1, Census Tract 9506, Ware County, Georgia",1657,359,1201,312,456,289
1500000US132999506002,132999506002,"Block Group 2, Census Tract 9506, Ware County, Georgia",1630,432,1232,345,398,369
1500000US132999506003,132999506003,"Block Group 3, Census Tract 9506, Ware County, Georgia",1384,368,241,168,1143,393
1500000US132999506004,132999506004,"Block Group 4, Census Tract 9506, Ware County, Georgia",659,404,363,191,296,375
1500000US132999506005,132999506005,"Block Group 5, Census Tract 9506, Ware County, Georgia",748,235,432,149,316,191
1500000US132999507001,132999507001,"Block Group 1, Census Tract 9507, Ware County, Georgia",407,136,285,132,122,67
1500000US132999507002,132999507002,"Block Group 2, Census Tract 9507, Ware County, Georgia",800,165,322,92,478,167
1500000US132999508001,132999508001,"Block Group 1, Census Tract 9508, Ware County, Georgia",711,353,335,195,376,324
1500000US132999508002,132999508002,"Block Group 2, Census Tract 9508, Ware County, Georgia",1252,377,924,298,328,266
1500000US132999508003,132999508003,"Block Group 3, Census Tract 9508, Ware County, Georgia",1234,459,232,209,1002,433
1500000US132999508004,132999508004,"Block Group 4, Census Tract 9508, Ware County, Georgia",313,163,313,163,0,13
1500000US132999508005,132999508005,"Block Group 5, Census Tract 9508, Ware County, Georgia",1418,409,926,348,492,291
1500000US132999508006,132999508006,"Block Group 6, Census Tract 9508, Ware County, Georgia",683,239,442,214,241,159
1500000US132999509001,132999509001,"Block Group 1, Census Tract 9509, Ware County, Georgia",1003,242,768,219,235,140
1500000US132999509002,132999509002,"Block Group 2, Census Tract 9509, Ware County, Georgia",737,249,527,179,210,207
1500000US132999509003,132999509003,"Block Group 3, Census Tract 9509, Ware County, Georgia",1379,325,1027,317,352,225
1500000US132999509004,132999509004,"Block Group 4, Census Tract 9509, Ware County, Georgia",1106,308,729,265,377,236
1500000US133019704001,133019704001,"Block Group 1, Census Tract 9704, Warren County, Georgia",877,188,376,95,501,170
1500000US133019704002,133019704002,"Block Group 2, Census Tract 9704, Warren County, Georgia",1190,224,664,160,526,192
1500000US133019704003,133019704003,"Block Group 3, Census Tract 9704, Warren County, Georgia",675,122,535,136,140,87
1500000US133019705001,133019705001,"Block Group 1, Census Tract 9705, Warren County, Georgia",1235,209,909,173,326,168
1500000US133019705002,133019705002,"Block Group 2, Census Tract 9705, Warren County, Georgia",776,189,538,146,238,137
1500000US133019705003,133019705003,"Block Group 3, Census Tract 9705, Warren County, Georgia",720,172,602,185,118,76
1500000US133039501001,133039501001,"Block Group 1, Census Tract 9501, Washington County, Georgia",860,171,682,153,178,131
1500000US133039501002,133039501002,"Block Group 2, Census Tract 9501, Washington County, Georgia",879,179,744,166,135,88
1500000US133039503001,133039503001,"Block Group 1, Census Tract 9503, Washington County, Georgia",1795,276,1064,267,731,215
1500000US133039503002,133039503002,"Block Group 2, Census Tract 9503, Washington County, Georgia",1282,336,624,205,658,296
1500000US133039503003,133039503003,"Block Group 3, Census Tract 9503, Washington County, Georgia",601,194,345,164,256,137
1500000US133039503004,133039503004,"Block Group 4, Census Tract 9503, Washington County, Georgia",550,151,389,128,161,130
1500000US133039504001,133039504001,"Block Group 1, Census Tract 9504, Washington County, Georgia",1808,459,1665,449,143,132
1500000US133039504002,133039504002,"Block Group 2, Census Tract 9504, Washington County, Georgia",973,364,762,319,211,196
1500000US133039504003,133039504003,"Block Group 3, Census Tract 9504, Washington County, Georgia",820,323,191,141,629,300
1500000US133039504004,133039504004,"Block Group 4, Census Tract 9504, Washington County, Georgia",1513,356,1220,358,293,210
1500000US133039505001,133039505001,"Block Group 1, Census Tract 9505, Washington County, Georgia",1000,204,686,172,314,156
1500000US133039505002,133039505002,"Block Group 2, Census Tract 9505, Washington County, Georgia",1359,300,1064,297,295,158
1500000US133039505003,133039505003,"Block Group 3, Census Tract 9505, Washington County, Georgia",1573,250,1231,233,342,136
1500000US133039507001,133039507001,"Block Group 1, Census Tract 9507, Washington County, Georgia",1695,272,1253,259,442,203
1500000US133039507002,133039507002,"Block Group 2, Census Tract 9507, Washington County, Georgia",947,252,427,166,520,229
1500000US133039507003,133039507003,"Block Group 3, Census Tract 9507, Washington County, Georgia",1461,324,851,212,610,256
1500000US133059701001,133059701001,"Block Group 1, Census Tract 9701, Wayne County, Georgia",1044,280,914,259,130,133
1500000US133059701002,133059701002,"Block Group 2, Census Tract 9701, Wayne County, Georgia",823,224,801,224,22,35
1500000US133059701003,133059701003,"Block Group 3, Census Tract 9701, Wayne County, Georgia",1009,267,959,250,50,77
1500000US133059701004,133059701004,"Block Group 4, Census Tract 9701, Wayne County, Georgia",1134,303,877,291,257,132
1500000US133059702001,133059702001,"Block Group 1, Census Tract 9702, Wayne County, Georgia",2671,562,1899,521,772,433
1500000US133059702002,133059702002,"Block Group 2, Census Tract 9702, Wayne County, Georgia",2847,660,2206,640,641,315
1500000US133059702003,133059702003,"Block Group 3, Census Tract 9702, Wayne County, Georgia",942,530,679,501,263,205
1500000US133059702004,133059702004,"Block Group 4, Census Tract 9702, Wayne County, Georgia",890,298,547,197,343,239
1500000US133059702005,133059702005,"Block Group 5, Census Tract 9702, Wayne County, Georgia",401,232,318,215,83,102
1500000US133059703001,133059703001,"Block Group 1, Census Tract 9703, Wayne County, Georgia",1224,305,641,206,583,225
1500000US133059703002,133059703002,"Block Group 2, Census Tract 9703, Wayne County, Georgia",1490,436,837,286,653,358
1500000US133059703003,133059703003,"Block Group 3, Census Tract 9703, Wayne County, Georgia",1518,365,484,176,1034,368
1500000US133059703004,133059703004,"Block Group 4, Census Tract 9703, Wayne County, Georgia",649,196,366,124,283,208
1500000US133059704001,133059704001,"Block Group 1, Census Tract 9704, Wayne County, Georgia",1840,260,1510,284,330,198
1500000US133059704002,133059704002,"Block Group 2, Census Tract 9704, Wayne County, Georgia",1128,278,895,251,233,169
1500000US133059704003,133059704003,"Block Group 3, Census Tract 9704, Wayne County, Georgia",706,199,377,132,329,142
1500000US133059705001,133059705001,"Block Group 1, Census Tract 9705, Wayne County, Georgia",1065,316,731,274,334,206
1500000US133059705002,133059705002,"Block Group 2, Census Tract 9705, Wayne County, Georgia",972,409,434,265,538,380
1500000US133059705003,133059705003,"Block Group 3, Census Tract 9705, Wayne County, Georgia",881,272,513,264,368,199
1500000US133059705004,133059705004,"Block Group 4, Census Tract 9705, Wayne County, Georgia",757,244,453,141,304,238
1500000US133059706001,133059706001,"Block Group 1, Census Tract 9706, Wayne County, Georgia",1910,398,1218,343,692,369
1500000US133059706002,133059706002,"Block Group 2, Census Tract 9706, Wayne County, Georgia",909,175,758,174,151,119
1500000US133059706003,133059706003,"Block Group 3, Census Tract 9706, Wayne County, Georgia",1085,227,872,218,213,152
1500000US133079601001,133079601001,"Block Group 1, Census Tract 9601, Webster County, Georgia",1420,146,1257,180,163,141
1500000US133079602001,133079602001,"Block Group 1, Census Tract 9602, Webster County, Georgia",1295,146,1092,149,203,91
1500000US133097801001,133097801001,"Block Group 1, Census Tract 7801, Wheeler County, Georgia",644,139,291,93,353,135
1500000US133097801002,133097801002,"Block Group 2, Census Tract 7801, Wheeler County, Georgia",527,155,230,106,297,121
1500000US133097801003,133097801003,"Block Group 3, Census Tract 7801, Wheeler County, Georgia",916,223,743,265,173,162
1500000US133097802001,133097802001,"Block Group 1, Census Tract 7802, Wheeler County, Georgia",513,165,305,145,208,94
1500000US133097802002,133097802002,"Block Group 2, Census Tract 7802, Wheeler County, Georgia",1207,273,1019,256,188,106
1500000US133097802003,133097802003,"Block Group 3, Census Tract 7802, Wheeler County, Georgia",542,178,340,132,202,108
1500000US133119501001,133119501001,"Block Group 1, Census Tract 9501, White County, Georgia",1460,316,1053,240,407,263
1500000US133119501002,133119501002,"Block Group 2, Census Tract 9501, White County, Georgia",1272,239,938,248,334,158
1500000US133119502011,133119502011,"Block Group 1, Census Tract 9502.01, White County, Georgia",2050,595,1574,575,476,467
1500000US133119502012,133119502012,"Block Group 2, Census Tract 9502.01, White County, Georgia",2963,594,1797,467,1166,565
1500000US133119502013,133119502013,"Block Group 3, Census Tract 9502.01, White County, Georgia",3594,855,2327,659,1267,765
1500000US133119502021,133119502021,"Block Group 1, Census Tract 9502.02, White County, Georgia",1343,242,1133,234,210,186
1500000US133119502022,133119502022,"Block Group 2, Census Tract 9502.02, White County, Georgia",1794,323,1573,297,221,122
1500000US133119502031,133119502031,"Block Group 1, Census Tract 9502.03, White County, Georgia",2854,565,2282,563,572,349
1500000US133119502032,133119502032,"Block Group 2, Census Tract 9502.03, White County, Georgia",2398,479,2151,457,247,251
1500000US133119503001,133119503001,"Block Group 1, Census Tract 9503, White County, Georgia",796,427,425,215,371,428
1500000US133119503002,133119503002,"Block Group 2, Census Tract 9503, White County, Georgia",4132,640,2906,606,1226,569
1500000US133119503003,133119503003,"Block Group 3, Census Tract 9503, White County, Georgia",2714,539,1880,481,834,429
1500000US133130001011,133130001011,"Block Group 1, Census Tract 1.01, Whitfield County, Georgia",1196,330,868,310,328,206
1500000US133130001012,133130001012,"Block Group 2, Census Tract 1.01, Whitfield County, Georgia",1648,489,1494,486,154,113
1500000US133130001013,133130001013,"Block Group 3, Census Tract 1.01, Whitfield County, Georgia",1133,290,987,286,146,95
1500000US133130001021,133130001021,"Block Group 1, Census Tract 1.02, Whitfield County, Georgia",1089,281,700,250,389,193
1500000US133130001022,133130001022,"Block Group 2, Census Tract 1.02, Whitfield County, Georgia",3451,566,2708,552,743,371
1500000US133130001023,133130001023,"Block Group 3, Census Tract 1.02, Whitfield County, Georgia",1514,575,930,277,584,531
1500000US133130001024,133130001024,"Block Group 4, Census Tract 1.02, Whitfield County, Georgia",2298,498,1387,483,911,359
1500000US133130002001,133130002001,"Block Group 1, Census Tract 2, Whitfield County, Georgia",1916,455,1222,303,694,333
1500000US133130002002,133130002002,"Block Group 2, Census Tract 2, Whitfield County, Georgia",965,241,790,244,175,114
1500000US133130002003,133130002003,"Block Group 3, Census Tract 2, Whitfield County, Georgia",1052,356,806,286,246,204
1500000US133130003011,133130003011,"Block Group 1, Census Tract 3.01, Whitfield County, Georgia",434,186,286,136,148,133
1500000US133130003012,133130003012,"Block Group 2, Census Tract 3.01, Whitfield County, Georgia",1094,341,551,224,543,319
1500000US133130003013,133130003013,"Block Group 3, Census Tract 3.01, Whitfield County, Georgia",2751,396,1911,391,840,358
1500000US133130003021,133130003021,"Block Group 1, Census Tract 3.02, Whitfield County, Georgia",1226,469,1215,469,11,19
1500000US133130003022,133130003022,"Block Group 2, Census Tract 3.02, Whitfield County, Georgia",3603,869,2333,605,1270,726
1500000US133130003023,133130003023,"Block Group 3, Census Tract 3.02, Whitfield County, Georgia",1819,540,1134,532,685,321
1500000US133130003024,133130003024,"Block Group 4, Census Tract 3.02, Whitfield County, Georgia",2603,503,2306,481,297,179
1500000US133130004001,133130004001,"Block Group 1, Census Tract 4, Whitfield County, Georgia",905,468,483,244,422,433
1500000US133130004002,133130004002,"Block Group 2, Census Tract 4, Whitfield County, Georgia",1089,623,431,322,658,539
1500000US133130004003,133130004003,"Block Group 3, Census Tract 4, Whitfield County, Georgia",1180,522,951,488,229,184
1500000US133130004004,133130004004,"Block Group 4, Census Tract 4, Whitfield County, Georgia",2536,845,1770,783,766,448
1500000US133130004005,133130004005,"Block Group 5, Census Tract 4, Whitfield County, Georgia",1590,603,781,467,809,427
1500000US133130004006,133130004006,"Block Group 6, Census Tract 4, Whitfield County, Georgia",511,238,186,151,325,202
1500000US133130005011,133130005011,"Block Group 1, Census Tract 5.01, Whitfield County, Georgia",965,493,928,492,37,25
1500000US133130005012,133130005012,"Block Group 2, Census Tract 5.01, Whitfield County, Georgia",2279,400,1562,378,717,251
1500000US133130005013,133130005013,"Block Group 3, Census Tract 5.01, Whitfield County, Georgia",974,270,760,308,214,133
1500000US133130005021,133130005021,"Block Group 1, Census Tract 5.02, Whitfield County, Georgia",1648,727,288,169,1360,724
1500000US133130005022,133130005022,"Block Group 2, Census Tract 5.02, Whitfield County, Georgia",630,300,202,145,428,268
1500000US133130005023,133130005023,"Block Group 3, Census Tract 5.02, Whitfield County, Georgia",1736,602,512,417,1224,457
1500000US133130005024,133130005024,"Block Group 4, Census Tract 5.02, Whitfield County, Georgia",1975,498,144,119,1831,517
1500000US133130006001,133130006001,"Block Group 1, Census Tract 6, Whitfield County, Georgia",2108,341,1601,315,507,177
1500000US133130006002,133130006002,"Block Group 2, Census Tract 6, Whitfield County, Georgia",1278,416,723,129,555,426
1500000US133130006003,133130006003,"Block Group 3, Census Tract 6, Whitfield County, Georgia",868,276,756,273,112,91
1500000US133130007001,133130007001,"Block Group 1, Census Tract 7, Whitfield County, Georgia",1143,327,934,279,209,189
1500000US133130007002,133130007002,"Block Group 2, Census Tract 7, Whitfield County, Georgia",1418,364,1128,319,290,227
1500000US133130007003,133130007003,"Block Group 3, Census Tract 7, Whitfield County, Georgia",1171,350,905,342,266,216
1500000US133130007004,133130007004,"Block Group 4, Census Tract 7, Whitfield County, Georgia",1030,285,470,210,560,265
1500000US133130008001,133130008001,"Block Group 1, Census Tract 8, Whitfield County, Georgia",2899,605,1291,327,1608,607
1500000US133130008002,133130008002,"Block Group 2, Census Tract 8, Whitfield County, Georgia",1418,384,1088,320,330,293
1500000US133130008003,133130008003,"Block Group 3, Census Tract 8, Whitfield County, Georgia",717,426,589,419,128,140
1500000US133130008004,133130008004,"Block Group 4, Census Tract 8, Whitfield County, Georgia",1151,354,995,372,156,155
1500000US133130008005,133130008005,"Block Group 5, Census Tract 8, Whitfield County, Georgia",1598,500,1319,487,279,251
1500000US133130009001,133130009001,"Block Group 1, Census Tract 9, Whitfield County, Georgia",486,146,331,150,155,95
1500000US133130009002,133130009002,"Block Group 2, Census Tract 9, Whitfield County, Georgia",1595,244,1158,198,437,250
1500000US133130009003,133130009003,"Block Group 3, Census Tract 9, Whitfield County, Georgia",1627,331,1069,219,558,294
1500000US133130010001,133130010001,"Block Group 1, Census Tract 10, Whitfield County, Georgia",1944,662,1191,518,753,441
1500000US133130010002,133130010002,"Block Group 2, Census Tract 10, Whitfield County, Georgia",1509,420,543,282,966,450
1500000US133130010003,133130010003,"Block Group 3, Census Tract 10, Whitfield County, Georgia",1031,435,398,261,633,370
1500000US133130011001,133130011001,"Block Group 1, Census Tract 11, Whitfield County, Georgia",592,219,312,103,280,216
1500000US133130011002,133130011002,"Block Group 2, Census Tract 11, Whitfield County, Georgia",1494,309,1324,310,170,103
1500000US133130011003,133130011003,"Block Group 3, Census Tract 11, Whitfield County, Georgia",1104,338,636,156,468,327
1500000US133130011004,133130011004,"Block Group 4, Census Tract 11, Whitfield County, Georgia",1838,498,1332,543,506,348
1500000US133130012001,133130012001,"Block Group 1, Census Tract 12, Whitfield County, Georgia",1517,476,1217,424,300,283
1500000US133130012002,133130012002,"Block Group 2, Census Tract 12, Whitfield County, Georgia",1453,424,672,232,781,435
1500000US133130012003,133130012003,"Block Group 3, Census Tract 12, Whitfield County, Georgia",1620,533,1098,441,522,308
1500000US133130012004,133130012004,"Block Group 4, Census Tract 12, Whitfield County, Georgia",1387,452,624,314,763,437
1500000US133130012005,133130012005,"Block Group 5, Census Tract 12, Whitfield County, Georgia",1079,469,467,269,612,415
1500000US133130012006,133130012006,"Block Group 6, Census Tract 12, Whitfield County, Georgia",747,451,354,346,393,408
1500000US133130013001,133130013001,"Block Group 1, Census Tract 13, Whitfield County, Georgia",2213,469,737,314,1476,403
1500000US133130013002,133130013002,"Block Group 2, Census Tract 13, Whitfield County, Georgia",499,272,208,143,291,258
1500000US133130013003,133130013003,"Block Group 3, Census Tract 13, Whitfield County, Georgia",1679,419,196,128,1483,433
1500000US133130014001,133130014001,"Block Group 1, Census Tract 14, Whitfield County, Georgia",1231,322,889,316,342,220
1500000US133130014002,133130014002,"Block Group 2, Census Tract 14, Whitfield County, Georgia",1979,549,1778,563,201,308
1500000US133130014003,133130014003,"Block Group 3, Census Tract 14, Whitfield County, Georgia",1389,475,832,297,557,353
1500000US133130014004,133130014004,"Block Group 4, Census Tract 14, Whitfield County, Georgia",534,346,343,298,191,260
1500000US133130014005,133130014005,"Block Group 5, Census Tract 14, Whitfield County, Georgia",1527,928,1353,898,174,226
1500000US133130015001,133130015001,"Block Group 1, Census Tract 15, Whitfield County, Georgia",1013,291,786,275,227,166
1500000US133130015002,133130015002,"Block Group 2, Census Tract 15, Whitfield County, Georgia",814,287,581,219,233,207
1500000US133130015003,133130015003,"Block Group 3, Census Tract 15, Whitfield County, Georgia",896,359,644,337,252,222
1500000US133130015004,133130015004,"Block Group 4, Census Tract 15, Whitfield County, Georgia",1068,399,955,415,113,89
1500000US133130015005,133130015005,"Block Group 5, Census Tract 15, Whitfield County, Georgia",1843,538,1574,559,269,202
1500000US133159601001,133159601001,"Block Group 1, Census Tract 9601, Wilcox County, Georgia",1203,177,623,159,580,152
1500000US133159601002,133159601002,"Block Group 2, Census Tract 9601, Wilcox County, Georgia",854,182,748,170,106,92
1500000US133159602001,133159602001,"Block Group 1, Census Tract 9602, Wilcox County, Georgia",1360,158,996,172,364,131
1500000US133159603001,133159603001,"Block Group 1, Census Tract 9603, Wilcox County, Georgia",1431,188,1076,183,355,137
1500000US133159604001,133159604001,"Block Group 1, Census Tract 9604, Wilcox County, Georgia",1397,202,1005,192,392,165
1500000US133159604002,133159604002,"Block Group 2, Census Tract 9604, Wilcox County, Georgia",678,171,521,159,157,93
1500000US133170101011,133170101011,"Block Group 1, Census Tract 101.01, Wilkes County, Georgia",795,136,602,121,193,80
1500000US133170101012,133170101012,"Block Group 2, Census Tract 101.01, Wilkes County, Georgia",778,181,659,187,119,77
1500000US133170101021,133170101021,"Block Group 1, Census Tract 101.02, Wilkes County, Georgia",763,205,439,140,324,163
1500000US133170101022,133170101022,"Block Group 2, Census Tract 101.02, Wilkes County, Georgia",820,217,545,160,275,126
1500000US133170103011,133170103011,"Block Group 1, Census Tract 103.01, Wilkes County, Georgia",1228,234,951,185,277,179
1500000US133170103012,133170103012,"Block Group 2, Census Tract 103.01, Wilkes County, Georgia",1065,213,852,224,213,119
1500000US133170103021,133170103021,"Block Group 1, Census Tract 103.02, Wilkes County, Georgia",1533,255,899,246,634,254
1500000US133170103022,133170103022,"Block Group 2, Census Tract 103.02, Wilkes County, Georgia",791,226,627,197,164,145
1500000US133170103023,133170103023,"Block Group 3, Census Tract 103.02, Wilkes County, Georgia",503,220,427,184,76,105
1500000US133170103024,133170103024,"Block Group 4, Census Tract 103.02, Wilkes County, Georgia",775,199,387,143,388,164
1500000US133170103025,133170103025,"Block Group 5, Census Tract 103.02, Wilkes County, Georgia",762,183,436,188,326,147
1500000US133199602001,133199602001,"Block Group 1, Census Tract 9602, Wilkinson County, Georgia",1392,263,1095,235,297,141
1500000US133199602002,133199602002,"Block Group 2, Census Tract 9602, Wilkinson County, Georgia",1055,211,791,170,264,153
1500000US133199602003,133199602003,"Block Group 3, Census Tract 9602, Wilkinson County, Georgia",701,151,527,120,174,98
1500000US133199603001,133199603001,"Block Group 1, Census Tract 9603, Wilkinson County, Georgia",662,192,498,171,164,128
1500000US133199603002,133199603002,"Block Group 2, Census Tract 9603, Wilkinson County, Georgia",1147,220,852,197,295,144
1500000US133199603003,133199603003,"Block Group 3, Census Tract 9603, Wilkinson County, Georgia",1386,208,757,187,629,201
1500000US133199603004,133199603004,"Block Group 4, Census Tract 9603, Wilkinson County, Georgia",1324,205,1159,200,165,71
1500000US133199604001,133199604001,"Block Group 1, Census Tract 9604, Wilkinson County, Georgia",1065,180,979,176,86,34
1500000US133199604002,133199604002,"Block Group 2, Census Tract 9604, Wilkinson County, Georgia",542,108,414,100,128,71
1500000US133219501001,133219501001,"Block Group 1, Census Tract 9501, Worth County, Georgia",822,196,635,178,187,100
1500000US133219501002,133219501002,"Block Group 2, Census Tract 9501, Worth County, Georgia",2006,296,1538,311,468,255
1500000US133219502001,133219502001,"Block Group 1, Census Tract 9502, Worth County, Georgia",1693,477,1426,465,267,191
1500000US133219502002,133219502002,"Block Group 2, Census Tract 9502, Worth County, Georgia",2592,420,2391,431,201,179
1500000US133219502003,133219502003,"Block Group 3, Census Tract 9502, Worth County, Georgia",1304,366,813,352,491,313
1500000US133219502004,133219502004,"Block Group 4, Census Tract 9502, Worth County, Georgia",1473,375,959,356,514,221
1500000US133219504001,133219504001,"Block Group 1, Census Tract 9504, Worth County, Georgia",1905,349,1272,254,633,263
1500000US133219504002,133219504002,"Block Group 2, Census Tract 9504, Worth County, Georgia",651,183,422,163,229,137
1500000US133219504003,133219504003,"Block Group 3, Census Tract 9504, Worth County, Georgia",1012,230,904,240,108,97
1500000US133219504004,133219504004,"Block Group 4, Census Tract 9504, Worth County, Georgia",1253,301,1069,287,184,89
1500000US133219505001,133219505001,"Block Group 1, Census Tract 9505, Worth County, Georgia",1601,306,1149,206,452,205
1500000US133219505002,133219505002,"Block Group 2, Census Tract 9505, Worth County, Georgia",1134,377,686,231,448,294
1500000US133219505003,133219505003,"Block Group 3, Census Tract 9505, Worth County, Georgia",1396,334,548,253,848,299
1500000US133219506001,133219506001,"Block Group 1, Census Tract 9506, Worth County, Georgia",1295,305,1008,301,287,152
1500000US133219506002,133219506002,"Block Group 2, Census Tract 9506, Worth County, Georgia",860,298,544,164,316,279
