Id,Id2,Geography,Estimate; Total:,Margin of Error; Total:,Estimate; Total: - Not Hispanic or Latino,Margin of Error; Total: - Not Hispanic or Latino,Estimate; Total: - Hispanic or Latino,Margin of Error; Total: - Hispanic or Latino
1500000US130019501001,130019501001,"Block Group 1, Census Tract 9501, Appling County, Georgia",912,296,912,296,0,13
1500000US130019501002,130019501002,"Block Group 2, Census Tract 9501, Appling County, Georgia",2498,342,2498,342,0,13
1500000US130019502001,130019502001,"Block Group 1, Census Tract 9502, Appling County, Georgia",2036,438,1722,366,314,319
1500000US130019502002,130019502002,"Block Group 2, Census Tract 9502, Appling County, Georgia",1593,389,1371,356,222,198
1500000US130019502003,130019502003,"Block Group 3, Census Tract 9502, Appling County, Georgia",1036,284,1036,284,0,13
1500000US130019503001,130019503001,"Block Group 1, Census Tract 9503, Appling County, Georgia",708,284,708,284,0,13
1500000US130019503002,130019503002,"Block Group 2, Census Tract 9503, Appling County, Georgia",1585,407,1338,364,247,218
1500000US130019503003,130019503003,"Block Group 3, Census Tract 9503, Appling County, Georgia",1085,299,1034,287,51,72
1500000US130019503004,130019503004,"Block Group 4, Census Tract 9503, Appling County, Georgia",1493,365,1204,282,289,293
1500000US130019504001,130019504001,"Block Group 1, Census Tract 9504, Appling County, Georgia",755,199,741,198,14,18
1500000US130019504002,130019504002,"Block Group 2, Census Tract 9504, Appling County, Georgia",698,159,685,157,13,19
1500000US130019505001,130019505001,"Block Group 1, Census Tract 9505, Appling County, Georgia",695,176,695,176,0,13
1500000US130019505002,130019505002,"Block Group 2, Census Tract 9505, Appling County, Georgia",1678,330,1634,331,44,63
1500000US130019505003,130019505003,"Block Group 3, Census Tract 9505, Appling County, Georgia",1645,463,1116,265,529,383
1500000US130039601001,130039601001,"Block Group 1, Census Tract 9601, Atkinson County, Georgia",1031,215,827,193,204,114
1500000US130039601002,130039601002,"Block Group 2, Census Tract 9601, Atkinson County, Georgia",1054,235,717,166,337,169
1500000US130039602001,130039602001,"Block Group 1, Census Tract 9602, Atkinson County, Georgia",2046,390,1387,251,659,269
1500000US130039602002,130039602002,"Block Group 2, Census Tract 9602, Atkinson County, Georgia",1072,278,740,250,332,153
1500000US130039602003,130039602003,"Block Group 3, Census Tract 9602, Atkinson County, Georgia",1784,337,1448,280,336,162
1500000US130039603001,130039603001,"Block Group 1, Census Tract 9603, Atkinson County, Georgia",1307,205,1165,189,142,91
1500000US130059701001,130059701001,"Block Group 1, Census Tract 9701, Bacon County, Georgia",1527,291,1257,283,270,229
1500000US130059701002,130059701002,"Block Group 2, Census Tract 9701, Bacon County, Georgia",820,194,795,188,25,42
1500000US130059701003,130059701003,"Block Group 3, Census Tract 9701, Bacon County, Georgia",741,212,741,212,0,13
1500000US130059702011,130059702011,"Block Group 1, Census Tract 9702.01, Bacon County, Georgia",1562,247,1498,264,64,71
1500000US130059702012,130059702012,"Block Group 2, Census Tract 9702.01, Bacon County, Georgia",1161,298,828,214,333,207
1500000US130059702013,130059702013,"Block Group 3, Census Tract 9702.01, Bacon County, Georgia",1287,198,1287,198,0,13
1500000US130059702021,130059702021,"Block Group 1, Census Tract 9702.02, Bacon County, Georgia",2324,348,2163,326,161,124
1500000US130059702022,130059702022,"Block Group 2, Census Tract 9702.02, Bacon County, Georgia",1251,270,1225,263,26,26
1500000US130059702023,130059702023,"Block Group 3, Census Tract 9702.02, Bacon County, Georgia",549,194,549,194,0,13
1500000US130079601001,130079601001,"Block Group 1, Census Tract 9601, Baker County, Georgia",815,210,811,210,4,6
1500000US130079601002,130079601002,"Block Group 2, Census Tract 9601, Baker County, Georgia",1394,222,1356,216,38,36
1500000US130079602001,130079602001,"Block Group 1, Census Tract 9602, Baker County, Georgia",468,121,446,120,22,37
1500000US130079602002,130079602002,"Block Group 2, Census Tract 9602, Baker County, Georgia",615,145,615,145,0,13
1500000US130099701001,130099701001,"Block Group 1, Census Tract 9701, Baldwin County, Georgia",1461,290,1461,290,0,13
1500000US130099701002,130099701002,"Block Group 2, Census Tract 9701, Baldwin County, Georgia",1264,350,1264,350,0,13
1500000US130099701003,130099701003,"Block Group 3, Census Tract 9701, Baldwin County, Georgia",2489,506,2366,507,123,168
1500000US130099702001,130099702001,"Block Group 1, Census Tract 9702, Baldwin County, Georgia",1025,399,855,361,170,187
1500000US130099702002,130099702002,"Block Group 2, Census Tract 9702, Baldwin County, Georgia",2291,388,2267,396,24,48
1500000US130099702003,130099702003,"Block Group 3, Census Tract 9702, Baldwin County, Georgia",2092,458,2073,457,19,24
1500000US130099702004,130099702004,"Block Group 4, Census Tract 9702, Baldwin County, Georgia",313,231,313,231,0,13
1500000US130099702005,130099702005,"Block Group 5, Census Tract 9702, Baldwin County, Georgia",803,381,778,373,25,42
1500000US130099703001,130099703001,"Block Group 1, Census Tract 9703, Baldwin County, Georgia",2826,433,2757,418,69,76
1500000US130099703002,130099703002,"Block Group 2, Census Tract 9703, Baldwin County, Georgia",3535,562,3391,553,144,150
1500000US130099704001,130099704001,"Block Group 1, Census Tract 9704, Baldwin County, Georgia",1106,279,1043,282,63,65
1500000US130099704002,130099704002,"Block Group 2, Census Tract 9704, Baldwin County, Georgia",1177,357,1165,358,12,20
1500000US130099704003,130099704003,"Block Group 3, Census Tract 9704, Baldwin County, Georgia",1003,319,981,312,22,32
1500000US130099704004,130099704004,"Block Group 4, Census Tract 9704, Baldwin County, Georgia",241,116,241,116,0,13
1500000US130099704005,130099704005,"Block Group 5, Census Tract 9704, Baldwin County, Georgia",1399,422,1383,419,16,26
1500000US130099705001,130099705001,"Block Group 1, Census Tract 9705, Baldwin County, Georgia",3454,783,3277,781,177,97
1500000US130099705002,130099705002,"Block Group 2, Census Tract 9705, Baldwin County, Georgia",544,228,544,228,0,13
1500000US130099705003,130099705003,"Block Group 3, Census Tract 9705, Baldwin County, Georgia",2393,609,2393,609,0,13
1500000US130099706001,130099706001,"Block Group 1, Census Tract 9706, Baldwin County, Georgia",1214,294,1214,294,0,13
1500000US130099706002,130099706002,"Block Group 2, Census Tract 9706, Baldwin County, Georgia",857,230,857,230,0,13
1500000US130099706003,130099706003,"Block Group 3, Census Tract 9706, Baldwin County, Georgia",694,266,694,266,0,13
1500000US130099706004,130099706004,"Block Group 4, Census Tract 9706, Baldwin County, Georgia",886,252,886,252,0,13
1500000US130099707011,130099707011,"Block Group 1, Census Tract 9707.01, Baldwin County, Georgia",823,218,823,218,0,13
1500000US130099707012,130099707012,"Block Group 2, Census Tract 9707.01, Baldwin County, Georgia",440,141,440,141,0,13
1500000US130099707013,130099707013,"Block Group 3, Census Tract 9707.01, Baldwin County, Georgia",1722,342,1722,342,0,13
1500000US130099707021,130099707021,"Block Group 1, Census Tract 9707.02, Baldwin County, Georgia",1189,326,1186,326,3,6
1500000US130099707022,130099707022,"Block Group 2, Census Tract 9707.02, Baldwin County, Georgia",1136,268,1110,277,26,31
1500000US130099708001,130099708001,"Block Group 1, Census Tract 9708, Baldwin County, Georgia",1792,300,1725,298,67,44
1500000US130099708002,130099708002,"Block Group 2, Census Tract 9708, Baldwin County, Georgia",3044,647,3044,647,0,13
1500000US130099708003,130099708003,"Block Group 3, Census Tract 9708, Baldwin County, Georgia",1257,456,1245,460,12,19
1500000US130099708004,130099708004,"Block Group 4, Census Tract 9708, Baldwin County, Georgia",1325,464,1325,464,0,13
1500000US130119701001,130119701001,"Block Group 1, Census Tract 9701, Banks County, Georgia",2360,479,2002,436,358,168
1500000US130119701002,130119701002,"Block Group 2, Census Tract 9701, Banks County, Georgia",2909,423,2694,376,215,191
1500000US130119702001,130119702001,"Block Group 1, Census Tract 9702, Banks County, Georgia",2555,337,2478,336,77,69
1500000US130119702002,130119702002,"Block Group 2, Census Tract 9702, Banks County, Georgia",2458,263,2436,267,22,30
1500000US130119703001,130119703001,"Block Group 1, Census Tract 9703, Banks County, Georgia",1475,241,1453,233,22,34
1500000US130119703002,130119703002,"Block Group 2, Census Tract 9703, Banks County, Georgia",2691,341,2691,341,0,13
1500000US130119704001,130119704001,"Block Group 1, Census Tract 9704, Banks County, Georgia",3888,367,3424,361,464,265
1500000US130131801031,130131801031,"Block Group 1, Census Tract 1801.03, Barrow County, Georgia",4674,500,4428,496,246,197
1500000US130131801041,130131801041,"Block Group 1, Census Tract 1801.04, Barrow County, Georgia",1976,249,1791,252,185,155
1500000US130131801051,130131801051,"Block Group 1, Census Tract 1801.05, Barrow County, Georgia",2802,310,2570,243,232,209
1500000US130131801061,130131801061,"Block Group 1, Census Tract 1801.06, Barrow County, Georgia",1946,314,1740,314,206,140
1500000US130131801062,130131801062,"Block Group 2, Census Tract 1801.06, Barrow County, Georgia",885,208,833,214,52,62
1500000US130131801071,130131801071,"Block Group 1, Census Tract 1801.07, Barrow County, Georgia",1214,350,1194,343,20,34
1500000US130131801072,130131801072,"Block Group 2, Census Tract 1801.07, Barrow County, Georgia",2639,456,2136,380,503,324
1500000US130131801081,130131801081,"Block Group 1, Census Tract 1801.08, Barrow County, Georgia",1568,324,1463,321,105,110
1500000US130131801082,130131801082,"Block Group 2, Census Tract 1801.08, Barrow County, Georgia",1634,383,1562,402,72,80
1500000US130131802031,130131802031,"Block Group 1, Census Tract 1802.03, Barrow County, Georgia",1827,456,1562,412,265,247
1500000US130131802032,130131802032,"Block Group 2, Census Tract 1802.03, Barrow County, Georgia",1594,398,1166,304,428,293
1500000US130131802041,130131802041,"Block Group 1, Census Tract 1802.04, Barrow County, Georgia",1165,239,1053,233,112,84
1500000US130131802042,130131802042,"Block Group 2, Census Tract 1802.04, Barrow County, Georgia",1567,322,1352,348,215,203
1500000US130131802051,130131802051,"Block Group 1, Census Tract 1802.05, Barrow County, Georgia",1196,352,1065,333,131,124
1500000US130131802052,130131802052,"Block Group 2, Census Tract 1802.05, Barrow County, Georgia",653,357,638,363,15,20
1500000US130131802053,130131802053,"Block Group 3, Census Tract 1802.05, Barrow County, Georgia",2540,400,2417,403,123,129
1500000US130131802061,130131802061,"Block Group 1, Census Tract 1802.06, Barrow County, Georgia",1358,329,1350,326,8,13
1500000US130131802062,130131802062,"Block Group 2, Census Tract 1802.06, Barrow County, Georgia",1358,336,1226,319,132,146
1500000US130131803011,130131803011,"Block Group 1, Census Tract 1803.01, Barrow County, Georgia",2167,175,2049,170,118,101
1500000US130131803021,130131803021,"Block Group 1, Census Tract 1803.02, Barrow County, Georgia",2276,527,2050,502,226,193
1500000US130131803022,130131803022,"Block Group 2, Census Tract 1803.02, Barrow County, Georgia",3231,496,3133,493,98,120
1500000US130131803031,130131803031,"Block Group 1, Census Tract 1803.03, Barrow County, Georgia",2334,426,2054,401,280,281
1500000US130131803032,130131803032,"Block Group 2, Census Tract 1803.03, Barrow County, Georgia",1989,362,1841,361,148,169
1500000US130131804011,130131804011,"Block Group 1, Census Tract 1804.01, Barrow County, Georgia",1852,439,1852,439,0,13
1500000US130131804012,130131804012,"Block Group 2, Census Tract 1804.01, Barrow County, Georgia",3616,624,3415,657,201,193
1500000US130131804021,130131804021,"Block Group 1, Census Tract 1804.02, Barrow County, Georgia",1197,650,1095,655,102,106
1500000US130131804022,130131804022,"Block Group 2, Census Tract 1804.02, Barrow County, Georgia",4149,544,3502,499,647,143
1500000US130131804023,130131804023,"Block Group 3, Census Tract 1804.02, Barrow County, Georgia",747,182,747,182,0,13
1500000US130131805011,130131805011,"Block Group 1, Census Tract 1805.01, Barrow County, Georgia",5718,537,4986,440,732,381
1500000US130131805021,130131805021,"Block Group 1, Census Tract 1805.02, Barrow County, Georgia",1667,365,1461,302,206,192
1500000US130131805022,130131805022,"Block Group 2, Census Tract 1805.02, Barrow County, Georgia",1451,378,1436,373,15,25
1500000US130131805023,130131805023,"Block Group 3, Census Tract 1805.02, Barrow County, Georgia",1064,320,974,306,90,119
1500000US130131805024,130131805024,"Block Group 4, Census Tract 1805.02, Barrow County, Georgia",366,146,366,146,0,13
1500000US130131805031,130131805031,"Block Group 1, Census Tract 1805.03, Barrow County, Georgia",5592,856,4688,425,904,769
1500000US130159601011,130159601011,"Block Group 1, Census Tract 9601.01, Bartow County, Georgia",1474,221,1453,220,21,37
1500000US130159601021,130159601021,"Block Group 1, Census Tract 9601.02, Bartow County, Georgia",3913,824,3681,789,232,193
1500000US130159601022,130159601022,"Block Group 2, Census Tract 9601.02, Bartow County, Georgia",2919,580,2854,567,65,96
1500000US130159601023,130159601023,"Block Group 3, Census Tract 9601.02, Bartow County, Georgia",2386,508,2246,495,140,239
1500000US130159602001,130159602001,"Block Group 1, Census Tract 9602, Bartow County, Georgia",2727,697,2594,712,133,205
1500000US130159602002,130159602002,"Block Group 2, Census Tract 9602, Bartow County, Georgia",1029,392,888,428,141,207
1500000US130159602003,130159602003,"Block Group 3, Census Tract 9602, Bartow County, Georgia",2579,669,2482,656,97,161
1500000US130159602004,130159602004,"Block Group 4, Census Tract 9602, Bartow County, Georgia",3156,529,2995,509,161,182
1500000US130159602005,130159602005,"Block Group 5, Census Tract 9602, Bartow County, Georgia",2260,712,2118,675,142,175
1500000US130159603001,130159603001,"Block Group 1, Census Tract 9603, Bartow County, Georgia",3139,553,2768,564,371,371
1500000US130159603002,130159603002,"Block Group 2, Census Tract 9603, Bartow County, Georgia",3501,588,3365,589,136,103
1500000US130159604011,130159604011,"Block Group 1, Census Tract 9604.01, Bartow County, Georgia",1259,495,1259,495,0,13
1500000US130159604012,130159604012,"Block Group 2, Census Tract 9604.01, Bartow County, Georgia",4563,1088,4107,1037,456,443
1500000US130159604013,130159604013,"Block Group 3, Census Tract 9604.01, Bartow County, Georgia",3565,829,2968,629,597,479
1500000US130159604021,130159604021,"Block Group 1, Census Tract 9604.02, Bartow County, Georgia",1627,457,1580,445,47,59
1500000US130159604022,130159604022,"Block Group 2, Census Tract 9604.02, Bartow County, Georgia",3594,907,3594,907,0,13
1500000US130159604023,130159604023,"Block Group 3, Census Tract 9604.02, Bartow County, Georgia",3631,618,3291,629,340,217
1500000US130159605001,130159605001,"Block Group 1, Census Tract 9605, Bartow County, Georgia",1342,500,1087,321,255,335
1500000US130159605002,130159605002,"Block Group 2, Census Tract 9605, Bartow County, Georgia",1317,402,1174,365,143,199
1500000US130159605003,130159605003,"Block Group 3, Census Tract 9605, Bartow County, Georgia",1779,604,1459,602,320,269
1500000US130159605004,130159605004,"Block Group 4, Census Tract 9605, Bartow County, Georgia",3724,647,3586,619,138,129
1500000US130159606001,130159606001,"Block Group 1, Census Tract 9606, Bartow County, Georgia",2025,795,1388,483,637,647
1500000US130159606002,130159606002,"Block Group 2, Census Tract 9606, Bartow County, Georgia",487,197,487,197,0,13
1500000US130159606003,130159606003,"Block Group 3, Census Tract 9606, Bartow County, Georgia",872,357,610,253,262,307
1500000US130159606004,130159606004,"Block Group 4, Census Tract 9606, Bartow County, Georgia",1408,359,1344,336,64,89
1500000US130159606005,130159606005,"Block Group 5, Census Tract 9606, Bartow County, Georgia",4008,802,3778,716,230,334
1500000US130159606006,130159606006,"Block Group 6, Census Tract 9606, Bartow County, Georgia",523,238,523,238,0,13
1500000US130159607001,130159607001,"Block Group 1, Census Tract 9607, Bartow County, Georgia",1655,490,1598,498,57,88
1500000US130159607002,130159607002,"Block Group 2, Census Tract 9607, Bartow County, Georgia",2143,493,1467,520,676,413
1500000US130159607003,130159607003,"Block Group 3, Census Tract 9607, Bartow County, Georgia",1912,593,1888,591,24,39
1500000US130159607004,130159607004,"Block Group 4, Census Tract 9607, Bartow County, Georgia",1018,414,973,403,45,73
1500000US130159607005,130159607005,"Block Group 5, Census Tract 9607, Bartow County, Georgia",544,257,443,194,101,144
1500000US130159608011,130159608011,"Block Group 1, Census Tract 9608.01, Bartow County, Georgia",1152,421,1152,421,0,13
1500000US130159608012,130159608012,"Block Group 2, Census Tract 9608.01, Bartow County, Georgia",2333,379,2051,353,282,233
1500000US130159608021,130159608021,"Block Group 1, Census Tract 9608.02, Bartow County, Georgia",1712,321,1223,372,489,318
1500000US130159608022,130159608022,"Block Group 2, Census Tract 9608.02, Bartow County, Georgia",1111,369,1110,368,1,2
1500000US130159608031,130159608031,"Block Group 1, Census Tract 9608.03, Bartow County, Georgia",1756,372,1741,373,15,13
1500000US130159608032,130159608032,"Block Group 2, Census Tract 9608.03, Bartow County, Georgia",1181,351,1181,351,0,13
1500000US130159608033,130159608033,"Block Group 3, Census Tract 9608.03, Bartow County, Georgia",2785,371,2550,340,235,150
1500000US130159609011,130159609011,"Block Group 1, Census Tract 9609.01, Bartow County, Georgia",975,275,918,262,57,79
1500000US130159609012,130159609012,"Block Group 2, Census Tract 9609.01, Bartow County, Georgia",2261,288,2101,301,160,142
1500000US130159609021,130159609021,"Block Group 1, Census Tract 9609.02, Bartow County, Georgia",2467,455,2403,447,64,105
1500000US130159609022,130159609022,"Block Group 2, Census Tract 9609.02, Bartow County, Georgia",953,290,921,285,32,51
1500000US130159609023,130159609023,"Block Group 3, Census Tract 9609.02, Bartow County, Georgia",1044,297,1000,281,44,57
1500000US130159609024,130159609024,"Block Group 4, Census Tract 9609.02, Bartow County, Georgia",1850,571,1522,477,328,287
1500000US130159610001,130159610001,"Block Group 1, Census Tract 9610, Bartow County, Georgia",770,247,770,247,0,13
1500000US130159610002,130159610002,"Block Group 2, Census Tract 9610, Bartow County, Georgia",1922,471,1768,483,154,230
1500000US130159610003,130159610003,"Block Group 3, Census Tract 9610, Bartow County, Georgia",2409,670,2324,651,85,89
1500000US130159610004,130159610004,"Block Group 4, Census Tract 9610, Bartow County, Georgia",2576,642,2507,653,69,108
1500000US130179601001,130179601001,"Block Group 1, Census Tract 9601, Ben Hill County, Georgia",2674,315,2674,315,0,13
1500000US130179602001,130179602001,"Block Group 1, Census Tract 9602, Ben Hill County, Georgia",1730,217,1676,201,54,57
1500000US130179603001,130179603001,"Block Group 1, Census Tract 9603, Ben Hill County, Georgia",1165,262,1165,262,0,13
1500000US130179603002,130179603002,"Block Group 2, Census Tract 9603, Ben Hill County, Georgia",533,219,415,204,118,145
1500000US130179603003,130179603003,"Block Group 3, Census Tract 9603, Ben Hill County, Georgia",1075,356,937,334,138,181
1500000US130179603004,130179603004,"Block Group 4, Census Tract 9603, Ben Hill County, Georgia",521,228,521,228,0,13
1500000US130179604001,130179604001,"Block Group 1, Census Tract 9604, Ben Hill County, Georgia",1766,413,1193,373,573,222
1500000US130179604002,130179604002,"Block Group 2, Census Tract 9604, Ben Hill County, Georgia",1104,382,1104,382,0,13
1500000US130179604003,130179604003,"Block Group 3, Census Tract 9604, Ben Hill County, Georgia",248,133,139,65,109,136
1500000US130179604004,130179604004,"Block Group 4, Census Tract 9604, Ben Hill County, Georgia",858,296,858,296,0,13
1500000US130179605001,130179605001,"Block Group 1, Census Tract 9605, Ben Hill County, Georgia",1231,298,1217,290,14,29
1500000US130179605002,130179605002,"Block Group 2, Census Tract 9605, Ben Hill County, Georgia",1322,501,1309,499,13,20
1500000US130179605003,130179605003,"Block Group 3, Census Tract 9605, Ben Hill County, Georgia",1176,359,1176,359,0,13
1500000US130179605004,130179605004,"Block Group 4, Census Tract 9605, Ben Hill County, Georgia",1162,416,1114,407,48,62
1500000US130179605005,130179605005,"Block Group 5, Census Tract 9605, Ben Hill County, Georgia",912,284,898,279,14,24
1500000US130199701001,130199701001,"Block Group 1, Census Tract 9701, Berrien County, Georgia",850,181,823,181,27,38
1500000US130199701002,130199701002,"Block Group 2, Census Tract 9701, Berrien County, Georgia",994,226,994,226,0,13
1500000US130199702001,130199702001,"Block Group 1, Census Tract 9702, Berrien County, Georgia",2022,438,1770,397,252,149
1500000US130199702002,130199702002,"Block Group 2, Census Tract 9702, Berrien County, Georgia",1834,369,1617,363,217,127
1500000US130199703001,130199703001,"Block Group 1, Census Tract 9703, Berrien County, Georgia",1037,255,873,199,164,146
1500000US130199703002,130199703002,"Block Group 2, Census Tract 9703, Berrien County, Georgia",1275,300,1243,298,32,37
1500000US130199703003,130199703003,"Block Group 3, Census Tract 9703, Berrien County, Georgia",911,257,906,258,5,8
1500000US130199704001,130199704001,"Block Group 1, Census Tract 9704, Berrien County, Georgia",843,249,843,249,0,13
1500000US130199704002,130199704002,"Block Group 2, Census Tract 9704, Berrien County, Georgia",803,294,747,287,56,72
1500000US130199704003,130199704003,"Block Group 3, Census Tract 9704, Berrien County, Georgia",1217,371,1217,371,0,13
1500000US130199705001,130199705001,"Block Group 1, Census Tract 9705, Berrien County, Georgia",859,257,850,257,9,16
1500000US130199705002,130199705002,"Block Group 2, Census Tract 9705, Berrien County, Georgia",2627,367,2510,368,117,93
1500000US130199706001,130199706001,"Block Group 1, Census Tract 9706, Berrien County, Georgia",1198,278,1184,283,14,25
1500000US130199706002,130199706002,"Block Group 2, Census Tract 9706, Berrien County, Georgia",1697,303,1696,303,1,2
1500000US130199706003,130199706003,"Block Group 3, Census Tract 9706, Berrien County, Georgia",852,229,816,229,36,35
1500000US130210101001,130210101001,"Block Group 1, Census Tract 101, Bibb County, Georgia",630,244,620,239,10,16
1500000US130210101002,130210101002,"Block Group 2, Census Tract 101, Bibb County, Georgia",865,250,865,250,0,13
1500000US130210102001,130210102001,"Block Group 1, Census Tract 102, Bibb County, Georgia",420,186,420,186,0,13
1500000US130210102002,130210102002,"Block Group 2, Census Tract 102, Bibb County, Georgia",572,172,551,175,21,35
1500000US130210102003,130210102003,"Block Group 3, Census Tract 102, Bibb County, Georgia",949,188,913,175,36,41
1500000US130210103001,130210103001,"Block Group 1, Census Tract 103, Bibb County, Georgia",767,157,767,157,0,13
1500000US130210104001,130210104001,"Block Group 1, Census Tract 104, Bibb County, Georgia",421,169,399,171,22,37
1500000US130210104002,130210104002,"Block Group 2, Census Tract 104, Bibb County, Georgia",433,190,433,190,0,13
1500000US130210104003,130210104003,"Block Group 3, Census Tract 104, Bibb County, Georgia",588,229,588,229,0,13
1500000US130210104004,130210104004,"Block Group 4, Census Tract 104, Bibb County, Georgia",808,295,808,295,0,13
1500000US130210105001,130210105001,"Block Group 1, Census Tract 105, Bibb County, Georgia",3360,284,3324,278,36,32
1500000US130210105002,130210105002,"Block Group 2, Census Tract 105, Bibb County, Georgia",446,168,446,168,0,13
1500000US130210108001,130210108001,"Block Group 1, Census Tract 108, Bibb County, Georgia",1464,210,1405,205,59,60
1500000US130210110001,130210110001,"Block Group 1, Census Tract 110, Bibb County, Georgia",527,278,513,277,14,20
1500000US130210110002,130210110002,"Block Group 2, Census Tract 110, Bibb County, Georgia",1890,514,1774,456,116,170
1500000US130210110003,130210110003,"Block Group 3, Census Tract 110, Bibb County, Georgia",615,456,615,456,0,13
1500000US130210110004,130210110004,"Block Group 4, Census Tract 110, Bibb County, Georgia",674,242,621,221,53,86
1500000US130210110005,130210110005,"Block Group 5, Census Tract 110, Bibb County, Georgia",913,334,913,334,0,13
1500000US130210111001,130210111001,"Block Group 1, Census Tract 111, Bibb County, Georgia",877,203,877,203,0,13
1500000US130210111002,130210111002,"Block Group 2, Census Tract 111, Bibb County, Georgia",665,203,665,203,0,13
1500000US130210111003,130210111003,"Block Group 3, Census Tract 111, Bibb County, Georgia",391,129,391,129,0,13
1500000US130210115001,130210115001,"Block Group 1, Census Tract 115, Bibb County, Georgia",504,170,493,166,11,19
1500000US130210115002,130210115002,"Block Group 2, Census Tract 115, Bibb County, Georgia",694,261,683,262,11,17
1500000US130210117011,130210117011,"Block Group 1, Census Tract 117.01, Bibb County, Georgia",1092,212,1087,212,5,8
1500000US130210117012,130210117012,"Block Group 2, Census Tract 117.01, Bibb County, Georgia",1426,258,1406,265,20,34
1500000US130210117021,130210117021,"Block Group 1, Census Tract 117.02, Bibb County, Georgia",555,244,555,244,0,13
1500000US130210117022,130210117022,"Block Group 2, Census Tract 117.02, Bibb County, Georgia",759,282,759,282,0,13
1500000US130210117023,130210117023,"Block Group 3, Census Tract 117.02, Bibb County, Georgia",960,456,960,456,0,13
1500000US130210117024,130210117024,"Block Group 4, Census Tract 117.02, Bibb County, Georgia",894,304,894,304,0,13
1500000US130210117025,130210117025,"Block Group 5, Census Tract 117.02, Bibb County, Georgia",815,347,815,347,0,13
1500000US130210117026,130210117026,"Block Group 6, Census Tract 117.02, Bibb County, Georgia",586,170,586,170,0,13
1500000US130210118001,130210118001,"Block Group 1, Census Tract 118, Bibb County, Georgia",1330,327,1324,326,6,11
1500000US130210118002,130210118002,"Block Group 2, Census Tract 118, Bibb County, Georgia",755,174,745,177,10,17
1500000US130210118003,130210118003,"Block Group 3, Census Tract 118, Bibb County, Georgia",378,117,378,117,0,13
1500000US130210118004,130210118004,"Block Group 4, Census Tract 118, Bibb County, Georgia",1110,290,1110,290,0,13
1500000US130210119001,130210119001,"Block Group 1, Census Tract 119, Bibb County, Georgia",454,125,437,125,17,27
1500000US130210119002,130210119002,"Block Group 2, Census Tract 119, Bibb County, Georgia",859,217,859,217,0,13
1500000US130210119003,130210119003,"Block Group 3, Census Tract 119, Bibb County, Georgia",547,349,547,349,0,13
1500000US130210120001,130210120001,"Block Group 1, Census Tract 120, Bibb County, Georgia",964,255,907,266,57,73
1500000US130210120002,130210120002,"Block Group 2, Census Tract 120, Bibb County, Georgia",689,233,689,233,0,13
1500000US130210120003,130210120003,"Block Group 3, Census Tract 120, Bibb County, Georgia",1367,305,1367,305,0,13
1500000US130210120004,130210120004,"Block Group 4, Census Tract 120, Bibb County, Georgia",1375,286,1320,265,55,94
1500000US130210121011,130210121011,"Block Group 1, Census Tract 121.01, Bibb County, Georgia",2065,329,2062,330,3,7
1500000US130210121021,130210121021,"Block Group 1, Census Tract 121.02, Bibb County, Georgia",1720,465,1613,441,107,168
1500000US130210121022,130210121022,"Block Group 2, Census Tract 121.02, Bibb County, Georgia",1954,341,1937,336,17,28
1500000US130210121023,130210121023,"Block Group 3, Census Tract 121.02, Bibb County, Georgia",1333,344,1196,293,137,148
1500000US130210122001,130210122001,"Block Group 1, Census Tract 122, Bibb County, Georgia",970,299,937,298,33,50
1500000US130210122002,130210122002,"Block Group 2, Census Tract 122, Bibb County, Georgia",1410,375,1405,374,5,9
1500000US130210123001,130210123001,"Block Group 1, Census Tract 123, Bibb County, Georgia",895,402,883,401,12,21
1500000US130210123002,130210123002,"Block Group 2, Census Tract 123, Bibb County, Georgia",377,225,377,225,0,13
1500000US130210123003,130210123003,"Block Group 3, Census Tract 123, Bibb County, Georgia",1265,284,1260,284,5,8
1500000US130210124001,130210124001,"Block Group 1, Census Tract 124, Bibb County, Georgia",1685,372,1685,372,0,13
1500000US130210124002,130210124002,"Block Group 2, Census Tract 124, Bibb County, Georgia",1135,344,1135,344,0,13
1500000US130210124003,130210124003,"Block Group 3, Census Tract 124, Bibb County, Georgia",897,344,897,344,0,13
1500000US130210124004,130210124004,"Block Group 4, Census Tract 124, Bibb County, Georgia",579,186,579,186,0,13
1500000US130210125001,130210125001,"Block Group 1, Census Tract 125, Bibb County, Georgia",776,384,748,379,28,45
1500000US130210125002,130210125002,"Block Group 2, Census Tract 125, Bibb County, Georgia",1045,291,1045,291,0,13
1500000US130210125003,130210125003,"Block Group 3, Census Tract 125, Bibb County, Georgia",1395,315,1358,301,37,59
1500000US130210126001,130210126001,"Block Group 1, Census Tract 126, Bibb County, Georgia",1637,439,1637,439,0,13
1500000US130210126002,130210126002,"Block Group 2, Census Tract 126, Bibb County, Georgia",646,206,624,202,22,35
1500000US130210126003,130210126003,"Block Group 3, Census Tract 126, Bibb County, Georgia",1312,399,1207,371,105,159
1500000US130210126004,130210126004,"Block Group 4, Census Tract 126, Bibb County, Georgia",1275,381,1275,381,0,13
1500000US130210127001,130210127001,"Block Group 1, Census Tract 127, Bibb County, Georgia",956,242,943,243,13,22
1500000US130210127002,130210127002,"Block Group 2, Census Tract 127, Bibb County, Georgia",778,244,778,244,0,13
1500000US130210127003,130210127003,"Block Group 3, Census Tract 127, Bibb County, Georgia",423,230,416,230,7,12
1500000US130210128001,130210128001,"Block Group 1, Census Tract 128, Bibb County, Georgia",2049,554,2038,554,11,19
1500000US130210128002,130210128002,"Block Group 2, Census Tract 128, Bibb County, Georgia",1137,516,1137,516,0,13
1500000US130210128003,130210128003,"Block Group 3, Census Tract 128, Bibb County, Georgia",396,210,341,177,55,122
1500000US130210129001,130210129001,"Block Group 1, Census Tract 129, Bibb County, Georgia",949,223,947,223,2,3
1500000US130210129002,130210129002,"Block Group 2, Census Tract 129, Bibb County, Georgia",881,268,876,264,5,11
1500000US130210131011,130210131011,"Block Group 1, Census Tract 131.01, Bibb County, Georgia",2693,659,2406,592,287,329
1500000US130210131012,130210131012,"Block Group 2, Census Tract 131.01, Bibb County, Georgia",1581,516,1472,474,109,176
1500000US130210131013,130210131013,"Block Group 3, Census Tract 131.01, Bibb County, Georgia",1482,695,1482,695,0,13
1500000US130210131021,130210131021,"Block Group 1, Census Tract 131.02, Bibb County, Georgia",528,239,528,239,0,13
1500000US130210131022,130210131022,"Block Group 2, Census Tract 131.02, Bibb County, Georgia",2087,765,2087,765,0,13
1500000US130210131023,130210131023,"Block Group 3, Census Tract 131.02, Bibb County, Georgia",1072,443,1072,443,0,13
1500000US130210131024,130210131024,"Block Group 4, Census Tract 131.02, Bibb County, Georgia",653,310,653,310,0,13
1500000US130210132011,130210132011,"Block Group 1, Census Tract 132.01, Bibb County, Georgia",764,329,626,274,138,123
1500000US130210132012,130210132012,"Block Group 2, Census Tract 132.01, Bibb County, Georgia",3342,1070,3241,1046,101,141
1500000US130210132013,130210132013,"Block Group 3, Census Tract 132.01, Bibb County, Georgia",1175,415,1175,415,0,13
1500000US130210132014,130210132014,"Block Group 4, Census Tract 132.01, Bibb County, Georgia",765,285,765,285,0,13
1500000US130210132021,130210132021,"Block Group 1, Census Tract 132.02, Bibb County, Georgia",1035,410,946,409,89,125
1500000US130210132022,130210132022,"Block Group 2, Census Tract 132.02, Bibb County, Georgia",854,439,854,439,0,13
1500000US130210132023,130210132023,"Block Group 3, Census Tract 132.02, Bibb County, Georgia",1025,275,782,230,243,182
1500000US130210133021,130210133021,"Block Group 1, Census Tract 133.02, Bibb County, Georgia",519,214,519,214,0,13
1500000US130210133022,130210133022,"Block Group 2, Census Tract 133.02, Bibb County, Georgia",826,263,826,263,0,13
1500000US130210133023,130210133023,"Block Group 3, Census Tract 133.02, Bibb County, Georgia",883,258,882,258,1,2
1500000US130210133024,130210133024,"Block Group 4, Census Tract 133.02, Bibb County, Georgia",1725,527,1725,527,0,13
1500000US130210134071,130210134071,"Block Group 1, Census Tract 134.07, Bibb County, Georgia",2057,557,2039,554,18,25
1500000US130210134072,130210134072,"Block Group 2, Census Tract 134.07, Bibb County, Georgia",1618,532,1471,497,147,180
1500000US130210134073,130210134073,"Block Group 3, Census Tract 134.07, Bibb County, Georgia",1038,410,1020,401,18,36
1500000US130210134081,130210134081,"Block Group 1, Census Tract 134.08, Bibb County, Georgia",3394,309,3360,309,34,37
1500000US130210134082,130210134082,"Block Group 2, Census Tract 134.08, Bibb County, Georgia",1141,210,1130,211,11,20
1500000US130210134091,130210134091,"Block Group 1, Census Tract 134.09, Bibb County, Georgia",2316,345,2177,371,139,113
1500000US130210134092,130210134092,"Block Group 2, Census Tract 134.09, Bibb County, Georgia",1661,426,1462,325,199,254
1500000US130210134101,130210134101,"Block Group 1, Census Tract 134.10, Bibb County, Georgia",1733,389,1733,389,0,13
1500000US130210134102,130210134102,"Block Group 2, Census Tract 134.10, Bibb County, Georgia",2030,373,2029,372,1,8
1500000US130210134103,130210134103,"Block Group 3, Census Tract 134.10, Bibb County, Georgia",1442,423,1442,423,0,13
1500000US130210134111,130210134111,"Block Group 1, Census Tract 134.11, Bibb County, Georgia",1333,344,1242,345,91,85
1500000US130210134112,130210134112,"Block Group 2, Census Tract 134.11, Bibb County, Georgia",2435,398,2359,394,76,80
1500000US130210135021,130210135021,"Block Group 1, Census Tract 135.02, Bibb County, Georgia",470,155,459,160,11,16
1500000US130210135022,130210135022,"Block Group 2, Census Tract 135.02, Bibb County, Georgia",1285,313,1113,236,172,207
1500000US130210135031,130210135031,"Block Group 1, Census Tract 135.03, Bibb County, Georgia",2754,365,1997,272,757,312
1500000US130210135041,130210135041,"Block Group 1, Census Tract 135.04, Bibb County, Georgia",2423,474,2423,474,0,13
1500000US130210135042,130210135042,"Block Group 2, Census Tract 135.04, Bibb County, Georgia",2275,546,2242,541,33,55
1500000US130210135043,130210135043,"Block Group 3, Census Tract 135.04, Bibb County, Georgia",1537,469,1537,469,0,13
1500000US130210135044,130210135044,"Block Group 4, Census Tract 135.04, Bibb County, Georgia",2258,666,2213,655,45,56
1500000US130210136031,130210136031,"Block Group 1, Census Tract 136.03, Bibb County, Georgia",3329,878,3211,828,118,135
1500000US130210136032,130210136032,"Block Group 2, Census Tract 136.03, Bibb County, Georgia",1654,457,1419,432,235,275
1500000US130210136041,130210136041,"Block Group 1, Census Tract 136.04, Bibb County, Georgia",1686,450,1686,450,0,13
1500000US130210136042,130210136042,"Block Group 2, Census Tract 136.04, Bibb County, Georgia",1782,418,1732,428,50,81
1500000US130210136043,130210136043,"Block Group 3, Census Tract 136.04, Bibb County, Georgia",1833,398,1725,409,108,102
1500000US130210136051,130210136051,"Block Group 1, Census Tract 136.05, Bibb County, Georgia",1683,409,1683,409,0,13
1500000US130210136052,130210136052,"Block Group 2, Census Tract 136.05, Bibb County, Georgia",1459,382,1418,362,41,98
1500000US130210136053,130210136053,"Block Group 3, Census Tract 136.05, Bibb County, Georgia",1585,478,1438,393,147,195
1500000US130210136061,130210136061,"Block Group 1, Census Tract 136.06, Bibb County, Georgia",753,232,753,232,0,13
1500000US130210136062,130210136062,"Block Group 2, Census Tract 136.06, Bibb County, Georgia",1180,277,1180,277,0,13
1500000US130210136063,130210136063,"Block Group 3, Census Tract 136.06, Bibb County, Georgia",1207,432,1207,432,0,13
1500000US130210136064,130210136064,"Block Group 4, Census Tract 136.06, Bibb County, Georgia",2969,523,2969,523,0,13
1500000US130210137001,130210137001,"Block Group 1, Census Tract 137, Bibb County, Georgia",1719,230,1696,223,23,32
1500000US130210137002,130210137002,"Block Group 2, Census Tract 137, Bibb County, Georgia",779,209,779,209,0,13
1500000US130210137003,130210137003,"Block Group 3, Census Tract 137, Bibb County, Georgia",395,146,380,134,15,24
1500000US130210138001,130210138001,"Block Group 1, Census Tract 138, Bibb County, Georgia",778,302,764,294,14,22
1500000US130210138002,130210138002,"Block Group 2, Census Tract 138, Bibb County, Georgia",1457,286,1407,270,50,61
1500000US130210139001,130210139001,"Block Group 1, Census Tract 139, Bibb County, Georgia",984,226,874,196,110,128
1500000US130210139002,130210139002,"Block Group 2, Census Tract 139, Bibb County, Georgia",1047,230,988,242,59,59
1500000US130237901001,130237901001,"Block Group 1, Census Tract 7901, Bleckley County, Georgia",2159,334,2143,339,16,36
1500000US130237901002,130237901002,"Block Group 2, Census Tract 7901, Bleckley County, Georgia",2528,461,2509,461,19,41
1500000US130237902001,130237902001,"Block Group 1, Census Tract 7902, Bleckley County, Georgia",1863,332,1594,326,269,79
1500000US130237902002,130237902002,"Block Group 2, Census Tract 7902, Bleckley County, Georgia",675,204,661,206,14,19
1500000US130237903001,130237903001,"Block Group 1, Census Tract 7903, Bleckley County, Georgia",1880,313,1865,308,15,24
1500000US130237903002,130237903002,"Block Group 2, Census Tract 7903, Bleckley County, Georgia",744,217,744,217,0,13
1500000US130237903003,130237903003,"Block Group 3, Census Tract 7903, Bleckley County, Georgia",1539,214,1539,214,0,13
1500000US130237903004,130237903004,"Block Group 4, Census Tract 7903, Bleckley County, Georgia",1358,220,1352,220,6,11
1500000US130259601001,130259601001,"Block Group 1, Census Tract 9601, Brantley County, Georgia",3188,589,3166,590,22,42
1500000US130259601002,130259601002,"Block Group 2, Census Tract 9601, Brantley County, Georgia",2626,598,2626,598,0,13
1500000US130259601003,130259601003,"Block Group 3, Census Tract 9601, Brantley County, Georgia",1428,356,1415,358,13,18
1500000US130259602001,130259602001,"Block Group 1, Census Tract 9602, Brantley County, Georgia",2301,448,2025,431,276,118
1500000US130259602002,130259602002,"Block Group 2, Census Tract 9602, Brantley County, Georgia",1749,418,1745,417,4,8
1500000US130259602003,130259602003,"Block Group 3, Census Tract 9602, Brantley County, Georgia",1941,358,1912,355,29,68
1500000US130259603001,130259603001,"Block Group 1, Census Tract 9603, Brantley County, Georgia",976,340,964,341,12,20
1500000US130259603002,130259603002,"Block Group 2, Census Tract 9603, Brantley County, Georgia",2202,495,2192,492,10,24
1500000US130259603003,130259603003,"Block Group 3, Census Tract 9603, Brantley County, Georgia",2041,440,2017,436,24,43
1500000US130279602001,130279602001,"Block Group 1, Census Tract 9602, Brooks County, Georgia",872,214,653,145,219,153
1500000US130279602002,130279602002,"Block Group 2, Census Tract 9602, Brooks County, Georgia",707,112,707,112,0,13
1500000US130279603001,130279603001,"Block Group 1, Census Tract 9603, Brooks County, Georgia",1330,371,1249,360,81,90
1500000US130279603002,130279603002,"Block Group 2, Census Tract 9603, Brooks County, Georgia",894,304,894,304,0,13
1500000US130279603003,130279603003,"Block Group 3, Census Tract 9603, Brooks County, Georgia",2028,359,2016,361,12,23
1500000US130279603004,130279603004,"Block Group 4, Census Tract 9603, Brooks County, Georgia",1338,430,1018,349,320,290
1500000US130279604001,130279604001,"Block Group 1, Census Tract 9604, Brooks County, Georgia",780,219,747,219,33,43
1500000US130279604002,130279604002,"Block Group 2, Census Tract 9604, Brooks County, Georgia",1649,319,1618,324,31,47
1500000US130279604003,130279604003,"Block Group 3, Census Tract 9604, Brooks County, Georgia",951,226,882,231,69,82
1500000US130279605001,130279605001,"Block Group 1, Census Tract 9605, Brooks County, Georgia",859,283,815,268,44,86
1500000US130279605002,130279605002,"Block Group 2, Census Tract 9605, Brooks County, Georgia",700,256,700,256,0,13
1500000US130279605003,130279605003,"Block Group 3, Census Tract 9605, Brooks County, Georgia",1209,341,1203,342,6,10
1500000US130279606001,130279606001,"Block Group 1, Census Tract 9606, Brooks County, Georgia",1122,310,1074,309,48,84
1500000US130279606002,130279606002,"Block Group 2, Census Tract 9606, Brooks County, Georgia",636,203,636,203,0,13
1500000US130279606003,130279606003,"Block Group 3, Census Tract 9606, Brooks County, Georgia",562,169,562,169,0,13
1500000US130299201011,130299201011,"Block Group 1, Census Tract 9201.01, Bryan County, Georgia",2259,544,2177,513,82,76
1500000US130299201012,130299201012,"Block Group 2, Census Tract 9201.01, Bryan County, Georgia",2826,522,2799,516,27,43
1500000US130299201021,130299201021,"Block Group 1, Census Tract 9201.02, Bryan County, Georgia",2594,590,2538,583,56,68
1500000US130299201022,130299201022,"Block Group 2, Census Tract 9201.02, Bryan County, Georgia",1673,505,1628,488,45,56
1500000US130299201023,130299201023,"Block Group 3, Census Tract 9201.02, Bryan County, Georgia",1480,597,1373,483,107,140
1500000US130299203011,130299203011,"Block Group 1, Census Tract 9203.01, Bryan County, Georgia",2041,269,1863,239,178,113
1500000US130299203031,130299203031,"Block Group 1, Census Tract 9203.03, Bryan County, Georgia",2972,537,2722,467,250,163
1500000US130299203032,130299203032,"Block Group 2, Census Tract 9203.03, Bryan County, Georgia",3074,612,2802,561,272,286
1500000US130299203051,130299203051,"Block Group 1, Census Tract 9203.05, Bryan County, Georgia",2298,426,1901,385,397,248
1500000US130299203052,130299203052,"Block Group 2, Census Tract 9203.05, Bryan County, Georgia",2211,338,2127,349,84,92
1500000US130299203061,130299203061,"Block Group 1, Census Tract 9203.06, Bryan County, Georgia",2508,547,2364,545,144,156
1500000US130299203062,130299203062,"Block Group 2, Census Tract 9203.06, Bryan County, Georgia",5431,778,5035,821,396,224
1500000US130299203063,130299203063,"Block Group 3, Census Tract 9203.06, Bryan County, Georgia",1784,441,1784,441,0,13
1500000US130299800001,130299800001,"Block Group 1, Census Tract 9800, Bryan County, Georgia",0,13,0,13,0,13
1500000US130311101001,130311101001,"Block Group 1, Census Tract 1101, Bulloch County, Georgia",1084,292,1084,292,0,13
1500000US130311101002,130311101002,"Block Group 2, Census Tract 1101, Bulloch County, Georgia",1376,252,1359,249,17,24
1500000US130311101003,130311101003,"Block Group 3, Census Tract 1101, Bulloch County, Georgia",1316,284,1314,284,2,4
1500000US130311102001,130311102001,"Block Group 1, Census Tract 1102, Bulloch County, Georgia",1777,347,1719,342,58,67
1500000US130311102002,130311102002,"Block Group 2, Census Tract 1102, Bulloch County, Georgia",1798,437,1713,427,85,113
1500000US130311102003,130311102003,"Block Group 3, Census Tract 1102, Bulloch County, Georgia",969,316,860,327,109,127
1500000US130311102004,130311102004,"Block Group 4, Census Tract 1102, Bulloch County, Georgia",613,325,613,325,0,13
1500000US130311102005,130311102005,"Block Group 5, Census Tract 1102, Bulloch County, Georgia",679,327,679,327,0,13
1500000US130311102006,130311102006,"Block Group 6, Census Tract 1102, Bulloch County, Georgia",1464,432,1408,421,56,56
1500000US130311103001,130311103001,"Block Group 1, Census Tract 1103, Bulloch County, Georgia",2067,562,2067,562,0,13
1500000US130311103002,130311103002,"Block Group 2, Census Tract 1103, Bulloch County, Georgia",1591,669,1358,666,233,183
1500000US130311103003,130311103003,"Block Group 3, Census Tract 1103, Bulloch County, Georgia",1982,609,1814,561,168,189
1500000US130311103004,130311103004,"Block Group 4, Census Tract 1103, Bulloch County, Georgia",2744,472,2702,471,42,61
1500000US130311104011,130311104011,"Block Group 1, Census Tract 1104.01, Bulloch County, Georgia",662,357,648,355,14,24
1500000US130311104012,130311104012,"Block Group 2, Census Tract 1104.01, Bulloch County, Georgia",2107,314,2068,326,39,50
1500000US130311104013,130311104013,"Block Group 3, Census Tract 1104.01, Bulloch County, Georgia",639,192,633,192,6,10
1500000US130311104031,130311104031,"Block Group 1, Census Tract 1104.03, Bulloch County, Georgia",2775,517,2763,512,12,22
1500000US130311104032,130311104032,"Block Group 2, Census Tract 1104.03, Bulloch County, Georgia",2741,572,2503,552,238,205
1500000US130311104033,130311104033,"Block Group 3, Census Tract 1104.03, Bulloch County, Georgia",1485,458,1447,453,38,64
1500000US130311104041,130311104041,"Block Group 1, Census Tract 1104.04, Bulloch County, Georgia",183,64,177,70,6,12
1500000US130311104042,130311104042,"Block Group 2, Census Tract 1104.04, Bulloch County, Georgia",3969,559,3828,547,141,60
1500000US130311104043,130311104043,"Block Group 3, Census Tract 1104.04, Bulloch County, Georgia",3107,629,2956,615,151,88
1500000US130311105001,130311105001,"Block Group 1, Census Tract 1105, Bulloch County, Georgia",1023,269,911,226,112,106
1500000US130311105002,130311105002,"Block Group 2, Census Tract 1105, Bulloch County, Georgia",1039,274,1039,274,0,13
1500000US130311105003,130311105003,"Block Group 3, Census Tract 1105, Bulloch County, Georgia",1712,301,1617,295,95,82
1500000US130311105004,130311105004,"Block Group 4, Census Tract 1105, Bulloch County, Georgia",1026,304,1016,303,10,16
1500000US130311106011,130311106011,"Block Group 1, Census Tract 1106.01, Bulloch County, Georgia",3422,649,3422,649,0,13
1500000US130311106012,130311106012,"Block Group 2, Census Tract 1106.01, Bulloch County, Georgia",965,325,907,316,58,95
1500000US130311106013,130311106013,"Block Group 3, Census Tract 1106.01, Bulloch County, Georgia",2421,524,2345,497,76,111
1500000US130311106021,130311106021,"Block Group 1, Census Tract 1106.02, Bulloch County, Georgia",818,212,773,208,45,52
1500000US130311106022,130311106022,"Block Group 2, Census Tract 1106.02, Bulloch County, Georgia",552,201,546,199,6,11
1500000US130311106023,130311106023,"Block Group 3, Census Tract 1106.02, Bulloch County, Georgia",2474,365,2265,352,209,201
1500000US130311107001,130311107001,"Block Group 1, Census Tract 1107, Bulloch County, Georgia",4051,768,3872,781,179,250
1500000US130311107002,130311107002,"Block Group 2, Census Tract 1107, Bulloch County, Georgia",2326,452,2288,446,38,46
1500000US130311107003,130311107003,"Block Group 3, Census Tract 1107, Bulloch County, Georgia",1145,324,1142,324,3,5
1500000US130311107004,130311107004,"Block Group 4, Census Tract 1107, Bulloch County, Georgia",2836,613,2656,601,180,220
1500000US130311108001,130311108001,"Block Group 1, Census Tract 1108, Bulloch County, Georgia",1601,304,1601,304,0,13
1500000US130311108002,130311108002,"Block Group 2, Census Tract 1108, Bulloch County, Georgia",925,175,916,173,9,15
1500000US130311109001,130311109001,"Block Group 1, Census Tract 1109, Bulloch County, Georgia",1263,409,1263,409,0,13
1500000US130311109002,130311109002,"Block Group 2, Census Tract 1109, Bulloch County, Georgia",2398,560,2231,546,167,207
1500000US130311109003,130311109003,"Block Group 3, Census Tract 1109, Bulloch County, Georgia",2370,531,2359,530,11,19
1500000US130311109004,130311109004,"Block Group 4, Census Tract 1109, Bulloch County, Georgia",891,353,874,358,17,30
1500000US130339501001,130339501001,"Block Group 1, Census Tract 9501, Burke County, Georgia",2089,415,1935,392,154,177
1500000US130339501002,130339501002,"Block Group 2, Census Tract 9501, Burke County, Georgia",3059,528,2995,524,64,73
1500000US130339502001,130339502001,"Block Group 1, Census Tract 9502, Burke County, Georgia",1097,309,1039,308,58,73
1500000US130339502002,130339502002,"Block Group 2, Census Tract 9502, Burke County, Georgia",1662,313,1643,315,19,27
1500000US130339504001,130339504001,"Block Group 1, Census Tract 9504, Burke County, Georgia",1723,390,1723,390,0,13
1500000US130339504002,130339504002,"Block Group 2, Census Tract 9504, Burke County, Georgia",590,184,590,184,0,13
1500000US130339504003,130339504003,"Block Group 3, Census Tract 9504, Burke County, Georgia",1686,373,1686,373,0,13
1500000US130339504004,130339504004,"Block Group 4, Census Tract 9504, Burke County, Georgia",1129,285,1129,285,0,13
1500000US130339505001,130339505001,"Block Group 1, Census Tract 9505, Burke County, Georgia",1301,334,1301,334,0,13
1500000US130339505002,130339505002,"Block Group 2, Census Tract 9505, Burke County, Georgia",2401,374,2393,374,8,14
1500000US130339505003,130339505003,"Block Group 3, Census Tract 9505, Burke County, Georgia",1802,302,1618,266,184,179
1500000US130339507001,130339507001,"Block Group 1, Census Tract 9507, Burke County, Georgia",964,231,964,231,0,13
1500000US130339507002,130339507002,"Block Group 2, Census Tract 9507, Burke County, Georgia",778,229,778,229,0,13
1500000US130339507003,130339507003,"Block Group 3, Census Tract 9507, Burke County, Georgia",998,288,987,284,11,18
1500000US130339509001,130339509001,"Block Group 1, Census Tract 9509, Burke County, Georgia",878,203,762,182,116,95
1500000US130339509002,130339509002,"Block Group 2, Census Tract 9509, Burke County, Georgia",850,133,784,129,66,70
1500000US130351501001,130351501001,"Block Group 1, Census Tract 1501, Butts County, Georgia",1519,369,1465,371,54,80
1500000US130351501002,130351501002,"Block Group 2, Census Tract 1501, Butts County, Georgia",1330,351,1330,351,0,13
1500000US130351501003,130351501003,"Block Group 3, Census Tract 1501, Butts County, Georgia",1774,618,1774,618,0,13
1500000US130351501004,130351501004,"Block Group 4, Census Tract 1501, Butts County, Georgia",998,277,979,269,19,28
1500000US130351501005,130351501005,"Block Group 5, Census Tract 1501, Butts County, Georgia",2298,619,2283,622,15,29
1500000US130351502001,130351502001,"Block Group 1, Census Tract 1502, Butts County, Georgia",2947,648,2926,637,21,29
1500000US130351502002,130351502002,"Block Group 2, Census Tract 1502, Butts County, Georgia",828,265,823,265,5,11
1500000US130351502003,130351502003,"Block Group 3, Census Tract 1502, Butts County, Georgia",825,378,732,360,93,135
1500000US130351502004,130351502004,"Block Group 4, Census Tract 1502, Butts County, Georgia",1154,434,1154,434,0,13
1500000US130351502005,130351502005,"Block Group 5, Census Tract 1502, Butts County, Georgia",2202,624,1995,579,207,204
1500000US130351503001,130351503001,"Block Group 1, Census Tract 1503, Butts County, Georgia",2628,498,2620,496,8,10
1500000US130351503002,130351503002,"Block Group 2, Census Tract 1503, Butts County, Georgia",1019,307,996,305,23,29
1500000US130351503003,130351503003,"Block Group 3, Census Tract 1503, Butts County, Georgia",2995,290,2887,291,108,50
1500000US130351503004,130351503004,"Block Group 4, Census Tract 1503, Butts County, Georgia",928,308,780,223,148,158
1500000US130379501001,130379501001,"Block Group 1, Census Tract 9501, Calhoun County, Georgia",732,284,717,253,15,48
1500000US130379501002,130379501002,"Block Group 2, Census Tract 9501, Calhoun County, Georgia",3033,1014,2800,912,233,115
1500000US130379502001,130379502001,"Block Group 1, Census Tract 9502, Calhoun County, Georgia",553,238,553,238,0,13
1500000US130379502002,130379502002,"Block Group 2, Census Tract 9502, Calhoun County, Georgia",527,214,527,214,0,13
1500000US130379502003,130379502003,"Block Group 3, Census Tract 9502, Calhoun County, Georgia",460,186,410,151,50,87
1500000US130379502004,130379502004,"Block Group 4, Census Tract 9502, Calhoun County, Georgia",1184,425,1183,423,1,4
1500000US130390101001,130390101001,"Block Group 1, Census Tract 101, Camden County, Georgia",956,244,938,240,18,30
1500000US130390101002,130390101002,"Block Group 2, Census Tract 101, Camden County, Georgia",1589,326,1575,326,14,19
1500000US130390102001,130390102001,"Block Group 1, Census Tract 102, Camden County, Georgia",1137,223,1115,219,22,32
1500000US130390102002,130390102002,"Block Group 2, Census Tract 102, Camden County, Georgia",1462,289,1354,267,108,84
1500000US130390102003,130390102003,"Block Group 3, Census Tract 102, Camden County, Georgia",2515,326,2482,328,33,31
1500000US130390103011,130390103011,"Block Group 1, Census Tract 103.01, Camden County, Georgia",1832,466,1814,466,18,32
1500000US130390103012,130390103012,"Block Group 2, Census Tract 103.01, Camden County, Georgia",1871,482,1850,483,21,27
1500000US130390103013,130390103013,"Block Group 3, Census Tract 103.01, Camden County, Georgia",3639,583,3610,581,29,33
1500000US130390103014,130390103014,"Block Group 4, Census Tract 103.01, Camden County, Georgia",1039,306,1039,306,0,13
1500000US130390103021,130390103021,"Block Group 1, Census Tract 103.02, Camden County, Georgia",637,226,585,227,52,62
1500000US130390103022,130390103022,"Block Group 2, Census Tract 103.02, Camden County, Georgia",2609,464,2490,455,119,96
1500000US130390103023,130390103023,"Block Group 3, Census Tract 103.02, Camden County, Georgia",834,279,831,278,3,6
1500000US130390104011,130390104011,"Block Group 1, Census Tract 104.01, Camden County, Georgia",5325,785,4957,821,368,203
1500000US130390104012,130390104012,"Block Group 2, Census Tract 104.01, Camden County, Georgia",1317,513,1280,516,37,58
1500000US130390104013,130390104013,"Block Group 3, Census Tract 104.01, Camden County, Georgia",5348,586,4769,571,579,312
1500000US130390104021,130390104021,"Block Group 1, Census Tract 104.02, Camden County, Georgia",1484,316,1362,286,122,165
1500000US130390104022,130390104022,"Block Group 2, Census Tract 104.02, Camden County, Georgia",3723,482,3070,503,653,202
1500000US130390104031,130390104031,"Block Group 1, Census Tract 104.03, Camden County, Georgia",4094,399,4033,407,61,54
1500000US130390105001,130390105001,"Block Group 1, Census Tract 105, Camden County, Georgia",2065,286,1642,294,423,169
1500000US130390105002,130390105002,"Block Group 2, Census Tract 105, Camden County, Georgia",794,246,735,228,59,38
1500000US130390106011,130390106011,"Block Group 1, Census Tract 106.01, Camden County, Georgia",1841,497,1680,467,161,194
1500000US130390106012,130390106012,"Block Group 2, Census Tract 106.01, Camden County, Georgia",2028,585,2004,583,24,29
1500000US130390106013,130390106013,"Block Group 3, Census Tract 106.01, Camden County, Georgia",2418,569,2418,569,0,13
1500000US130390106021,130390106021,"Block Group 1, Census Tract 106.02, Camden County, Georgia",888,159,794,160,94,72
1500000US130399900000,130399900000,"Block Group 0, Census Tract 9900, Camden County, Georgia",0,13,0,13,0,13
1500000US130439501001,130439501001,"Block Group 1, Census Tract 9501, Candler County, Georgia",1086,208,980,204,106,124
1500000US130439501002,130439501002,"Block Group 2, Census Tract 9501, Candler County, Georgia",2206,353,2019,333,187,203
1500000US130439501003,130439501003,"Block Group 3, Census Tract 9501, Candler County, Georgia",1978,328,1770,292,208,182
1500000US130439502001,130439502001,"Block Group 1, Census Tract 9502, Candler County, Georgia",1702,336,1463,324,239,243
1500000US130439502002,130439502002,"Block Group 2, Census Tract 9502, Candler County, Georgia",1203,325,1147,310,56,56
1500000US130439502003,130439502003,"Block Group 3, Census Tract 9502, Candler County, Georgia",678,190,638,195,40,63
1500000US130439503001,130439503001,"Block Group 1, Census Tract 9503, Candler County, Georgia",1059,195,1002,198,57,59
1500000US130439503002,130439503002,"Block Group 2, Census Tract 9503, Candler County, Georgia",1119,272,773,208,346,176
1500000US130459101011,130459101011,"Block Group 1, Census Tract 9101.01, Carroll County, Georgia",4183,498,4115,512,68,109
1500000US130459101012,130459101012,"Block Group 2, Census Tract 9101.01, Carroll County, Georgia",1785,429,1727,445,58,96
1500000US130459101031,130459101031,"Block Group 1, Census Tract 9101.03, Carroll County, Georgia",2744,468,2468,386,276,258
1500000US130459101032,130459101032,"Block Group 2, Census Tract 9101.03, Carroll County, Georgia",2188,380,2036,356,152,112
1500000US130459101041,130459101041,"Block Group 1, Census Tract 9101.04, Carroll County, Georgia",1702,512,1485,442,217,222
1500000US130459101042,130459101042,"Block Group 2, Census Tract 9101.04, Carroll County, Georgia",5604,966,4985,1016,619,409
1500000US130459101043,130459101043,"Block Group 3, Census Tract 9101.04, Carroll County, Georgia",1549,430,1537,429,12,21
1500000US130459101044,130459101044,"Block Group 4, Census Tract 9101.04, Carroll County, Georgia",801,407,753,396,48,77
1500000US130459102001,130459102001,"Block Group 1, Census Tract 9102, Carroll County, Georgia",2963,876,2925,866,38,49
1500000US130459102002,130459102002,"Block Group 2, Census Tract 9102, Carroll County, Georgia",5624,1082,5624,1082,0,18
1500000US130459102003,130459102003,"Block Group 3, Census Tract 9102, Carroll County, Georgia",3576,786,3381,769,195,229
1500000US130459103001,130459103001,"Block Group 1, Census Tract 9103, Carroll County, Georgia",1238,470,1238,470,0,13
1500000US130459103002,130459103002,"Block Group 2, Census Tract 9103, Carroll County, Georgia",3302,602,3018,574,284,196
1500000US130459103003,130459103003,"Block Group 3, Census Tract 9103, Carroll County, Georgia",1329,307,1303,306,26,29
1500000US130459104001,130459104001,"Block Group 1, Census Tract 9104, Carroll County, Georgia",1041,224,1041,224,0,13
1500000US130459104002,130459104002,"Block Group 2, Census Tract 9104, Carroll County, Georgia",1301,253,1283,254,18,19
1500000US130459104003,130459104003,"Block Group 3, Census Tract 9104, Carroll County, Georgia",927,261,927,261,0,13
1500000US130459105011,130459105011,"Block Group 1, Census Tract 9105.01, Carroll County, Georgia",3690,664,3123,611,567,268
1500000US130459105012,130459105012,"Block Group 2, Census Tract 9105.01, Carroll County, Georgia",3757,532,3623,525,134,64
1500000US130459105013,130459105013,"Block Group 3, Census Tract 9105.01, Carroll County, Georgia",1125,365,1125,365,0,13
1500000US130459105014,130459105014,"Block Group 4, Census Tract 9105.01, Carroll County, Georgia",434,205,247,202,187,132
1500000US130459105021,130459105021,"Block Group 1, Census Tract 9105.02, Carroll County, Georgia",1064,283,886,250,178,160
1500000US130459105022,130459105022,"Block Group 2, Census Tract 9105.02, Carroll County, Georgia",1155,308,657,272,498,206
1500000US130459105023,130459105023,"Block Group 3, Census Tract 9105.02, Carroll County, Georgia",787,240,643,214,144,124
1500000US130459106001,130459106001,"Block Group 1, Census Tract 9106, Carroll County, Georgia",3638,629,3230,575,408,368
1500000US130459106002,130459106002,"Block Group 2, Census Tract 9106, Carroll County, Georgia",1543,429,1503,423,40,74
1500000US130459106003,130459106003,"Block Group 3, Census Tract 9106, Carroll County, Georgia",819,320,576,289,243,154
1500000US130459107011,130459107011,"Block Group 1, Census Tract 9107.01, Carroll County, Georgia",4128,757,3987,786,141,128
1500000US130459107012,130459107012,"Block Group 2, Census Tract 9107.01, Carroll County, Georgia",1483,453,1312,417,171,180
1500000US130459107013,130459107013,"Block Group 3, Census Tract 9107.01, Carroll County, Georgia",3040,579,2780,569,260,112
1500000US130459107021,130459107021,"Block Group 1, Census Tract 9107.02, Carroll County, Georgia",2874,573,2673,597,201,214
1500000US130459107022,130459107022,"Block Group 2, Census Tract 9107.02, Carroll County, Georgia",2319,490,2232,500,87,99
1500000US130459107023,130459107023,"Block Group 3, Census Tract 9107.02, Carroll County, Georgia",2230,657,2213,655,17,29
1500000US130459107031,130459107031,"Block Group 1, Census Tract 9107.03, Carroll County, Georgia",1997,676,1773,613,224,325
1500000US130459107032,130459107032,"Block Group 2, Census Tract 9107.03, Carroll County, Georgia",998,395,998,395,0,13
1500000US130459107033,130459107033,"Block Group 3, Census Tract 9107.03, Carroll County, Georgia",3470,850,3316,856,154,113
1500000US130459107034,130459107034,"Block Group 4, Census Tract 9107.03, Carroll County, Georgia",2405,790,2405,790,0,13
1500000US130459108001,130459108001,"Block Group 1, Census Tract 9108, Carroll County, Georgia",2007,456,1919,449,88,119
1500000US130459108002,130459108002,"Block Group 2, Census Tract 9108, Carroll County, Georgia",2117,308,2056,299,61,67
1500000US130459109001,130459109001,"Block Group 1, Census Tract 9109, Carroll County, Georgia",2005,375,1924,316,81,117
1500000US130459109002,130459109002,"Block Group 2, Census Tract 9109, Carroll County, Georgia",2110,390,2086,385,24,31
1500000US130459110001,130459110001,"Block Group 1, Census Tract 9110, Carroll County, Georgia",1452,598,1098,538,354,324
1500000US130459110002,130459110002,"Block Group 2, Census Tract 9110, Carroll County, Georgia",3322,563,3068,565,254,238
1500000US130459110003,130459110003,"Block Group 3, Census Tract 9110, Carroll County, Georgia",1383,424,1226,396,157,157
1500000US130459111001,130459111001,"Block Group 1, Census Tract 9111, Carroll County, Georgia",1316,524,1316,524,0,13
1500000US130459111002,130459111002,"Block Group 2, Census Tract 9111, Carroll County, Georgia",2146,608,2006,582,140,158
1500000US130459111003,130459111003,"Block Group 3, Census Tract 9111, Carroll County, Georgia",1008,460,997,460,11,23
1500000US130459111004,130459111004,"Block Group 4, Census Tract 9111, Carroll County, Georgia",2352,480,1967,473,385,397
1500000US130459111005,130459111005,"Block Group 5, Census Tract 9111, Carroll County, Georgia",844,285,829,286,15,25
1500000US130459112001,130459112001,"Block Group 1, Census Tract 9112, Carroll County, Georgia",1902,465,1902,465,0,13
1500000US130459112002,130459112002,"Block Group 2, Census Tract 9112, Carroll County, Georgia",1161,354,1134,351,27,42
1500000US130459112003,130459112003,"Block Group 3, Census Tract 9112, Carroll County, Georgia",1407,442,1407,442,0,13
1500000US130459112004,130459112004,"Block Group 4, Census Tract 9112, Carroll County, Georgia",1250,236,1250,236,0,13
1500000US130470301001,130470301001,"Block Group 1, Census Tract 301, Catoosa County, Georgia",2667,634,2511,591,156,121
1500000US130470301002,130470301002,"Block Group 2, Census Tract 301, Catoosa County, Georgia",565,219,525,205,40,67
1500000US130470301003,130470301003,"Block Group 3, Census Tract 301, Catoosa County, Georgia",1322,434,1305,431,17,29
1500000US130470301004,130470301004,"Block Group 4, Census Tract 301, Catoosa County, Georgia",1949,507,1949,507,0,13
1500000US130470302011,130470302011,"Block Group 1, Census Tract 302.01, Catoosa County, Georgia",1481,288,1451,287,30,51
1500000US130470302012,130470302012,"Block Group 2, Census Tract 302.01, Catoosa County, Georgia",3089,385,3010,384,79,96
1500000US130470302021,130470302021,"Block Group 1, Census Tract 302.02, Catoosa County, Georgia",1676,637,1676,637,0,13
1500000US130470302022,130470302022,"Block Group 2, Census Tract 302.02, Catoosa County, Georgia",1703,539,1703,539,0,13
1500000US130470302023,130470302023,"Block Group 3, Census Tract 302.02, Catoosa County, Georgia",2888,469,2822,456,66,119
1500000US130470303011,130470303011,"Block Group 1, Census Tract 303.01, Catoosa County, Georgia",2300,496,2047,535,253,298
1500000US130470303012,130470303012,"Block Group 2, Census Tract 303.01, Catoosa County, Georgia",2385,643,2385,643,0,13
1500000US130470303013,130470303013,"Block Group 3, Census Tract 303.01, Catoosa County, Georgia",2841,609,2841,609,0,13
1500000US130470303031,130470303031,"Block Group 1, Census Tract 303.03, Catoosa County, Georgia",3175,329,3092,316,83,89
1500000US130470303041,130470303041,"Block Group 1, Census Tract 303.04, Catoosa County, Georgia",3787,347,3763,347,24,46
1500000US130470304011,130470304011,"Block Group 1, Census Tract 304.01, Catoosa County, Georgia",1589,380,1513,341,76,127
1500000US130470304012,130470304012,"Block Group 2, Census Tract 304.01, Catoosa County, Georgia",3012,468,2959,456,53,98
1500000US130470304013,130470304013,"Block Group 3, Census Tract 304.01, Catoosa County, Georgia",2428,554,2342,559,86,127
1500000US130470304021,130470304021,"Block Group 1, Census Tract 304.02, Catoosa County, Georgia",1228,368,1058,325,170,201
1500000US130470304022,130470304022,"Block Group 2, Census Tract 304.02, Catoosa County, Georgia",851,482,775,427,76,80
1500000US130470304023,130470304023,"Block Group 3, Census Tract 304.02, Catoosa County, Georgia",2479,598,2479,598,0,13
1500000US130470304024,130470304024,"Block Group 4, Census Tract 304.02, Catoosa County, Georgia",1915,513,1828,509,87,135
1500000US130470305001,130470305001,"Block Group 1, Census Tract 305, Catoosa County, Georgia",3705,514,3646,500,59,58
1500000US130470305002,130470305002,"Block Group 2, Census Tract 305, Catoosa County, Georgia",805,236,805,236,0,13
1500000US130470305003,130470305003,"Block Group 3, Census Tract 305, Catoosa County, Georgia",1596,458,1596,458,0,13
1500000US130470306001,130470306001,"Block Group 1, Census Tract 306, Catoosa County, Georgia",674,262,648,259,26,38
1500000US130470306002,130470306002,"Block Group 2, Census Tract 306, Catoosa County, Georgia",1667,531,1667,531,0,13
1500000US130470306003,130470306003,"Block Group 3, Census Tract 306, Catoosa County, Georgia",1282,378,1199,340,83,116
1500000US130470306004,130470306004,"Block Group 4, Census Tract 306, Catoosa County, Georgia",905,352,783,312,122,208
1500000US130470306005,130470306005,"Block Group 5, Census Tract 306, Catoosa County, Georgia",1112,395,1012,321,100,140
1500000US130470307001,130470307001,"Block Group 1, Census Tract 307, Catoosa County, Georgia",2698,544,2612,539,86,133
1500000US130470307002,130470307002,"Block Group 2, Census Tract 307, Catoosa County, Georgia",954,268,954,268,0,13
1500000US130470307003,130470307003,"Block Group 3, Census Tract 307, Catoosa County, Georgia",3053,513,3053,513,0,13
1500000US130470307004,130470307004,"Block Group 4, Census Tract 307, Catoosa County, Georgia",968,377,968,377,0,13
1500000US130470307005,130470307005,"Block Group 5, Census Tract 307, Catoosa County, Georgia",626,293,626,293,0,13
1500000US130490101001,130490101001,"Block Group 1, Census Tract 101, Charlton County, Georgia",1516,384,1498,387,18,26
1500000US130490101002,130490101002,"Block Group 2, Census Tract 101, Charlton County, Georgia",2732,604,1662,350,1070,463
1500000US130490101003,130490101003,"Block Group 3, Census Tract 101, Charlton County, Georgia",2244,644,2130,626,114,131
1500000US130490101004,130490101004,"Block Group 4, Census Tract 101, Charlton County, Georgia",3285,653,3112,639,173,238
1500000US130490102001,130490102001,"Block Group 1, Census Tract 102, Charlton County, Georgia",1647,473,1604,444,43,70
1500000US130490102002,130490102002,"Block Group 2, Census Tract 102, Charlton County, Georgia",1706,340,1635,336,71,106
1500000US130510001001,130510001001,"Block Group 1, Census Tract 1, Chatham County, Georgia",1916,186,1752,165,164,75
1500000US130510003001,130510003001,"Block Group 1, Census Tract 3, Chatham County, Georgia",982,207,876,190,106,49
1500000US130510003002,130510003002,"Block Group 2, Census Tract 3, Chatham County, Georgia",701,219,652,195,49,76
1500000US130510006011,130510006011,"Block Group 1, Census Tract 6.01, Chatham County, Georgia",349,175,349,175,0,13
1500000US130510006012,130510006012,"Block Group 2, Census Tract 6.01, Chatham County, Georgia",481,268,481,268,0,13
1500000US130510006013,130510006013,"Block Group 3, Census Tract 6.01, Chatham County, Georgia",774,321,774,321,0,13
1500000US130510006014,130510006014,"Block Group 4, Census Tract 6.01, Chatham County, Georgia",1621,289,1440,281,181,136
1500000US130510006015,130510006015,"Block Group 5, Census Tract 6.01, Chatham County, Georgia",995,298,995,298,0,13
1500000US130510009001,130510009001,"Block Group 1, Census Tract 9, Chatham County, Georgia",1171,142,1076,115,95,67
1500000US130510011001,130510011001,"Block Group 1, Census Tract 11, Chatham County, Georgia",1080,182,1035,189,45,40
1500000US130510011002,130510011002,"Block Group 2, Census Tract 11, Chatham County, Georgia",997,195,997,195,0,13
1500000US130510012001,130510012001,"Block Group 1, Census Tract 12, Chatham County, Georgia",1962,258,1947,264,15,22
1500000US130510015001,130510015001,"Block Group 1, Census Tract 15, Chatham County, Georgia",1416,247,1226,192,190,229
1500000US130510020001,130510020001,"Block Group 1, Census Tract 20, Chatham County, Georgia",595,168,559,165,36,27
1500000US130510020002,130510020002,"Block Group 2, Census Tract 20, Chatham County, Georgia",681,140,672,139,9,13
1500000US130510021001,130510021001,"Block Group 1, Census Tract 21, Chatham County, Georgia",629,194,624,193,5,8
1500000US130510021002,130510021002,"Block Group 2, Census Tract 21, Chatham County, Georgia",574,201,574,201,0,13
1500000US130510021003,130510021003,"Block Group 3, Census Tract 21, Chatham County, Georgia",948,236,948,236,0,13
1500000US130510022001,130510022001,"Block Group 1, Census Tract 22, Chatham County, Georgia",923,311,892,309,31,50
1500000US130510022002,130510022002,"Block Group 2, Census Tract 22, Chatham County, Georgia",796,253,790,253,6,11
1500000US130510022003,130510022003,"Block Group 3, Census Tract 22, Chatham County, Georgia",692,184,692,184,0,13
1500000US130510022004,130510022004,"Block Group 4, Census Tract 22, Chatham County, Georgia",970,278,970,278,0,13
1500000US130510022005,130510022005,"Block Group 5, Census Tract 22, Chatham County, Georgia",726,200,726,200,0,13
1500000US130510023001,130510023001,"Block Group 1, Census Tract 23, Chatham County, Georgia",1287,281,1287,281,0,13
1500000US130510023002,130510023002,"Block Group 2, Census Tract 23, Chatham County, Georgia",775,169,775,169,0,13
1500000US130510026001,130510026001,"Block Group 1, Census Tract 26, Chatham County, Georgia",788,206,779,204,9,12
1500000US130510026002,130510026002,"Block Group 2, Census Tract 26, Chatham County, Georgia",781,176,774,175,7,8
1500000US130510027001,130510027001,"Block Group 1, Census Tract 27, Chatham County, Georgia",534,204,534,204,0,13
1500000US130510027002,130510027002,"Block Group 2, Census Tract 27, Chatham County, Georgia",1332,525,1332,525,0,13
1500000US130510027003,130510027003,"Block Group 3, Census Tract 27, Chatham County, Georgia",696,226,660,220,36,49
1500000US130510027004,130510027004,"Block Group 4, Census Tract 27, Chatham County, Georgia",406,122,406,122,0,13
1500000US130510028001,130510028001,"Block Group 1, Census Tract 28, Chatham County, Georgia",643,194,643,194,0,13
1500000US130510028002,130510028002,"Block Group 2, Census Tract 28, Chatham County, Georgia",570,221,570,221,0,13
1500000US130510028003,130510028003,"Block Group 3, Census Tract 28, Chatham County, Georgia",1248,264,1194,257,54,34
1500000US130510029001,130510029001,"Block Group 1, Census Tract 29, Chatham County, Georgia",1083,240,1052,254,31,44
1500000US130510029002,130510029002,"Block Group 2, Census Tract 29, Chatham County, Georgia",700,132,684,132,16,26
1500000US130510029003,130510029003,"Block Group 3, Census Tract 29, Chatham County, Georgia",769,146,769,146,0,13
1500000US130510029004,130510029004,"Block Group 4, Census Tract 29, Chatham County, Georgia",601,152,569,150,32,40
1500000US130510030001,130510030001,"Block Group 1, Census Tract 30, Chatham County, Georgia",541,115,484,117,57,53
1500000US130510030002,130510030002,"Block Group 2, Census Tract 30, Chatham County, Georgia",1494,196,1385,193,109,85
1500000US130510033011,130510033011,"Block Group 1, Census Tract 33.01, Chatham County, Georgia",1033,229,1024,231,9,10
1500000US130510033012,130510033012,"Block Group 2, Census Tract 33.01, Chatham County, Georgia",971,225,971,225,0,13
1500000US130510033021,130510033021,"Block Group 1, Census Tract 33.02, Chatham County, Georgia",768,183,768,183,0,13
1500000US130510033022,130510033022,"Block Group 2, Census Tract 33.02, Chatham County, Georgia",891,180,891,180,0,13
1500000US130510034001,130510034001,"Block Group 1, Census Tract 34, Chatham County, Georgia",777,282,777,282,0,13
1500000US130510034002,130510034002,"Block Group 2, Census Tract 34, Chatham County, Georgia",714,219,714,219,0,13
1500000US130510034003,130510034003,"Block Group 3, Census Tract 34, Chatham County, Georgia",737,326,707,304,30,30
1500000US130510034004,130510034004,"Block Group 4, Census Tract 34, Chatham County, Georgia",1293,303,1277,302,16,19
1500000US130510034005,130510034005,"Block Group 5, Census Tract 34, Chatham County, Georgia",685,162,667,158,18,19
1500000US130510035011,130510035011,"Block Group 1, Census Tract 35.01, Chatham County, Georgia",1052,271,1046,273,6,9
1500000US130510035012,130510035012,"Block Group 2, Census Tract 35.01, Chatham County, Georgia",1152,245,1130,247,22,33
1500000US130510035013,130510035013,"Block Group 3, Census Tract 35.01, Chatham County, Georgia",585,198,578,198,7,11
1500000US130510035021,130510035021,"Block Group 1, Census Tract 35.02, Chatham County, Georgia",561,208,561,208,0,13
1500000US130510035022,130510035022,"Block Group 2, Census Tract 35.02, Chatham County, Georgia",1220,305,1220,305,0,13
1500000US130510035023,130510035023,"Block Group 3, Census Tract 35.02, Chatham County, Georgia",1107,343,1107,343,0,13
1500000US130510035024,130510035024,"Block Group 4, Census Tract 35.02, Chatham County, Georgia",1268,355,1246,344,22,32
1500000US130510036011,130510036011,"Block Group 1, Census Tract 36.01, Chatham County, Georgia",2310,437,2134,473,176,119
1500000US130510036012,130510036012,"Block Group 2, Census Tract 36.01, Chatham County, Georgia",713,254,713,254,0,13
1500000US130510036021,130510036021,"Block Group 1, Census Tract 36.02, Chatham County, Georgia",515,268,515,268,0,13
1500000US130510036022,130510036022,"Block Group 2, Census Tract 36.02, Chatham County, Georgia",1039,379,1010,383,29,28
1500000US130510036023,130510036023,"Block Group 3, Census Tract 36.02, Chatham County, Georgia",806,407,788,404,18,20
1500000US130510036024,130510036024,"Block Group 4, Census Tract 36.02, Chatham County, Georgia",858,266,764,253,94,100
1500000US130510036025,130510036025,"Block Group 5, Census Tract 36.02, Chatham County, Georgia",1210,357,1210,357,0,13
1500000US130510037001,130510037001,"Block Group 1, Census Tract 37, Chatham County, Georgia",884,190,866,185,18,22
1500000US130510037002,130510037002,"Block Group 2, Census Tract 37, Chatham County, Georgia",879,182,857,183,22,23
1500000US130510038001,130510038001,"Block Group 1, Census Tract 38, Chatham County, Georgia",1214,273,1214,273,0,13
1500000US130510038002,130510038002,"Block Group 2, Census Tract 38, Chatham County, Georgia",1632,288,1588,292,44,49
1500000US130510039001,130510039001,"Block Group 1, Census Tract 39, Chatham County, Georgia",783,245,770,243,13,25
1500000US130510039002,130510039002,"Block Group 2, Census Tract 39, Chatham County, Georgia",765,316,765,316,0,13
1500000US130510039003,130510039003,"Block Group 3, Census Tract 39, Chatham County, Georgia",924,381,894,382,30,37
1500000US130510039004,130510039004,"Block Group 4, Census Tract 39, Chatham County, Georgia",1202,504,1202,504,0,13
1500000US130510040011,130510040011,"Block Group 1, Census Tract 40.01, Chatham County, Georgia",735,228,735,228,0,13
1500000US130510040012,130510040012,"Block Group 2, Census Tract 40.01, Chatham County, Georgia",657,192,657,192,0,13
1500000US130510040013,130510040013,"Block Group 3, Census Tract 40.01, Chatham County, Georgia",1072,249,1027,238,45,60
1500000US130510040014,130510040014,"Block Group 4, Census Tract 40.01, Chatham County, Georgia",842,150,820,154,22,27
1500000US130510040015,130510040015,"Block Group 5, Census Tract 40.01, Chatham County, Georgia",957,363,913,356,44,74
1500000US130510040021,130510040021,"Block Group 1, Census Tract 40.02, Chatham County, Georgia",896,304,871,302,25,31
1500000US130510040022,130510040022,"Block Group 2, Census Tract 40.02, Chatham County, Georgia",1279,250,1268,252,11,18
1500000US130510040023,130510040023,"Block Group 3, Census Tract 40.02, Chatham County, Georgia",711,298,608,261,103,162
1500000US130510040024,130510040024,"Block Group 4, Census Tract 40.02, Chatham County, Georgia",841,242,742,227,99,126
1500000US130510041001,130510041001,"Block Group 1, Census Tract 41, Chatham County, Georgia",1258,181,1235,181,23,23
1500000US130510041002,130510041002,"Block Group 2, Census Tract 41, Chatham County, Georgia",575,115,549,105,26,40
1500000US130510042071,130510042071,"Block Group 1, Census Tract 42.07, Chatham County, Georgia",2293,419,2250,416,43,53
1500000US130510042072,130510042072,"Block Group 2, Census Tract 42.07, Chatham County, Georgia",1153,291,1143,290,10,16
1500000US130510042073,130510042073,"Block Group 3, Census Tract 42.07, Chatham County, Georgia",187,112,187,112,0,13
1500000US130510042081,130510042081,"Block Group 1, Census Tract 42.08, Chatham County, Georgia",1308,322,1221,326,87,103
1500000US130510042082,130510042082,"Block Group 2, Census Tract 42.08, Chatham County, Georgia",861,379,636,194,225,343
1500000US130510042083,130510042083,"Block Group 3, Census Tract 42.08, Chatham County, Georgia",703,214,621,197,82,107
1500000US130510042084,130510042084,"Block Group 4, Census Tract 42.08, Chatham County, Georgia",1245,289,1117,261,128,118
1500000US130510042085,130510042085,"Block Group 5, Census Tract 42.08, Chatham County, Georgia",1113,259,941,255,172,104
1500000US130510042091,130510042091,"Block Group 1, Census Tract 42.09, Chatham County, Georgia",1537,343,1488,345,49,46
1500000US130510042092,130510042092,"Block Group 2, Census Tract 42.09, Chatham County, Georgia",1280,348,1074,274,206,203
1500000US130510042093,130510042093,"Block Group 3, Census Tract 42.09, Chatham County, Georgia",564,160,556,159,8,14
1500000US130510042101,130510042101,"Block Group 1, Census Tract 42.10, Chatham County, Georgia",422,196,390,187,32,39
1500000US130510042102,130510042102,"Block Group 2, Census Tract 42.10, Chatham County, Georgia",1637,439,1394,382,243,226
1500000US130510042103,130510042103,"Block Group 3, Census Tract 42.10, Chatham County, Georgia",1481,433,1313,371,168,134
1500000US130510042104,130510042104,"Block Group 4, Census Tract 42.10, Chatham County, Georgia",1462,391,1436,396,26,41
1500000US130510042111,130510042111,"Block Group 1, Census Tract 42.11, Chatham County, Georgia",796,340,779,338,17,29
1500000US130510042112,130510042112,"Block Group 2, Census Tract 42.11, Chatham County, Georgia",1737,502,1567,394,170,184
1500000US130510042113,130510042113,"Block Group 3, Census Tract 42.11, Chatham County, Georgia",1352,457,1323,476,29,54
1500000US130510042114,130510042114,"Block Group 4, Census Tract 42.11, Chatham County, Georgia",1410,331,1394,337,16,31
1500000US130510042121,130510042121,"Block Group 1, Census Tract 42.12, Chatham County, Georgia",3597,433,3363,422,234,126
1500000US130510042122,130510042122,"Block Group 2, Census Tract 42.12, Chatham County, Georgia",1438,326,1293,294,145,162
1500000US130510042123,130510042123,"Block Group 3, Census Tract 42.12, Chatham County, Georgia",1204,267,1152,266,52,56
1500000US130510043001,130510043001,"Block Group 1, Census Tract 43, Chatham County, Georgia",2711,288,2253,280,458,147
1500000US130510044001,130510044001,"Block Group 1, Census Tract 44, Chatham County, Georgia",1232,171,1201,179,31,43
1500000US130510044002,130510044002,"Block Group 2, Census Tract 44, Chatham County, Georgia",884,168,884,168,0,13
1500000US130510045001,130510045001,"Block Group 1, Census Tract 45, Chatham County, Georgia",556,261,556,261,0,13
1500000US130510045002,130510045002,"Block Group 2, Census Tract 45, Chatham County, Georgia",1026,413,960,385,66,106
1500000US130510045003,130510045003,"Block Group 3, Census Tract 45, Chatham County, Georgia",1498,383,1498,383,0,13
1500000US130510045004,130510045004,"Block Group 4, Census Tract 45, Chatham County, Georgia",1177,303,1177,303,0,13
1500000US130510101011,130510101011,"Block Group 1, Census Tract 101.01, Chatham County, Georgia",553,156,553,156,0,13
1500000US130510101012,130510101012,"Block Group 2, Census Tract 101.01, Chatham County, Georgia",362,53,358,51,4,6
1500000US130510101021,130510101021,"Block Group 1, Census Tract 101.02, Chatham County, Georgia",1021,201,823,193,198,104
1500000US130510101022,130510101022,"Block Group 2, Census Tract 101.02, Chatham County, Georgia",1519,351,1506,352,13,17
1500000US130510101023,130510101023,"Block Group 3, Census Tract 101.02, Chatham County, Georgia",1697,222,1659,226,38,41
1500000US130510102001,130510102001,"Block Group 1, Census Tract 102, Chatham County, Georgia",1687,433,1687,433,0,13
1500000US130510102002,130510102002,"Block Group 2, Census Tract 102, Chatham County, Georgia",1686,396,1675,393,11,18
1500000US130510102003,130510102003,"Block Group 3, Census Tract 102, Chatham County, Georgia",1481,484,1383,478,98,96
1500000US130510105011,130510105011,"Block Group 1, Census Tract 105.01, Chatham County, Georgia",868,422,366,238,502,462
1500000US130510105012,130510105012,"Block Group 2, Census Tract 105.01, Chatham County, Georgia",901,408,100,107,801,419
1500000US130510105013,130510105013,"Block Group 3, Census Tract 105.01, Chatham County, Georgia",3246,492,2750,419,496,237
1500000US130510105014,130510105014,"Block Group 4, Census Tract 105.01, Chatham County, Georgia",536,330,536,330,0,13
1500000US130510105015,130510105015,"Block Group 5, Census Tract 105.01, Chatham County, Georgia",560,254,449,257,111,127
1500000US130510105021,130510105021,"Block Group 1, Census Tract 105.02, Chatham County, Georgia",923,349,904,348,19,31
1500000US130510105022,130510105022,"Block Group 2, Census Tract 105.02, Chatham County, Georgia",2674,421,2674,421,0,13
1500000US130510106011,130510106011,"Block Group 1, Census Tract 106.01, Chatham County, Georgia",349,182,349,182,0,13
1500000US130510106012,130510106012,"Block Group 2, Census Tract 106.01, Chatham County, Georgia",1017,315,973,324,44,66
1500000US130510106013,130510106013,"Block Group 3, Census Tract 106.01, Chatham County, Georgia",429,223,377,195,52,84
1500000US130510106014,130510106014,"Block Group 4, Census Tract 106.01, Chatham County, Georgia",784,356,784,356,0,13
1500000US130510106015,130510106015,"Block Group 5, Census Tract 106.01, Chatham County, Georgia",733,393,696,384,37,56
1500000US130510106016,130510106016,"Block Group 6, Census Tract 106.01, Chatham County, Georgia",918,460,489,195,429,442
1500000US130510106031,130510106031,"Block Group 1, Census Tract 106.03, Chatham County, Georgia",1869,268,1837,264,32,28
1500000US130510106051,130510106051,"Block Group 1, Census Tract 106.05, Chatham County, Georgia",10,15,10,15,0,13
1500000US130510107001,130510107001,"Block Group 1, Census Tract 107, Chatham County, Georgia",19601,1804,17889,1886,1712,729
1500000US130510107002,130510107002,"Block Group 2, Census Tract 107, Chatham County, Georgia",748,433,649,369,99,194
1500000US130510107003,130510107003,"Block Group 3, Census Tract 107, Chatham County, Georgia",683,412,683,412,0,13
1500000US130510108011,130510108011,"Block Group 1, Census Tract 108.01, Chatham County, Georgia",1340,193,1297,188,43,35
1500000US130510108012,130510108012,"Block Group 2, Census Tract 108.01, Chatham County, Georgia",1313,177,1236,169,77,83
1500000US130510108021,130510108021,"Block Group 1, Census Tract 108.02, Chatham County, Georgia",7320,875,6974,888,346,141
1500000US130510108022,130510108022,"Block Group 2, Census Tract 108.02, Chatham County, Georgia",2052,602,2040,602,12,19
1500000US130510108031,130510108031,"Block Group 1, Census Tract 108.03, Chatham County, Georgia",1284,371,1284,371,0,13
1500000US130510108032,130510108032,"Block Group 2, Census Tract 108.03, Chatham County, Georgia",826,454,826,454,0,13
1500000US130510108033,130510108033,"Block Group 3, Census Tract 108.03, Chatham County, Georgia",4337,898,3946,887,391,258
1500000US130510108034,130510108034,"Block Group 4, Census Tract 108.03, Chatham County, Georgia",4768,875,4692,871,76,74
1500000US130510108061,130510108061,"Block Group 1, Census Tract 108.06, Chatham County, Georgia",2010,496,1964,494,46,54
1500000US130510108062,130510108062,"Block Group 2, Census Tract 108.06, Chatham County, Georgia",702,232,650,231,52,68
1500000US130510108063,130510108063,"Block Group 3, Census Tract 108.06, Chatham County, Georgia",1330,435,1221,421,109,123
1500000US130510108064,130510108064,"Block Group 4, Census Tract 108.06, Chatham County, Georgia",2342,527,2135,503,207,189
1500000US130510108071,130510108071,"Block Group 1, Census Tract 108.07, Chatham County, Georgia",2707,603,2463,573,244,194
1500000US130510108072,130510108072,"Block Group 2, Census Tract 108.07, Chatham County, Georgia",299,192,299,192,0,13
1500000US130510108073,130510108073,"Block Group 3, Census Tract 108.07, Chatham County, Georgia",1959,440,1759,461,200,153
1500000US130510108081,130510108081,"Block Group 1, Census Tract 108.08, Chatham County, Georgia",3843,781,3395,788,448,247
1500000US130510108082,130510108082,"Block Group 2, Census Tract 108.08, Chatham County, Georgia",1294,654,670,395,624,599
1500000US130510108083,130510108083,"Block Group 3, Census Tract 108.08, Chatham County, Georgia",2249,728,1810,576,439,494
1500000US130510108084,130510108084,"Block Group 4, Census Tract 108.08, Chatham County, Georgia",3335,931,3027,879,308,346
1500000US130510108091,130510108091,"Block Group 1, Census Tract 108.09, Chatham County, Georgia",4719,821,4362,765,357,274
1500000US130510108092,130510108092,"Block Group 2, Census Tract 108.09, Chatham County, Georgia",7075,844,6777,816,298,285
1500000US130510109011,130510109011,"Block Group 1, Census Tract 109.01, Chatham County, Georgia",1946,426,1483,392,463,238
1500000US130510109012,130510109012,"Block Group 2, Census Tract 109.01, Chatham County, Georgia",1526,411,1262,333,264,269
1500000US130510109013,130510109013,"Block Group 3, Census Tract 109.01, Chatham County, Georgia",809,262,806,260,3,6
1500000US130510110031,130510110031,"Block Group 1, Census Tract 110.03, Chatham County, Georgia",2042,411,1888,385,154,193
1500000US130510110032,130510110032,"Block Group 2, Census Tract 110.03, Chatham County, Georgia",1343,460,1081,478,262,241
1500000US130510110033,130510110033,"Block Group 3, Census Tract 110.03, Chatham County, Georgia",1649,539,1649,539,0,13
1500000US130510110034,130510110034,"Block Group 4, Census Tract 110.03, Chatham County, Georgia",643,277,555,261,88,138
1500000US130510110035,130510110035,"Block Group 5, Census Tract 110.03, Chatham County, Georgia",909,231,909,231,0,13
1500000US130510110041,130510110041,"Block Group 1, Census Tract 110.04, Chatham County, Georgia",1729,249,1701,247,28,28
1500000US130510110042,130510110042,"Block Group 2, Census Tract 110.04, Chatham County, Georgia",1019,181,1019,181,0,13
1500000US130510110043,130510110043,"Block Group 3, Census Tract 110.04, Chatham County, Georgia",756,193,745,191,11,18
1500000US130510110051,130510110051,"Block Group 1, Census Tract 110.05, Chatham County, Georgia",684,223,659,229,25,49
1500000US130510110052,130510110052,"Block Group 2, Census Tract 110.05, Chatham County, Georgia",1071,209,1071,209,0,13
1500000US130510110053,130510110053,"Block Group 3, Census Tract 110.05, Chatham County, Georgia",1156,315,1129,311,27,32
1500000US130510110054,130510110054,"Block Group 4, Census Tract 110.05, Chatham County, Georgia",1597,279,1542,275,55,88
1500000US130510110061,130510110061,"Block Group 1, Census Tract 110.06, Chatham County, Georgia",1188,203,1162,201,26,35
1500000US130510110062,130510110062,"Block Group 2, Census Tract 110.06, Chatham County, Georgia",2417,266,2360,257,57,62
1500000US130510111031,130510111031,"Block Group 1, Census Tract 111.03, Chatham County, Georgia",825,342,816,342,9,16
1500000US130510111032,130510111032,"Block Group 2, Census Tract 111.03, Chatham County, Georgia",841,250,841,250,0,13
1500000US130510111033,130510111033,"Block Group 3, Census Tract 111.03, Chatham County, Georgia",809,253,809,253,0,13
1500000US130510111034,130510111034,"Block Group 4, Census Tract 111.03, Chatham County, Georgia",918,312,918,312,0,13
1500000US130510111041,130510111041,"Block Group 1, Census Tract 111.04, Chatham County, Georgia",1560,352,1560,352,0,13
1500000US130510111042,130510111042,"Block Group 2, Census Tract 111.04, Chatham County, Georgia",2562,491,2503,500,59,94
1500000US130510111043,130510111043,"Block Group 3, Census Tract 111.04, Chatham County, Georgia",836,301,836,301,0,13
1500000US130510111061,130510111061,"Block Group 1, Census Tract 111.06, Chatham County, Georgia",2597,425,2524,432,73,82
1500000US130510111062,130510111062,"Block Group 2, Census Tract 111.06, Chatham County, Georgia",3197,586,3060,586,137,133
1500000US130510111071,130510111071,"Block Group 1, Census Tract 111.07, Chatham County, Georgia",662,209,602,190,60,69
1500000US130510111072,130510111072,"Block Group 2, Census Tract 111.07, Chatham County, Georgia",1237,249,1210,245,27,39
1500000US130510111073,130510111073,"Block Group 3, Census Tract 111.07, Chatham County, Georgia",1175,222,1168,219,7,14
1500000US130510111081,130510111081,"Block Group 1, Census Tract 111.08, Chatham County, Georgia",1493,236,1466,230,27,33
1500000US130510111082,130510111082,"Block Group 2, Census Tract 111.08, Chatham County, Georgia",1511,276,1503,277,8,12
1500000US130510111091,130510111091,"Block Group 1, Census Tract 111.09, Chatham County, Georgia",2143,443,2109,439,34,38
1500000US130510111092,130510111092,"Block Group 2, Census Tract 111.09, Chatham County, Georgia",3031,467,2873,471,158,123
1500000US130510111093,130510111093,"Block Group 3, Census Tract 111.09, Chatham County, Georgia",962,233,912,221,50,80
1500000US130510111094,130510111094,"Block Group 4, Census Tract 111.09, Chatham County, Georgia",683,224,683,224,0,13
1500000US130510112001,130510112001,"Block Group 1, Census Tract 112, Chatham County, Georgia",911,181,873,171,38,37
1500000US130510112002,130510112002,"Block Group 2, Census Tract 112, Chatham County, Georgia",846,153,788,146,58,46
1500000US130510113001,130510113001,"Block Group 1, Census Tract 113, Chatham County, Georgia",1181,323,1168,322,13,21
1500000US130510113002,130510113002,"Block Group 2, Census Tract 113, Chatham County, Georgia",1284,333,1238,323,46,42
1500000US130510114001,130510114001,"Block Group 1, Census Tract 114, Chatham County, Georgia",1262,241,1176,229,86,60
1500000US130510114002,130510114002,"Block Group 2, Census Tract 114, Chatham County, Georgia",823,170,807,159,16,26
1500000US130510115001,130510115001,"Block Group 1, Census Tract 115, Chatham County, Georgia",1123,195,1102,194,21,17
1500000US130510115002,130510115002,"Block Group 2, Census Tract 115, Chatham County, Georgia",1469,209,1456,213,13,22
1500000US130510116001,130510116001,"Block Group 1, Census Tract 116, Chatham County, Georgia",1028,323,1028,323,0,13
1500000US130510116002,130510116002,"Block Group 2, Census Tract 116, Chatham County, Georgia",1416,367,1129,326,287,182
1500000US130519800001,130519800001,"Block Group 1, Census Tract 9800, Chatham County, Georgia",0,13,0,13,0,13
1500000US130519900000,130519900000,"Block Group 0, Census Tract 9900, Chatham County, Georgia",0,13,0,13,0,13
1500000US130530201001,130530201001,"Block Group 1, Census Tract 201, Chattahoochee County, Georgia",1600,300,1567,298,33,41
1500000US130530201002,130530201002,"Block Group 2, Census Tract 201, Chattahoochee County, Georgia",948,242,948,242,0,13
1500000US130530202011,130530202011,"Block Group 1, Census Tract 202.01, Chattahoochee County, Georgia",3071,425,2547,398,524,183
1500000US130530202012,130530202012,"Block Group 2, Census Tract 202.01, Chattahoochee County, Georgia",750,244,642,224,108,63
1500000US130530202031,130530202031,"Block Group 1, Census Tract 202.03, Chattahoochee County, Georgia",1972,294,1541,290,431,144
1500000US130530202032,130530202032,"Block Group 2, Census Tract 202.03, Chattahoochee County, Georgia",210,87,196,80,14,15
1500000US130530202051,130530202051,"Block Group 1, Census Tract 202.05, Chattahoochee County, Georgia",1341,249,1037,212,304,140
1500000US130530202052,130530202052,"Block Group 2, Census Tract 202.05, Chattahoochee County, Georgia",458,131,320,109,138,93
1500000US130530202053,130530202053,"Block Group 3, Census Tract 202.05, Chattahoochee County, Georgia",1039,255,914,257,125,64
1500000US130530202061,130530202061,"Block Group 1, Census Tract 202.06, Chattahoochee County, Georgia",525,241,421,203,104,52
1500000US130550101001,130550101001,"Block Group 1, Census Tract 101, Chattooga County, Georgia",756,142,747,142,9,14
1500000US130550101002,130550101002,"Block Group 2, Census Tract 101, Chattooga County, Georgia",1233,135,1218,132,15,17
1500000US130550102001,130550102001,"Block Group 1, Census Tract 102, Chattooga County, Georgia",809,349,745,333,64,100
1500000US130550102002,130550102002,"Block Group 2, Census Tract 102, Chattooga County, Georgia",989,243,817,201,172,138
1500000US130550102003,130550102003,"Block Group 3, Census Tract 102, Chattooga County, Georgia",862,247,806,234,56,90
1500000US130550102004,130550102004,"Block Group 4, Census Tract 102, Chattooga County, Georgia",1519,478,1434,464,85,112
1500000US130550102005,130550102005,"Block Group 5, Census Tract 102, Chattooga County, Georgia",1170,217,723,183,447,190
1500000US130550102006,130550102006,"Block Group 6, Census Tract 102, Chattooga County, Georgia",978,285,978,285,0,13
1500000US130550103001,130550103001,"Block Group 1, Census Tract 103, Chattooga County, Georgia",919,208,906,209,13,22
1500000US130550103002,130550103002,"Block Group 2, Census Tract 103, Chattooga County, Georgia",1074,275,1074,275,0,13
1500000US130550103003,130550103003,"Block Group 3, Census Tract 103, Chattooga County, Georgia",934,231,934,231,0,13
1500000US130550104001,130550104001,"Block Group 1, Census Tract 104, Chattooga County, Georgia",2421,504,2421,504,0,13
1500000US130550104002,130550104002,"Block Group 2, Census Tract 104, Chattooga County, Georgia",1358,326,1358,326,0,13
1500000US130550104003,130550104003,"Block Group 3, Census Tract 104, Chattooga County, Georgia",968,233,968,233,0,13
1500000US130550104004,130550104004,"Block Group 4, Census Tract 104, Chattooga County, Georgia",644,271,644,271,0,13
1500000US130550105001,130550105001,"Block Group 1, Census Tract 105, Chattooga County, Georgia",978,228,978,228,0,13
1500000US130550105002,130550105002,"Block Group 2, Census Tract 105, Chattooga County, Georgia",2664,390,2481,354,183,138
1500000US130550105003,130550105003,"Block Group 3, Census Tract 105, Chattooga County, Georgia",716,196,686,182,30,47
1500000US130550105004,130550105004,"Block Group 4, Census Tract 105, Chattooga County, Georgia",854,261,854,261,0,13
1500000US130550105005,130550105005,"Block Group 5, Census Tract 105, Chattooga County, Georgia",879,223,879,223,0,13
1500000US130550106001,130550106001,"Block Group 1, Census Tract 106, Chattooga County, Georgia",1477,257,1382,248,95,112
1500000US130550106002,130550106002,"Block Group 2, Census Tract 106, Chattooga County, Georgia",1039,219,1038,219,1,3
1500000US130570901001,130570901001,"Block Group 1, Census Tract 901, Cherokee County, Georgia",999,480,754,298,245,378
1500000US130570901002,130570901002,"Block Group 2, Census Tract 901, Cherokee County, Georgia",2904,392,2861,383,43,34
1500000US130570901003,130570901003,"Block Group 3, Census Tract 901, Cherokee County, Georgia",1649,284,1637,285,12,17
1500000US130570901004,130570901004,"Block Group 4, Census Tract 901, Cherokee County, Georgia",3378,547,3378,547,0,13
1500000US130570902001,130570902001,"Block Group 1, Census Tract 902, Cherokee County, Georgia",2037,559,2011,555,26,27
1500000US130570902002,130570902002,"Block Group 2, Census Tract 902, Cherokee County, Georgia",3132,581,3033,547,99,117
1500000US130570902003,130570902003,"Block Group 3, Census Tract 902, Cherokee County, Georgia",2926,459,2926,459,0,13
1500000US130570903001,130570903001,"Block Group 1, Census Tract 903, Cherokee County, Georgia",5057,691,4788,656,269,193
1500000US130570903002,130570903002,"Block Group 2, Census Tract 903, Cherokee County, Georgia",7346,695,7147,721,199,115
1500000US130570904001,130570904001,"Block Group 1, Census Tract 904, Cherokee County, Georgia",1121,335,1068,324,53,83
1500000US130570904002,130570904002,"Block Group 2, Census Tract 904, Cherokee County, Georgia",4952,1017,3932,787,1020,628
1500000US130570904003,130570904003,"Block Group 3, Census Tract 904, Cherokee County, Georgia",3763,609,2731,493,1032,445
1500000US130570905011,130570905011,"Block Group 1, Census Tract 905.01, Cherokee County, Georgia",1774,482,1774,482,0,13
1500000US130570905012,130570905012,"Block Group 2, Census Tract 905.01, Cherokee County, Georgia",4499,515,4353,482,146,170
1500000US130570905021,130570905021,"Block Group 1, Census Tract 905.02, Cherokee County, Georgia",7259,1127,6427,1017,832,689
1500000US130570905022,130570905022,"Block Group 2, Census Tract 905.02, Cherokee County, Georgia",1932,792,1734,746,198,267
1500000US130570905023,130570905023,"Block Group 3, Census Tract 905.02, Cherokee County, Georgia",3282,1428,2571,719,711,852
1500000US130570905024,130570905024,"Block Group 4, Census Tract 905.02, Cherokee County, Georgia",1470,470,1470,470,0,13
1500000US130570906011,130570906011,"Block Group 1, Census Tract 906.01, Cherokee County, Georgia",1408,495,1213,363,195,304
1500000US130570906012,130570906012,"Block Group 2, Census Tract 906.01, Cherokee County, Georgia",4152,680,3396,458,756,483
1500000US130570906013,130570906013,"Block Group 3, Census Tract 906.01, Cherokee County, Georgia",2037,734,610,525,1427,591
1500000US130570906021,130570906021,"Block Group 1, Census Tract 906.02, Cherokee County, Georgia",5100,506,4383,436,717,324
1500000US130570906022,130570906022,"Block Group 2, Census Tract 906.02, Cherokee County, Georgia",1809,502,1583,449,226,301
1500000US130570906023,130570906023,"Block Group 3, Census Tract 906.02, Cherokee County, Georgia",1468,537,888,295,580,452
1500000US130570907011,130570907011,"Block Group 1, Census Tract 907.01, Cherokee County, Georgia",4068,1339,3756,1283,312,339
1500000US130570907012,130570907012,"Block Group 2, Census Tract 907.01, Cherokee County, Georgia",2082,948,2055,954,27,44
1500000US130570907013,130570907013,"Block Group 3, Census Tract 907.01, Cherokee County, Georgia",5284,1434,5284,1434,0,18
1500000US130570907014,130570907014,"Block Group 4, Census Tract 907.01, Cherokee County, Georgia",7376,1179,6494,1215,882,388
1500000US130570907021,130570907021,"Block Group 1, Census Tract 907.02, Cherokee County, Georgia",2742,591,2266,473,476,344
1500000US130570907022,130570907022,"Block Group 2, Census Tract 907.02, Cherokee County, Georgia",1229,464,1018,377,211,227
1500000US130570907023,130570907023,"Block Group 3, Census Tract 907.02, Cherokee County, Georgia",2197,539,1930,429,267,288
1500000US130570907024,130570907024,"Block Group 4, Census Tract 907.02, Cherokee County, Georgia",1520,436,1520,436,0,13
1500000US130570908021,130570908021,"Block Group 1, Census Tract 908.02, Cherokee County, Georgia",1996,402,1736,449,260,230
1500000US130570908022,130570908022,"Block Group 2, Census Tract 908.02, Cherokee County, Georgia",1949,394,1885,379,64,76
1500000US130570908023,130570908023,"Block Group 3, Census Tract 908.02, Cherokee County, Georgia",2983,657,2917,671,66,76
1500000US130570908031,130570908031,"Block Group 1, Census Tract 908.03, Cherokee County, Georgia",5678,606,5456,596,222,151
1500000US130570908032,130570908032,"Block Group 2, Census Tract 908.03, Cherokee County, Georgia",2276,566,2214,556,62,74
1500000US130570908033,130570908033,"Block Group 3, Census Tract 908.03, Cherokee County, Georgia",2301,608,2129,617,172,172
1500000US130570908041,130570908041,"Block Group 1, Census Tract 908.04, Cherokee County, Georgia",3220,669,3204,666,16,28
1500000US130570908042,130570908042,"Block Group 2, Census Tract 908.04, Cherokee County, Georgia",4687,681,4284,634,403,282
1500000US130570908043,130570908043,"Block Group 3, Census Tract 908.04, Cherokee County, Georgia",1568,503,1348,392,220,342
1500000US130570909011,130570909011,"Block Group 1, Census Tract 909.01, Cherokee County, Georgia",2676,590,2332,566,344,168
1500000US130570909012,130570909012,"Block Group 2, Census Tract 909.01, Cherokee County, Georgia",3420,667,3140,611,280,222
1500000US130570909013,130570909013,"Block Group 3, Census Tract 909.01, Cherokee County, Georgia",1697,456,1697,456,0,13
1500000US130570909021,130570909021,"Block Group 1, Census Tract 909.02, Cherokee County, Georgia",1603,424,1466,394,137,105
1500000US130570909022,130570909022,"Block Group 2, Census Tract 909.02, Cherokee County, Georgia",2418,641,2015,547,403,429
1500000US130570909023,130570909023,"Block Group 3, Census Tract 909.02, Cherokee County, Georgia",6168,891,5861,839,307,219
1500000US130570909024,130570909024,"Block Group 4, Census Tract 909.02, Cherokee County, Georgia",2281,443,2087,385,194,237
1500000US130570909025,130570909025,"Block Group 5, Census Tract 909.02, Cherokee County, Georgia",1969,557,1847,513,122,146
1500000US130570909041,130570909041,"Block Group 1, Census Tract 909.04, Cherokee County, Georgia",3010,626,2632,553,378,363
1500000US130570909042,130570909042,"Block Group 2, Census Tract 909.04, Cherokee County, Georgia",1642,639,992,453,650,533
1500000US130570909043,130570909043,"Block Group 3, Census Tract 909.04, Cherokee County, Georgia",2562,687,2067,438,495,461
1500000US130570909044,130570909044,"Block Group 4, Census Tract 909.04, Cherokee County, Georgia",1427,400,1406,399,21,35
1500000US130570909051,130570909051,"Block Group 1, Census Tract 909.05, Cherokee County, Georgia",2048,272,1813,264,235,151
1500000US130570909052,130570909052,"Block Group 2, Census Tract 909.05, Cherokee County, Georgia",1524,288,1435,268,89,56
1500000US130570910011,130570910011,"Block Group 1, Census Tract 910.01, Cherokee County, Georgia",802,264,658,289,144,210
1500000US130570910012,130570910012,"Block Group 2, Census Tract 910.01, Cherokee County, Georgia",791,451,521,318,270,365
1500000US130570910013,130570910013,"Block Group 3, Census Tract 910.01, Cherokee County, Georgia",2704,449,2674,446,30,28
1500000US130570910031,130570910031,"Block Group 1, Census Tract 910.03, Cherokee County, Georgia",3000,560,2710,521,290,304
1500000US130570910032,130570910032,"Block Group 2, Census Tract 910.03, Cherokee County, Georgia",1585,637,1001,359,584,538
1500000US130570910033,130570910033,"Block Group 3, Census Tract 910.03, Cherokee County, Georgia",2662,523,2371,471,291,212
1500000US130570910051,130570910051,"Block Group 1, Census Tract 910.05, Cherokee County, Georgia",2935,653,1466,309,1469,596
1500000US130570910052,130570910052,"Block Group 2, Census Tract 910.05, Cherokee County, Georgia",779,335,779,335,0,13
1500000US130570910053,130570910053,"Block Group 3, Census Tract 910.05, Cherokee County, Georgia",2472,787,2319,740,153,265
1500000US130570910054,130570910054,"Block Group 4, Census Tract 910.05, Cherokee County, Georgia",1833,924,1833,924,0,13
1500000US130570910061,130570910061,"Block Group 1, Census Tract 910.06, Cherokee County, Georgia",2345,305,2191,293,154,106
1500000US130570910062,130570910062,"Block Group 2, Census Tract 910.06, Cherokee County, Georgia",2549,339,2450,329,99,93
1500000US130570910071,130570910071,"Block Group 1, Census Tract 910.07, Cherokee County, Georgia",2091,417,1926,424,165,217
1500000US130570910072,130570910072,"Block Group 2, Census Tract 910.07, Cherokee County, Georgia",2852,640,2701,598,151,202
1500000US130570910073,130570910073,"Block Group 3, Census Tract 910.07, Cherokee County, Georgia",1657,470,1657,470,0,13
1500000US130570910081,130570910081,"Block Group 1, Census Tract 910.08, Cherokee County, Georgia",1174,349,1170,348,4,10
1500000US130570910082,130570910082,"Block Group 2, Census Tract 910.08, Cherokee County, Georgia",1248,348,1241,346,7,13
1500000US130570910083,130570910083,"Block Group 3, Census Tract 910.08, Cherokee County, Georgia",1876,444,1856,437,20,33
1500000US130570910084,130570910084,"Block Group 4, Census Tract 910.08, Cherokee County, Georgia",3894,672,3662,673,232,91
1500000US130570911011,130570911011,"Block Group 1, Census Tract 911.01, Cherokee County, Georgia",1871,376,1839,373,32,36
1500000US130570911012,130570911012,"Block Group 2, Census Tract 911.01, Cherokee County, Georgia",1961,347,1895,337,66,85
1500000US130570911013,130570911013,"Block Group 3, Census Tract 911.01, Cherokee County, Georgia",2164,488,2164,488,0,13
1500000US130570911021,130570911021,"Block Group 1, Census Tract 911.02, Cherokee County, Georgia",1965,609,1692,571,273,266
1500000US130570911022,130570911022,"Block Group 2, Census Tract 911.02, Cherokee County, Georgia",3188,613,2968,590,220,183
1500000US130570911023,130570911023,"Block Group 3, Census Tract 911.02, Cherokee County, Georgia",1830,444,1657,390,173,252
1500000US130570911024,130570911024,"Block Group 4, Census Tract 911.02, Cherokee County, Georgia",2004,683,1202,326,802,606
1500000US130570911031,130570911031,"Block Group 1, Census Tract 911.03, Cherokee County, Georgia",2168,497,1926,435,242,216
1500000US130570911032,130570911032,"Block Group 2, Census Tract 911.03, Cherokee County, Georgia",2699,497,2401,454,298,200
1500000US130570911033,130570911033,"Block Group 3, Census Tract 911.03, Cherokee County, Georgia",1395,480,1395,480,0,13
1500000US130570911034,130570911034,"Block Group 4, Census Tract 911.03, Cherokee County, Georgia",2395,695,2233,663,162,188
1500000US130590001001,130590001001,"Block Group 1, Census Tract 1, Clarke County, Georgia",1796,321,1753,319,43,34
1500000US130590004011,130590004011,"Block Group 1, Census Tract 4.01, Clarke County, Georgia",1385,156,1356,157,29,23
1500000US130590004021,130590004021,"Block Group 1, Census Tract 4.02, Clarke County, Georgia",1972,268,1882,259,90,56
1500000US130590004022,130590004022,"Block Group 2, Census Tract 4.02, Clarke County, Georgia",3271,347,3143,357,128,79
1500000US130590004023,130590004023,"Block Group 3, Census Tract 4.02, Clarke County, Georgia",2518,319,2378,320,140,62
1500000US130590006001,130590006001,"Block Group 1, Census Tract 6, Clarke County, Georgia",991,284,952,266,39,40
1500000US130590006002,130590006002,"Block Group 2, Census Tract 6, Clarke County, Georgia",2002,282,1782,272,220,109
1500000US130590009001,130590009001,"Block Group 1, Census Tract 9, Clarke County, Georgia",993,351,918,318,75,106
1500000US130590009002,130590009002,"Block Group 2, Census Tract 9, Clarke County, Georgia",1268,357,1196,362,72,88
1500000US130590009003,130590009003,"Block Group 3, Census Tract 9, Clarke County, Georgia",1029,316,1029,316,0,13
1500000US130590012001,130590012001,"Block Group 1, Census Tract 12, Clarke County, Georgia",2002,382,1899,391,103,88
1500000US130590012002,130590012002,"Block Group 2, Census Tract 12, Clarke County, Georgia",1067,382,1065,383,2,5
1500000US130590017001,130590017001,"Block Group 1, Census Tract 17, Clarke County, Georgia",2120,156,2050,150,70,66
1500000US130590018001,130590018001,"Block Group 1, Census Tract 18, Clarke County, Georgia",1088,239,1088,239,0,13
1500000US130590018002,130590018002,"Block Group 2, Census Tract 18, Clarke County, Georgia",211,106,203,106,8,15
1500000US130590018003,130590018003,"Block Group 3, Census Tract 18, Clarke County, Georgia",1094,225,1006,203,88,80
1500000US130590019001,130590019001,"Block Group 1, Census Tract 19, Clarke County, Georgia",2111,351,2036,352,75,54
1500000US130590019002,130590019002,"Block Group 2, Census Tract 19, Clarke County, Georgia",2066,486,1899,482,167,148
1500000US130590020001,130590020001,"Block Group 1, Census Tract 20, Clarke County, Georgia",999,197,970,200,29,37
1500000US130590020002,130590020002,"Block Group 2, Census Tract 20, Clarke County, Georgia",1081,161,1081,161,0,13
1500000US130590021001,130590021001,"Block Group 1, Census Tract 21, Clarke County, Georgia",2579,337,2470,352,109,73
1500000US130590021002,130590021002,"Block Group 2, Census Tract 21, Clarke County, Georgia",1481,329,1481,329,0,13
1500000US130590022001,130590022001,"Block Group 1, Census Tract 22, Clarke County, Georgia",1064,208,1016,201,48,50
1500000US130590022002,130590022002,"Block Group 2, Census Tract 22, Clarke County, Georgia",1210,260,1147,257,63,59
1500000US130590301001,130590301001,"Block Group 1, Census Tract 301, Clarke County, Georgia",1902,415,1881,411,21,33
1500000US130590301002,130590301002,"Block Group 2, Census Tract 301, Clarke County, Georgia",3006,532,2960,538,46,67
1500000US130590302001,130590302001,"Block Group 1, Census Tract 302, Clarke County, Georgia",1011,315,964,310,47,53
1500000US130590302002,130590302002,"Block Group 2, Census Tract 302, Clarke County, Georgia",1230,453,1048,401,182,211
1500000US130590302003,130590302003,"Block Group 3, Census Tract 302, Clarke County, Georgia",2517,478,2517,478,0,13
1500000US130591303001,130591303001,"Block Group 1, Census Tract 1303, Clarke County, Georgia",2585,597,1179,327,1406,571
1500000US130591303002,130591303002,"Block Group 2, Census Tract 1303, Clarke County, Georgia",3460,581,2362,448,1098,461
1500000US130591304001,130591304001,"Block Group 1, Census Tract 1304, Clarke County, Georgia",2554,500,2297,457,257,218
1500000US130591304002,130591304002,"Block Group 2, Census Tract 1304, Clarke County, Georgia",1736,512,1682,514,54,94
1500000US130591304003,130591304003,"Block Group 3, Census Tract 1304, Clarke County, Georgia",1341,445,1326,447,15,25
1500000US130591305001,130591305001,"Block Group 1, Census Tract 1305, Clarke County, Georgia",1245,226,1228,228,17,23
1500000US130591305002,130591305002,"Block Group 2, Census Tract 1305, Clarke County, Georgia",896,199,834,201,62,78
1500000US130591305003,130591305003,"Block Group 3, Census Tract 1305, Clarke County, Georgia",523,170,523,170,0,13
1500000US130591306001,130591306001,"Block Group 1, Census Tract 1306, Clarke County, Georgia",1608,392,1608,392,0,13
1500000US130591306002,130591306002,"Block Group 2, Census Tract 1306, Clarke County, Georgia",2981,746,2634,651,347,431
1500000US130591306003,130591306003,"Block Group 3, Census Tract 1306, Clarke County, Georgia",2003,623,1174,432,829,604
1500000US130591307001,130591307001,"Block Group 1, Census Tract 1307, Clarke County, Georgia",2381,466,2195,469,186,207
1500000US130591307002,130591307002,"Block Group 2, Census Tract 1307, Clarke County, Georgia",1270,329,1196,332,74,94
1500000US130591307003,130591307003,"Block Group 3, Census Tract 1307, Clarke County, Georgia",1658,446,1447,334,211,304
1500000US130591403001,130591403001,"Block Group 1, Census Tract 1403, Clarke County, Georgia",1897,507,1054,326,843,484
1500000US130591403002,130591403002,"Block Group 2, Census Tract 1403, Clarke County, Georgia",1282,385,1142,291,140,174
1500000US130591403003,130591403003,"Block Group 3, Census Tract 1403, Clarke County, Georgia",2034,538,1652,536,382,179
1500000US130591404001,130591404001,"Block Group 1, Census Tract 1404, Clarke County, Georgia",1190,253,1012,202,178,165
1500000US130591404002,130591404002,"Block Group 2, Census Tract 1404, Clarke County, Georgia",2418,468,918,326,1500,388
1500000US130591405001,130591405001,"Block Group 1, Census Tract 1405, Clarke County, Georgia",2130,312,1735,350,395,221
1500000US130591406001,130591406001,"Block Group 1, Census Tract 1406, Clarke County, Georgia",672,199,533,136,139,193
1500000US130591406002,130591406002,"Block Group 2, Census Tract 1406, Clarke County, Georgia",2793,370,2386,350,407,302
1500000US130591406003,130591406003,"Block Group 3, Census Tract 1406, Clarke County, Georgia",1457,348,1326,302,131,183
1500000US130591503001,130591503001,"Block Group 1, Census Tract 1503, Clarke County, Georgia",1117,248,831,181,286,203
1500000US130591503002,130591503002,"Block Group 2, Census Tract 1503, Clarke County, Georgia",973,339,965,340,8,14
1500000US130591503003,130591503003,"Block Group 3, Census Tract 1503, Clarke County, Georgia",1271,303,1111,263,160,163
1500000US130591504001,130591504001,"Block Group 1, Census Tract 1504, Clarke County, Georgia",2276,580,2133,552,143,101
1500000US130591504002,130591504002,"Block Group 2, Census Tract 1504, Clarke County, Georgia",1701,392,1668,394,33,41
1500000US130591504003,130591504003,"Block Group 3, Census Tract 1504, Clarke County, Georgia",961,370,943,368,18,21
1500000US130591505001,130591505001,"Block Group 1, Census Tract 1505, Clarke County, Georgia",1433,325,1342,330,91,87
1500000US130591505002,130591505002,"Block Group 2, Census Tract 1505, Clarke County, Georgia",1352,314,1185,247,167,142
1500000US130591505003,130591505003,"Block Group 3, Census Tract 1505, Clarke County, Georgia",1792,467,1659,468,133,120
1500000US130591506001,130591506001,"Block Group 1, Census Tract 1506, Clarke County, Georgia",1361,271,1163,294,198,137
1500000US130591506002,130591506002,"Block Group 2, Census Tract 1506, Clarke County, Georgia",1537,246,1364,258,173,192
1500000US130591507001,130591507001,"Block Group 1, Census Tract 1507, Clarke County, Georgia",1480,372,1424,380,56,77
1500000US130591507002,130591507002,"Block Group 2, Census Tract 1507, Clarke County, Georgia",2959,601,2921,599,38,44
1500000US130591507003,130591507003,"Block Group 3, Census Tract 1507, Clarke County, Georgia",1215,429,1060,378,155,227
1500000US130591508001,130591508001,"Block Group 1, Census Tract 1508, Clarke County, Georgia",1839,344,1583,334,256,210
1500000US130591508002,130591508002,"Block Group 2, Census Tract 1508, Clarke County, Georgia",945,360,945,360,0,13
1500000US130591508003,130591508003,"Block Group 3, Census Tract 1508, Clarke County, Georgia",1334,427,1318,428,16,24
1500000US130591508004,130591508004,"Block Group 4, Census Tract 1508, Clarke County, Georgia",2027,425,2007,423,20,29
1500000US130591509001,130591509001,"Block Group 1, Census Tract 1509, Clarke County, Georgia",2170,340,2170,340,0,13
1500000US130591509002,130591509002,"Block Group 2, Census Tract 1509, Clarke County, Georgia",1984,407,1730,346,254,261
1500000US130619603001,130619603001,"Block Group 1, Census Tract 9603, Clay County, Georgia",1699,242,1552,228,147,201
1500000US130619603002,130619603002,"Block Group 2, Census Tract 9603, Clay County, Georgia",609,162,609,162,0,13
1500000US130619603003,130619603003,"Block Group 3, Census Tract 9603, Clay County, Georgia",796,194,791,195,5,9
1500000US130630402021,130630402021,"Block Group 1, Census Tract 402.02, Clayton County, Georgia",1355,252,1287,243,68,65
1500000US130630402022,130630402022,"Block Group 2, Census Tract 402.02, Clayton County, Georgia",1139,282,1017,292,122,111
1500000US130630402031,130630402031,"Block Group 1, Census Tract 402.03, Clayton County, Georgia",763,432,763,432,0,13
1500000US130630402032,130630402032,"Block Group 2, Census Tract 402.03, Clayton County, Georgia",2434,436,2256,426,178,135
1500000US130630402041,130630402041,"Block Group 1, Census Tract 402.04, Clayton County, Georgia",1149,405,1095,404,54,63
1500000US130630402042,130630402042,"Block Group 2, Census Tract 402.04, Clayton County, Georgia",877,349,867,349,10,16
1500000US130630402043,130630402043,"Block Group 3, Census Tract 402.04, Clayton County, Georgia",1554,431,1482,420,72,100
1500000US130630403021,130630403021,"Block Group 1, Census Tract 403.02, Clayton County, Georgia",1190,370,844,320,346,279
1500000US130630403022,130630403022,"Block Group 2, Census Tract 403.02, Clayton County, Georgia",1189,429,632,201,557,407
1500000US130630403023,130630403023,"Block Group 3, Census Tract 403.02, Clayton County, Georgia",1275,467,1194,454,81,85
1500000US130630403024,130630403024,"Block Group 4, Census Tract 403.02, Clayton County, Georgia",1177,419,758,251,419,315
1500000US130630403031,130630403031,"Block Group 1, Census Tract 403.03, Clayton County, Georgia",1448,591,1151,483,297,357
1500000US130630403032,130630403032,"Block Group 2, Census Tract 403.03, Clayton County, Georgia",947,444,719,398,228,265
1500000US130630403033,130630403033,"Block Group 3, Census Tract 403.03, Clayton County, Georgia",784,445,690,434,94,152
1500000US130630403034,130630403034,"Block Group 4, Census Tract 403.03, Clayton County, Georgia",1160,468,1130,466,30,53
1500000US130630403035,130630403035,"Block Group 5, Census Tract 403.03, Clayton County, Georgia",1048,432,591,352,457,423
1500000US130630403036,130630403036,"Block Group 6, Census Tract 403.03, Clayton County, Georgia",968,584,697,519,271,390
1500000US130630403061,130630403061,"Block Group 1, Census Tract 403.06, Clayton County, Georgia",2143,569,1158,442,985,463
1500000US130630403062,130630403062,"Block Group 2, Census Tract 403.06, Clayton County, Georgia",1914,458,959,317,955,464
1500000US130630403071,130630403071,"Block Group 1, Census Tract 403.07, Clayton County, Georgia",1803,484,1267,350,536,344
1500000US130630403072,130630403072,"Block Group 2, Census Tract 403.07, Clayton County, Georgia",2753,476,2372,431,381,214
1500000US130630403081,130630403081,"Block Group 1, Census Tract 403.08, Clayton County, Georgia",1881,432,1245,266,636,296
1500000US130630403082,130630403082,"Block Group 2, Census Tract 403.08, Clayton County, Georgia",1653,351,1127,292,526,277
1500000US130630403083,130630403083,"Block Group 3, Census Tract 403.08, Clayton County, Georgia",819,218,525,187,294,202
1500000US130630404071,130630404071,"Block Group 1, Census Tract 404.07, Clayton County, Georgia",1919,435,1655,435,264,173
1500000US130630404072,130630404072,"Block Group 2, Census Tract 404.07, Clayton County, Georgia",2143,628,1743,479,400,301
1500000US130630404081,130630404081,"Block Group 1, Census Tract 404.08, Clayton County, Georgia",2086,556,1713,498,373,175
1500000US130630404082,130630404082,"Block Group 2, Census Tract 404.08, Clayton County, Georgia",3556,536,3448,521,108,101
1500000US130630404083,130630404083,"Block Group 3, Census Tract 404.08, Clayton County, Georgia",2473,535,2281,500,192,196
1500000US130630404091,130630404091,"Block Group 1, Census Tract 404.09, Clayton County, Georgia",2275,367,2010,363,265,180
1500000US130630404092,130630404092,"Block Group 2, Census Tract 404.09, Clayton County, Georgia",3613,651,2967,476,646,464
1500000US130630404101,130630404101,"Block Group 1, Census Tract 404.10, Clayton County, Georgia",5999,1089,4710,887,1289,767
1500000US130630404102,130630404102,"Block Group 2, Census Tract 404.10, Clayton County, Georgia",1317,634,589,316,728,616
1500000US130630404111,130630404111,"Block Group 1, Census Tract 404.11, Clayton County, Georgia",2912,811,2831,804,81,133
1500000US130630404112,130630404112,"Block Group 2, Census Tract 404.11, Clayton County, Georgia",2890,864,2403,743,487,397
1500000US130630404113,130630404113,"Block Group 3, Census Tract 404.11, Clayton County, Georgia",2357,621,2135,635,222,253
1500000US130630404114,130630404114,"Block Group 4, Census Tract 404.11, Clayton County, Georgia",4865,1111,4865,1111,0,13
1500000US130630404121,130630404121,"Block Group 1, Census Tract 404.12, Clayton County, Georgia",2743,810,2370,695,373,326
1500000US130630404122,130630404122,"Block Group 2, Census Tract 404.12, Clayton County, Georgia",3161,675,2823,631,338,286
1500000US130630404123,130630404123,"Block Group 3, Census Tract 404.12, Clayton County, Georgia",2139,606,2115,608,24,43
1500000US130630404131,130630404131,"Block Group 1, Census Tract 404.13, Clayton County, Georgia",2950,556,2394,494,556,331
1500000US130630404132,130630404132,"Block Group 2, Census Tract 404.13, Clayton County, Georgia",4002,602,3609,555,393,286
1500000US130630404141,130630404141,"Block Group 1, Census Tract 404.14, Clayton County, Georgia",1870,310,1068,273,802,277
1500000US130630404151,130630404151,"Block Group 1, Census Tract 404.15, Clayton County, Georgia",1468,558,980,397,488,445
1500000US130630404152,130630404152,"Block Group 2, Census Tract 404.15, Clayton County, Georgia",1858,843,1717,830,141,171
1500000US130630404153,130630404153,"Block Group 3, Census Tract 404.15, Clayton County, Georgia",689,289,401,226,288,208
1500000US130630404154,130630404154,"Block Group 4, Census Tract 404.15, Clayton County, Georgia",1985,765,1428,651,557,335
1500000US130630404161,130630404161,"Block Group 1, Census Tract 404.16, Clayton County, Georgia",2180,462,1592,417,588,269
1500000US130630404162,130630404162,"Block Group 2, Census Tract 404.16, Clayton County, Georgia",1997,525,1611,447,386,305
1500000US130630404171,130630404171,"Block Group 1, Census Tract 404.17, Clayton County, Georgia",2417,590,2237,596,180,120
1500000US130630404172,130630404172,"Block Group 2, Census Tract 404.17, Clayton County, Georgia",791,319,451,235,340,247
1500000US130630404173,130630404173,"Block Group 3, Census Tract 404.17, Clayton County, Georgia",1403,338,1340,337,63,84
1500000US130630405091,130630405091,"Block Group 1, Census Tract 405.09, Clayton County, Georgia",1909,391,1798,379,111,119
1500000US130630405092,130630405092,"Block Group 2, Census Tract 405.09, Clayton County, Georgia",2795,561,2655,542,140,174
1500000US130630405101,130630405101,"Block Group 1, Census Tract 405.10, Clayton County, Georgia",1808,393,1599,370,209,161
1500000US130630405102,130630405102,"Block Group 2, Census Tract 405.10, Clayton County, Georgia",1532,518,1508,518,24,41
1500000US130630405121,130630405121,"Block Group 1, Census Tract 405.12, Clayton County, Georgia",2436,506,2384,506,52,47
1500000US130630405122,130630405122,"Block Group 2, Census Tract 405.12, Clayton County, Georgia",595,279,575,284,20,30
1500000US130630405123,130630405123,"Block Group 3, Census Tract 405.12, Clayton County, Georgia",2331,557,2206,552,125,93
1500000US130630405131,130630405131,"Block Group 1, Census Tract 405.13, Clayton County, Georgia",1690,701,1690,701,0,13
1500000US130630405132,130630405132,"Block Group 2, Census Tract 405.13, Clayton County, Georgia",985,323,969,324,16,18
1500000US130630405133,130630405133,"Block Group 3, Census Tract 405.13, Clayton County, Georgia",2098,564,2088,556,10,19
1500000US130630405141,130630405141,"Block Group 1, Census Tract 405.14, Clayton County, Georgia",1231,372,1206,384,25,41
1500000US130630405142,130630405142,"Block Group 2, Census Tract 405.14, Clayton County, Georgia",1717,438,643,314,1074,288
1500000US130630405143,130630405143,"Block Group 3, Census Tract 405.14, Clayton County, Georgia",3977,626,3884,586,93,102
1500000US130630405151,130630405151,"Block Group 1, Census Tract 405.15, Clayton County, Georgia",867,443,587,362,280,334
1500000US130630405152,130630405152,"Block Group 2, Census Tract 405.15, Clayton County, Georgia",2230,745,2082,732,148,165
1500000US130630405153,130630405153,"Block Group 3, Census Tract 405.15, Clayton County, Georgia",1670,692,1155,441,515,531
1500000US130630405154,130630405154,"Block Group 4, Census Tract 405.15, Clayton County, Georgia",3016,775,2840,745,176,302
1500000US130630405161,130630405161,"Block Group 1, Census Tract 405.16, Clayton County, Georgia",3561,742,3455,767,106,96
1500000US130630405162,130630405162,"Block Group 2, Census Tract 405.16, Clayton County, Georgia",1293,595,1025,568,268,195
1500000US130630405163,130630405163,"Block Group 3, Census Tract 405.16, Clayton County, Georgia",1178,472,1050,513,128,203
1500000US130630405181,130630405181,"Block Group 1, Census Tract 405.18, Clayton County, Georgia",698,246,640,236,58,58
1500000US130630405182,130630405182,"Block Group 2, Census Tract 405.18, Clayton County, Georgia",2841,460,2596,459,245,251
1500000US130630405183,130630405183,"Block Group 3, Census Tract 405.18, Clayton County, Georgia",1585,509,1200,349,385,381
1500000US130630405191,130630405191,"Block Group 1, Census Tract 405.19, Clayton County, Georgia",3414,539,3290,530,124,92
1500000US130630405192,130630405192,"Block Group 2, Census Tract 405.19, Clayton County, Georgia",785,277,714,249,71,76
1500000US130630405201,130630405201,"Block Group 1, Census Tract 405.20, Clayton County, Georgia",818,294,777,287,41,59
1500000US130630405202,130630405202,"Block Group 2, Census Tract 405.20, Clayton County, Georgia",580,207,580,207,0,13
1500000US130630405203,130630405203,"Block Group 3, Census Tract 405.20, Clayton County, Georgia",2044,389,1914,406,130,178
1500000US130630405211,130630405211,"Block Group 1, Census Tract 405.21, Clayton County, Georgia",1977,405,1832,379,145,126
1500000US130630405212,130630405212,"Block Group 2, Census Tract 405.21, Clayton County, Georgia",1371,342,1330,325,41,53
1500000US130630405221,130630405221,"Block Group 1, Census Tract 405.22, Clayton County, Georgia",1972,421,1709,385,263,255
1500000US130630405222,130630405222,"Block Group 2, Census Tract 405.22, Clayton County, Georgia",1452,292,1395,307,57,73
1500000US130630405223,130630405223,"Block Group 3, Census Tract 405.22, Clayton County, Georgia",1106,323,966,341,140,128
1500000US130630405231,130630405231,"Block Group 1, Census Tract 405.23, Clayton County, Georgia",3115,446,2887,417,228,224
1500000US130630405241,130630405241,"Block Group 1, Census Tract 405.24, Clayton County, Georgia",2086,557,1914,566,172,155
1500000US130630405242,130630405242,"Block Group 2, Census Tract 405.24, Clayton County, Georgia",1966,638,1609,436,357,509
1500000US130630405243,130630405243,"Block Group 3, Census Tract 405.24, Clayton County, Georgia",1025,387,932,358,93,130
1500000US130630405244,130630405244,"Block Group 4, Census Tract 405.24, Clayton County, Georgia",2128,687,1636,557,492,414
1500000US130630405251,130630405251,"Block Group 1, Census Tract 405.25, Clayton County, Georgia",2729,343,2554,363,175,125
1500000US130630405261,130630405261,"Block Group 1, Census Tract 405.26, Clayton County, Georgia",2492,805,2325,797,167,193
1500000US130630405262,130630405262,"Block Group 2, Census Tract 405.26, Clayton County, Georgia",2289,925,1991,885,298,225
1500000US130630405263,130630405263,"Block Group 3, Census Tract 405.26, Clayton County, Georgia",1565,546,1515,551,50,59
1500000US130630406061,130630406061,"Block Group 1, Census Tract 406.06, Clayton County, Georgia",1879,396,1674,384,205,195
1500000US130630406062,130630406062,"Block Group 2, Census Tract 406.06, Clayton County, Georgia",1863,476,1192,294,671,360
1500000US130630406081,130630406081,"Block Group 1, Census Tract 406.08, Clayton County, Georgia",8648,798,8148,791,500,232
1500000US130630406082,130630406082,"Block Group 2, Census Tract 406.08, Clayton County, Georgia",2726,561,2687,552,39,58
1500000US130630406091,130630406091,"Block Group 1, Census Tract 406.09, Clayton County, Georgia",1633,522,1562,521,71,81
1500000US130630406092,130630406092,"Block Group 2, Census Tract 406.09, Clayton County, Georgia",2284,667,1993,622,291,216
1500000US130630406093,130630406093,"Block Group 3, Census Tract 406.09, Clayton County, Georgia",2243,517,2129,504,114,91
1500000US130630406111,130630406111,"Block Group 1, Census Tract 406.11, Clayton County, Georgia",3422,802,2294,684,1128,510
1500000US130630406112,130630406112,"Block Group 2, Census Tract 406.11, Clayton County, Georgia",762,341,677,342,85,76
1500000US130630406113,130630406113,"Block Group 3, Census Tract 406.11, Clayton County, Georgia",2025,554,1681,552,344,234
1500000US130630406121,130630406121,"Block Group 1, Census Tract 406.12, Clayton County, Georgia",940,286,911,286,29,41
1500000US130630406122,130630406122,"Block Group 2, Census Tract 406.12, Clayton County, Georgia",2979,676,2491,602,488,346
1500000US130630406123,130630406123,"Block Group 3, Census Tract 406.12, Clayton County, Georgia",2521,362,2408,362,113,41
1500000US130630406131,130630406131,"Block Group 1, Census Tract 406.13, Clayton County, Georgia",2714,749,2526,737,188,151
1500000US130630406132,130630406132,"Block Group 2, Census Tract 406.13, Clayton County, Georgia",2869,879,2576,794,293,425
1500000US130630406133,130630406133,"Block Group 3, Census Tract 406.13, Clayton County, Georgia",2585,643,2497,629,88,117
1500000US130630406141,130630406141,"Block Group 1, Census Tract 406.14, Clayton County, Georgia",1207,250,1207,250,0,13
1500000US130630406142,130630406142,"Block Group 2, Census Tract 406.14, Clayton County, Georgia",1943,236,1766,285,177,153
1500000US130630406143,130630406143,"Block Group 3, Census Tract 406.14, Clayton County, Georgia",1677,402,1546,391,131,160
1500000US130630406151,130630406151,"Block Group 1, Census Tract 406.15, Clayton County, Georgia",2107,276,1976,271,131,98
1500000US130630406161,130630406161,"Block Group 1, Census Tract 406.16, Clayton County, Georgia",5156,913,4826,854,330,308
1500000US130630406162,130630406162,"Block Group 2, Census Tract 406.16, Clayton County, Georgia",744,277,731,275,13,22
1500000US130630406163,130630406163,"Block Group 3, Census Tract 406.16, Clayton County, Georgia",2450,814,1632,574,818,593
1500000US130630406171,130630406171,"Block Group 1, Census Tract 406.17, Clayton County, Georgia",1694,315,660,112,1034,312
1500000US130630406191,130630406191,"Block Group 1, Census Tract 406.19, Clayton County, Georgia",3526,444,3189,520,337,282
1500000US130630406201,130630406201,"Block Group 1, Census Tract 406.20, Clayton County, Georgia",3302,481,3009,477,293,268
1500000US130630406211,130630406211,"Block Group 1, Census Tract 406.21, Clayton County, Georgia",5776,994,5314,888,462,431
1500000US130630406212,130630406212,"Block Group 2, Census Tract 406.21, Clayton County, Georgia",4633,849,4298,804,335,273
1500000US130630406221,130630406221,"Block Group 1, Census Tract 406.22, Clayton County, Georgia",3455,1253,3091,1160,364,292
1500000US130630406222,130630406222,"Block Group 2, Census Tract 406.22, Clayton County, Georgia",3382,829,2847,701,535,391
1500000US130630406223,130630406223,"Block Group 3, Census Tract 406.22, Clayton County, Georgia",1651,716,1568,701,83,130
1500000US130639800001,130639800001,"Block Group 1, Census Tract 9800, Clayton County, Georgia",0,13,0,13,0,13
1500000US130659701001,130659701001,"Block Group 1, Census Tract 9701, Clinch County, Georgia",1008,302,1008,302,0,13
1500000US130659701002,130659701002,"Block Group 2, Census Tract 9701, Clinch County, Georgia",1745,302,1686,286,59,101
1500000US130659701003,130659701003,"Block Group 3, Census Tract 9701, Clinch County, Georgia",491,136,491,136,0,13
1500000US130659701004,130659701004,"Block Group 4, Census Tract 9701, Clinch County, Georgia",895,278,895,278,0,13
1500000US130659701005,130659701005,"Block Group 5, Census Tract 9701, Clinch County, Georgia",1175,282,984,229,191,143
1500000US130659702001,130659702001,"Block Group 1, Census Tract 9702, Clinch County, Georgia",653,177,628,165,25,49
1500000US130659702002,130659702002,"Block Group 2, Census Tract 9702, Clinch County, Georgia",824,150,814,149,10,26
1500000US130670301011,130670301011,"Block Group 1, Census Tract 301.01, Cobb County, Georgia",1402,381,1214,374,188,214
1500000US130670301012,130670301012,"Block Group 2, Census Tract 301.01, Cobb County, Georgia",1858,474,1615,467,243,245
1500000US130670301013,130670301013,"Block Group 3, Census Tract 301.01, Cobb County, Georgia",2656,585,2461,557,195,172
1500000US130670301014,130670301014,"Block Group 4, Census Tract 301.01, Cobb County, Georgia",1883,453,1866,449,17,28
1500000US130670301031,130670301031,"Block Group 1, Census Tract 301.03, Cobb County, Georgia",2252,841,2184,865,68,127
1500000US130670301032,130670301032,"Block Group 2, Census Tract 301.03, Cobb County, Georgia",2793,656,2767,644,26,44
1500000US130670301033,130670301033,"Block Group 3, Census Tract 301.03, Cobb County, Georgia",4074,646,3764,602,310,211
1500000US130670301041,130670301041,"Block Group 1, Census Tract 301.04, Cobb County, Georgia",951,307,773,260,178,166
1500000US130670301042,130670301042,"Block Group 2, Census Tract 301.04, Cobb County, Georgia",2695,366,2403,416,292,181
1500000US130670301061,130670301061,"Block Group 1, Census Tract 301.06, Cobb County, Georgia",2365,667,2157,690,208,166
1500000US130670301062,130670301062,"Block Group 2, Census Tract 301.06, Cobb County, Georgia",2241,573,1844,559,397,363
1500000US130670301063,130670301063,"Block Group 3, Census Tract 301.06, Cobb County, Georgia",3234,597,3059,591,175,285
1500000US130670301071,130670301071,"Block Group 1, Census Tract 301.07, Cobb County, Georgia",1813,443,1631,378,182,234
1500000US130670301072,130670301072,"Block Group 2, Census Tract 301.07, Cobb County, Georgia",3006,369,2684,431,322,247
1500000US130670302091,130670302091,"Block Group 1, Census Tract 302.09, Cobb County, Georgia",1727,386,1617,360,110,123
1500000US130670302092,130670302092,"Block Group 2, Census Tract 302.09, Cobb County, Georgia",1980,438,1980,438,0,13
1500000US130670302093,130670302093,"Block Group 3, Census Tract 302.09, Cobb County, Georgia",2961,542,2713,503,248,252
1500000US130670302141,130670302141,"Block Group 1, Census Tract 302.14, Cobb County, Georgia",2945,470,2945,470,0,13
1500000US130670302142,130670302142,"Block Group 2, Census Tract 302.14, Cobb County, Georgia",2324,549,2193,514,131,159
1500000US130670302143,130670302143,"Block Group 3, Census Tract 302.14, Cobb County, Georgia",2930,642,2548,615,382,334
1500000US130670302151,130670302151,"Block Group 1, Census Tract 302.15, Cobb County, Georgia",2687,453,2376,404,311,239
1500000US130670302152,130670302152,"Block Group 2, Census Tract 302.15, Cobb County, Georgia",2236,840,1722,640,514,499
1500000US130670302153,130670302153,"Block Group 3, Census Tract 302.15, Cobb County, Georgia",1559,395,1173,292,386,274
1500000US130670302154,130670302154,"Block Group 4, Census Tract 302.15, Cobb County, Georgia",2968,458,2858,439,110,141
1500000US130670302181,130670302181,"Block Group 1, Census Tract 302.18, Cobb County, Georgia",2864,426,2604,424,260,154
1500000US130670302182,130670302182,"Block Group 2, Census Tract 302.18, Cobb County, Georgia",2777,493,2508,467,269,177
1500000US130670302191,130670302191,"Block Group 1, Census Tract 302.19, Cobb County, Georgia",2257,504,2066,459,191,166
1500000US130670302192,130670302192,"Block Group 2, Census Tract 302.19, Cobb County, Georgia",2357,520,2184,481,173,290
1500000US130670302193,130670302193,"Block Group 3, Census Tract 302.19, Cobb County, Georgia",2215,572,2175,548,40,64
1500000US130670302194,130670302194,"Block Group 4, Census Tract 302.19, Cobb County, Georgia",2406,654,2257,533,149,232
1500000US130670302201,130670302201,"Block Group 1, Census Tract 302.20, Cobb County, Georgia",1866,118,1732,160,134,112
1500000US130670302221,130670302221,"Block Group 1, Census Tract 302.22, Cobb County, Georgia",2660,449,2624,448,36,45
1500000US130670302222,130670302222,"Block Group 2, Census Tract 302.22, Cobb County, Georgia",2365,425,2162,442,203,167
1500000US130670302223,130670302223,"Block Group 3, Census Tract 302.22, Cobb County, Georgia",860,233,833,232,27,45
1500000US130670302231,130670302231,"Block Group 1, Census Tract 302.23, Cobb County, Georgia",3135,482,2590,441,545,312
1500000US130670302232,130670302232,"Block Group 2, Census Tract 302.23, Cobb County, Georgia",2132,460,2006,401,126,194
1500000US130670302233,130670302233,"Block Group 3, Census Tract 302.23, Cobb County, Georgia",650,290,598,269,52,81
1500000US130670302241,130670302241,"Block Group 1, Census Tract 302.24, Cobb County, Georgia",5609,711,4815,658,794,561
1500000US130670302242,130670302242,"Block Group 2, Census Tract 302.24, Cobb County, Georgia",1040,329,827,328,213,151
1500000US130670302261,130670302261,"Block Group 1, Census Tract 302.26, Cobb County, Georgia",4182,795,3435,705,747,388
1500000US130670302262,130670302262,"Block Group 2, Census Tract 302.26, Cobb County, Georgia",1749,535,1508,502,241,212
1500000US130670302263,130670302263,"Block Group 3, Census Tract 302.26, Cobb County, Georgia",2959,725,2792,731,167,136
1500000US130670302271,130670302271,"Block Group 1, Census Tract 302.27, Cobb County, Georgia",2002,690,1448,554,554,509
1500000US130670302272,130670302272,"Block Group 2, Census Tract 302.27, Cobb County, Georgia",3512,779,3110,664,402,533
1500000US130670302273,130670302273,"Block Group 3, Census Tract 302.27, Cobb County, Georgia",2367,546,2214,541,153,129
1500000US130670302281,130670302281,"Block Group 1, Census Tract 302.28, Cobb County, Georgia",2369,512,1945,406,424,301
1500000US130670302282,130670302282,"Block Group 2, Census Tract 302.28, Cobb County, Georgia",1212,413,1154,413,58,95
1500000US130670302283,130670302283,"Block Group 3, Census Tract 302.28, Cobb County, Georgia",2131,804,1678,365,453,581
1500000US130670302284,130670302284,"Block Group 4, Census Tract 302.28, Cobb County, Georgia",1377,498,1351,495,26,50
1500000US130670302291,130670302291,"Block Group 1, Census Tract 302.29, Cobb County, Georgia",171,102,171,102,0,13
1500000US130670302292,130670302292,"Block Group 2, Census Tract 302.29, Cobb County, Georgia",5681,662,5418,698,263,135
1500000US130670302301,130670302301,"Block Group 1, Census Tract 302.30, Cobb County, Georgia",7581,1085,5917,1044,1664,601
1500000US130670302302,130670302302,"Block Group 2, Census Tract 302.30, Cobb County, Georgia",5400,878,5231,842,169,222
1500000US130670302311,130670302311,"Block Group 1, Census Tract 302.31, Cobb County, Georgia",827,316,775,277,52,64
1500000US130670302312,130670302312,"Block Group 2, Census Tract 302.31, Cobb County, Georgia",1777,397,1777,397,0,13
1500000US130670302313,130670302313,"Block Group 3, Census Tract 302.31, Cobb County, Georgia",1755,374,1702,374,53,49
1500000US130670302314,130670302314,"Block Group 4, Census Tract 302.31, Cobb County, Georgia",2838,448,2789,459,49,59
1500000US130670302321,130670302321,"Block Group 1, Census Tract 302.32, Cobb County, Georgia",2481,304,2219,270,262,151
1500000US130670302322,130670302322,"Block Group 2, Census Tract 302.32, Cobb County, Georgia",3201,402,2898,383,303,222
1500000US130670302331,130670302331,"Block Group 1, Census Tract 302.33, Cobb County, Georgia",1411,334,1212,285,199,241
1500000US130670302332,130670302332,"Block Group 2, Census Tract 302.33, Cobb County, Georgia",2835,285,2710,332,125,146
1500000US130670302341,130670302341,"Block Group 1, Census Tract 302.34, Cobb County, Georgia",3140,409,3042,385,98,154
1500000US130670302342,130670302342,"Block Group 2, Census Tract 302.34, Cobb County, Georgia",2989,399,2856,402,133,117
1500000US130670302351,130670302351,"Block Group 1, Census Tract 302.35, Cobb County, Georgia",1696,260,1566,237,130,159
1500000US130670302352,130670302352,"Block Group 2, Census Tract 302.35, Cobb County, Georgia",3184,314,3068,312,116,99
1500000US130670302361,130670302361,"Block Group 1, Census Tract 302.36, Cobb County, Georgia",2306,352,2260,348,46,51
1500000US130670302362,130670302362,"Block Group 2, Census Tract 302.36, Cobb County, Georgia",2451,458,2377,449,74,125
1500000US130670302381,130670302381,"Block Group 1, Census Tract 302.38, Cobb County, Georgia",3335,567,3300,565,35,43
1500000US130670302382,130670302382,"Block Group 2, Census Tract 302.38, Cobb County, Georgia",3376,611,3060,519,316,390
1500000US130670302391,130670302391,"Block Group 1, Census Tract 302.39, Cobb County, Georgia",1978,669,1608,574,370,358
1500000US130670302392,130670302392,"Block Group 2, Census Tract 302.39, Cobb County, Georgia",3033,590,2988,594,45,54
1500000US130670302393,130670302393,"Block Group 3, Census Tract 302.39, Cobb County, Georgia",3453,669,3340,673,113,137
1500000US130670303101,130670303101,"Block Group 1, Census Tract 303.10, Cobb County, Georgia",1497,540,1323,515,174,170
1500000US130670303102,130670303102,"Block Group 2, Census Tract 303.10, Cobb County, Georgia",2530,586,2485,600,45,60
1500000US130670303103,130670303103,"Block Group 3, Census Tract 303.10, Cobb County, Georgia",687,273,582,242,105,161
1500000US130670303104,130670303104,"Block Group 4, Census Tract 303.10, Cobb County, Georgia",1998,471,1801,501,197,177
1500000US130670303105,130670303105,"Block Group 5, Census Tract 303.10, Cobb County, Georgia",1415,508,1332,530,83,91
1500000US130670303111,130670303111,"Block Group 1, Census Tract 303.11, Cobb County, Georgia",1687,432,1687,432,0,13
1500000US130670303112,130670303112,"Block Group 2, Census Tract 303.11, Cobb County, Georgia",1137,295,1112,298,25,33
1500000US130670303113,130670303113,"Block Group 3, Census Tract 303.11, Cobb County, Georgia",973,211,973,211,0,13
1500000US130670303114,130670303114,"Block Group 4, Census Tract 303.11, Cobb County, Georgia",2066,388,1759,331,307,274
1500000US130670303121,130670303121,"Block Group 1, Census Tract 303.12, Cobb County, Georgia",2640,333,2618,328,22,30
1500000US130670303122,130670303122,"Block Group 2, Census Tract 303.12, Cobb County, Georgia",1380,357,1313,372,67,115
1500000US130670303123,130670303123,"Block Group 3, Census Tract 303.12, Cobb County, Georgia",1373,269,1160,271,213,162
1500000US130670303124,130670303124,"Block Group 4, Census Tract 303.12, Cobb County, Georgia",686,323,611,291,75,119
1500000US130670303131,130670303131,"Block Group 1, Census Tract 303.13, Cobb County, Georgia",1697,381,1374,359,323,298
1500000US130670303132,130670303132,"Block Group 2, Census Tract 303.13, Cobb County, Georgia",679,279,679,279,0,13
1500000US130670303133,130670303133,"Block Group 3, Census Tract 303.13, Cobb County, Georgia",1109,326,1018,329,91,143
1500000US130670303134,130670303134,"Block Group 4, Census Tract 303.13, Cobb County, Georgia",1751,435,1654,467,97,126
1500000US130670303135,130670303135,"Block Group 5, Census Tract 303.13, Cobb County, Georgia",3177,704,3177,704,0,13
1500000US130670303141,130670303141,"Block Group 1, Census Tract 303.14, Cobb County, Georgia",2244,332,1907,318,337,160
1500000US130670303142,130670303142,"Block Group 2, Census Tract 303.14, Cobb County, Georgia",2252,351,2166,321,86,73
1500000US130670303143,130670303143,"Block Group 3, Census Tract 303.14, Cobb County, Georgia",3420,434,3167,426,253,230
1500000US130670303181,130670303181,"Block Group 1, Census Tract 303.18, Cobb County, Georgia",2577,432,2577,432,0,13
1500000US130670303182,130670303182,"Block Group 2, Census Tract 303.18, Cobb County, Georgia",2748,353,2652,366,96,86
1500000US130670303183,130670303183,"Block Group 3, Census Tract 303.18, Cobb County, Georgia",2677,464,2568,433,109,130
1500000US130670303191,130670303191,"Block Group 1, Census Tract 303.19, Cobb County, Georgia",1896,337,1864,344,32,31
1500000US130670303192,130670303192,"Block Group 2, Census Tract 303.19, Cobb County, Georgia",2369,346,2306,357,63,91
1500000US130670303201,130670303201,"Block Group 1, Census Tract 303.20, Cobb County, Georgia",2908,410,2731,408,177,160
1500000US130670303202,130670303202,"Block Group 2, Census Tract 303.20, Cobb County, Georgia",2757,434,2563,450,194,153
1500000US130670303203,130670303203,"Block Group 3, Census Tract 303.20, Cobb County, Georgia",2206,365,2132,350,74,77
1500000US130670303221,130670303221,"Block Group 1, Census Tract 303.22, Cobb County, Georgia",1312,220,1250,222,62,54
1500000US130670303222,130670303222,"Block Group 2, Census Tract 303.22, Cobb County, Georgia",2101,208,1997,239,104,96
1500000US130670303241,130670303241,"Block Group 1, Census Tract 303.24, Cobb County, Georgia",1801,334,1664,346,137,127
1500000US130670303242,130670303242,"Block Group 2, Census Tract 303.24, Cobb County, Georgia",1723,393,1693,388,30,37
1500000US130670303261,130670303261,"Block Group 1, Census Tract 303.26, Cobb County, Georgia",1566,287,1556,288,10,17
1500000US130670303262,130670303262,"Block Group 2, Census Tract 303.26, Cobb County, Georgia",1978,296,1896,279,82,50
1500000US130670303263,130670303263,"Block Group 3, Census Tract 303.26, Cobb County, Georgia",1102,445,651,160,451,484
1500000US130670303271,130670303271,"Block Group 1, Census Tract 303.27, Cobb County, Georgia",3082,330,2991,335,91,70
1500000US130670303272,130670303272,"Block Group 2, Census Tract 303.27, Cobb County, Georgia",1333,252,1322,254,11,19
1500000US130670303281,130670303281,"Block Group 1, Census Tract 303.28, Cobb County, Georgia",1873,409,1797,410,76,95
1500000US130670303282,130670303282,"Block Group 2, Census Tract 303.28, Cobb County, Georgia",2539,566,2111,346,428,551
1500000US130670303283,130670303283,"Block Group 3, Census Tract 303.28, Cobb County, Georgia",2001,350,2001,350,0,13
1500000US130670303291,130670303291,"Block Group 1, Census Tract 303.29, Cobb County, Georgia",2809,293,2738,290,71,56
1500000US130670303292,130670303292,"Block Group 2, Census Tract 303.29, Cobb County, Georgia",1498,218,1498,218,0,13
1500000US130670303301,130670303301,"Block Group 1, Census Tract 303.30, Cobb County, Georgia",1767,338,1722,338,45,51
1500000US130670303302,130670303302,"Block Group 2, Census Tract 303.30, Cobb County, Georgia",2447,391,2390,386,57,60
1500000US130670303303,130670303303,"Block Group 3, Census Tract 303.30, Cobb County, Georgia",1654,278,1616,262,38,45
1500000US130670303311,130670303311,"Block Group 1, Census Tract 303.31, Cobb County, Georgia",2412,368,2283,372,129,121
1500000US130670303312,130670303312,"Block Group 2, Census Tract 303.31, Cobb County, Georgia",2256,333,2199,336,57,53
1500000US130670303313,130670303313,"Block Group 3, Census Tract 303.31, Cobb County, Georgia",1031,251,1027,251,4,8
1500000US130670303321,130670303321,"Block Group 1, Census Tract 303.32, Cobb County, Georgia",1527,187,1527,187,0,13
1500000US130670303322,130670303322,"Block Group 2, Census Tract 303.32, Cobb County, Georgia",1892,255,1781,262,111,105
1500000US130670303331,130670303331,"Block Group 1, Census Tract 303.33, Cobb County, Georgia",2787,435,2647,439,140,105
1500000US130670303332,130670303332,"Block Group 2, Census Tract 303.33, Cobb County, Georgia",1857,341,1776,353,81,104
1500000US130670303333,130670303333,"Block Group 3, Census Tract 303.33, Cobb County, Georgia",1273,281,1273,281,0,13
1500000US130670303341,130670303341,"Block Group 1, Census Tract 303.34, Cobb County, Georgia",1385,298,1347,295,38,41
1500000US130670303342,130670303342,"Block Group 2, Census Tract 303.34, Cobb County, Georgia",1894,321,1887,321,7,13
1500000US130670303351,130670303351,"Block Group 1, Census Tract 303.35, Cobb County, Georgia",2471,264,2396,250,75,93
1500000US130670303352,130670303352,"Block Group 2, Census Tract 303.35, Cobb County, Georgia",2101,240,2003,239,98,91
1500000US130670303361,130670303361,"Block Group 1, Census Tract 303.36, Cobb County, Georgia",1946,384,1791,365,155,164
1500000US130670303362,130670303362,"Block Group 2, Census Tract 303.36, Cobb County, Georgia",1556,351,1463,413,93,116
1500000US130670303363,130670303363,"Block Group 3, Census Tract 303.36, Cobb County, Georgia",2336,315,2261,306,75,92
1500000US130670303364,130670303364,"Block Group 4, Census Tract 303.36, Cobb County, Georgia",1468,267,1420,291,48,78
1500000US130670303371,130670303371,"Block Group 1, Census Tract 303.37, Cobb County, Georgia",1521,284,1437,311,84,81
1500000US130670303372,130670303372,"Block Group 2, Census Tract 303.37, Cobb County, Georgia",1902,270,1845,265,57,79
1500000US130670303373,130670303373,"Block Group 3, Census Tract 303.37, Cobb County, Georgia",994,233,987,235,7,12
1500000US130670303391,130670303391,"Block Group 1, Census Tract 303.39, Cobb County, Georgia",1439,360,1272,301,167,181
1500000US130670303392,130670303392,"Block Group 2, Census Tract 303.39, Cobb County, Georgia",4423,489,4094,571,329,214
1500000US130670303401,130670303401,"Block Group 1, Census Tract 303.40, Cobb County, Georgia",1802,301,1657,267,145,197
1500000US130670303402,130670303402,"Block Group 2, Census Tract 303.40, Cobb County, Georgia",2141,286,1834,309,307,277
1500000US130670303411,130670303411,"Block Group 1, Census Tract 303.41, Cobb County, Georgia",2154,255,2013,288,141,117
1500000US130670303412,130670303412,"Block Group 2, Census Tract 303.41, Cobb County, Georgia",2283,312,2128,320,155,116
1500000US130670303421,130670303421,"Block Group 1, Census Tract 303.42, Cobb County, Georgia",1806,273,1730,278,76,70
1500000US130670303422,130670303422,"Block Group 2, Census Tract 303.42, Cobb County, Georgia",2935,281,2880,275,55,72
1500000US130670303431,130670303431,"Block Group 1, Census Tract 303.43, Cobb County, Georgia",1734,266,1702,272,32,39
1500000US130670303432,130670303432,"Block Group 2, Census Tract 303.43, Cobb County, Georgia",1722,302,1708,303,14,17
1500000US130670303433,130670303433,"Block Group 3, Census Tract 303.43, Cobb County, Georgia",1137,200,1126,205,11,18
1500000US130670303441,130670303441,"Block Group 1, Census Tract 303.44, Cobb County, Georgia",2402,362,2196,330,206,195
1500000US130670303442,130670303442,"Block Group 2, Census Tract 303.44, Cobb County, Georgia",732,213,611,190,121,144
1500000US130670303443,130670303443,"Block Group 3, Census Tract 303.44, Cobb County, Georgia",474,129,394,114,80,75
1500000US130670303451,130670303451,"Block Group 1, Census Tract 303.45, Cobb County, Georgia",2730,507,1582,350,1148,398
1500000US130670303452,130670303452,"Block Group 2, Census Tract 303.45, Cobb County, Georgia",347,133,347,133,0,13
1500000US130670303453,130670303453,"Block Group 3, Census Tract 303.45, Cobb County, Georgia",1912,350,1782,336,130,123
1500000US130670304051,130670304051,"Block Group 1, Census Tract 304.05, Cobb County, Georgia",2611,496,2611,496,0,13
1500000US130670304052,130670304052,"Block Group 2, Census Tract 304.05, Cobb County, Georgia",1169,379,1019,310,150,249
1500000US130670304053,130670304053,"Block Group 3, Census Tract 304.05, Cobb County, Georgia",1829,417,1768,410,61,95
1500000US130670304054,130670304054,"Block Group 4, Census Tract 304.05, Cobb County, Georgia",575,276,575,276,0,13
1500000US130670304071,130670304071,"Block Group 1, Census Tract 304.07, Cobb County, Georgia",1900,259,1788,271,112,123
1500000US130670304072,130670304072,"Block Group 2, Census Tract 304.07, Cobb County, Georgia",1451,376,1354,357,97,96
1500000US130670304073,130670304073,"Block Group 3, Census Tract 304.07, Cobb County, Georgia",1491,275,1358,274,133,72
1500000US130670304081,130670304081,"Block Group 1, Census Tract 304.08, Cobb County, Georgia",1557,280,1351,280,206,154
1500000US130670304082,130670304082,"Block Group 2, Census Tract 304.08, Cobb County, Georgia",1577,283,1478,259,99,99
1500000US130670304091,130670304091,"Block Group 1, Census Tract 304.09, Cobb County, Georgia",2000,233,2000,233,0,13
1500000US130670304092,130670304092,"Block Group 2, Census Tract 304.09, Cobb County, Georgia",1576,233,1463,225,113,123
1500000US130670304101,130670304101,"Block Group 1, Census Tract 304.10, Cobb County, Georgia",2587,632,1971,435,616,684
1500000US130670304102,130670304102,"Block Group 2, Census Tract 304.10, Cobb County, Georgia",2266,399,1933,368,333,203
1500000US130670304111,130670304111,"Block Group 1, Census Tract 304.11, Cobb County, Georgia",1014,387,811,357,203,204
1500000US130670304112,130670304112,"Block Group 2, Census Tract 304.11, Cobb County, Georgia",1009,392,518,197,491,332
1500000US130670304113,130670304113,"Block Group 3, Census Tract 304.11, Cobb County, Georgia",1566,364,1339,340,227,192
1500000US130670304121,130670304121,"Block Group 1, Census Tract 304.12, Cobb County, Georgia",527,156,476,154,51,40
1500000US130670304122,130670304122,"Block Group 2, Census Tract 304.12, Cobb County, Georgia",3313,457,2482,384,831,373
1500000US130670304123,130670304123,"Block Group 3, Census Tract 304.12, Cobb County, Georgia",398,167,362,170,36,47
1500000US130670304124,130670304124,"Block Group 4, Census Tract 304.12, Cobb County, Georgia",356,226,356,226,0,13
1500000US130670304131,130670304131,"Block Group 1, Census Tract 304.13, Cobb County, Georgia",1861,714,1349,597,512,486
1500000US130670304132,130670304132,"Block Group 2, Census Tract 304.13, Cobb County, Georgia",2109,570,1895,537,214,201
1500000US130670304133,130670304133,"Block Group 3, Census Tract 304.13, Cobb County, Georgia",2073,557,1776,535,297,233
1500000US130670304141,130670304141,"Block Group 1, Census Tract 304.14, Cobb County, Georgia",2038,389,1777,356,261,241
1500000US130670304142,130670304142,"Block Group 2, Census Tract 304.14, Cobb County, Georgia",912,236,857,253,55,89
1500000US130670305021,130670305021,"Block Group 1, Census Tract 305.02, Cobb County, Georgia",3077,418,2596,380,481,211
1500000US130670305022,130670305022,"Block Group 2, Census Tract 305.02, Cobb County, Georgia",2449,456,2414,456,35,57
1500000US130670305023,130670305023,"Block Group 3, Census Tract 305.02, Cobb County, Georgia",1184,295,1043,280,141,149
1500000US130670305041,130670305041,"Block Group 1, Census Tract 305.04, Cobb County, Georgia",3454,644,3191,559,263,275
1500000US130670305042,130670305042,"Block Group 2, Census Tract 305.04, Cobb County, Georgia",1141,432,1084,431,57,97
1500000US130670305043,130670305043,"Block Group 3, Census Tract 305.04, Cobb County, Georgia",1769,623,1285,861,484,413
1500000US130670305044,130670305044,"Block Group 4, Census Tract 305.04, Cobb County, Georgia",457,178,457,178,0,13
1500000US130670305051,130670305051,"Block Group 1, Census Tract 305.05, Cobb County, Georgia",1707,414,1461,322,246,238
1500000US130670305052,130670305052,"Block Group 2, Census Tract 305.05, Cobb County, Georgia",1801,454,1486,346,315,357
1500000US130670305053,130670305053,"Block Group 3, Census Tract 305.05, Cobb County, Georgia",1514,462,1387,456,127,177
1500000US130670305054,130670305054,"Block Group 4, Census Tract 305.05, Cobb County, Georgia",2037,699,982,296,1055,622
1500000US130670305061,130670305061,"Block Group 1, Census Tract 305.06, Cobb County, Georgia",2367,384,2074,338,293,196
1500000US130670305062,130670305062,"Block Group 2, Census Tract 305.06, Cobb County, Georgia",1822,422,1578,445,244,170
1500000US130670305071,130670305071,"Block Group 1, Census Tract 305.07, Cobb County, Georgia",3123,482,2879,480,244,122
1500000US130670305072,130670305072,"Block Group 2, Census Tract 305.07, Cobb County, Georgia",1910,361,1761,351,149,160
1500000US130670306011,130670306011,"Block Group 1, Census Tract 306.01, Cobb County, Georgia",3225,1168,2923,1198,302,283
1500000US130670306012,130670306012,"Block Group 2, Census Tract 306.01, Cobb County, Georgia",1345,753,1295,747,50,83
1500000US130670306013,130670306013,"Block Group 3, Census Tract 306.01, Cobb County, Georgia",4539,825,4180,864,359,255
1500000US130670306021,130670306021,"Block Group 1, Census Tract 306.02, Cobb County, Georgia",2886,427,2839,436,47,48
1500000US130670306022,130670306022,"Block Group 2, Census Tract 306.02, Cobb County, Georgia",343,141,326,130,17,20
1500000US130670306023,130670306023,"Block Group 3, Census Tract 306.02, Cobb County, Georgia",2442,525,2203,488,239,261
1500000US130670306024,130670306024,"Block Group 4, Census Tract 306.02, Cobb County, Georgia",975,226,937,222,38,45
1500000US130670307001,130670307001,"Block Group 1, Census Tract 307, Cobb County, Georgia",1388,266,1005,262,383,220
1500000US130670307002,130670307002,"Block Group 2, Census Tract 307, Cobb County, Georgia",1004,257,914,252,90,110
1500000US130670307003,130670307003,"Block Group 3, Census Tract 307, Cobb County, Georgia",818,247,682,176,136,170
1500000US130670307004,130670307004,"Block Group 4, Census Tract 307, Cobb County, Georgia",654,195,528,190,126,125
1500000US130670308001,130670308001,"Block Group 1, Census Tract 308, Cobb County, Georgia",1187,402,577,218,610,384
1500000US130670308002,130670308002,"Block Group 2, Census Tract 308, Cobb County, Georgia",3013,593,1922,421,1091,391
1500000US130670308003,130670308003,"Block Group 3, Census Tract 308, Cobb County, Georgia",1113,293,989,260,124,91
1500000US130670309011,130670309011,"Block Group 1, Census Tract 309.01, Cobb County, Georgia",589,220,530,219,59,70
1500000US130670309012,130670309012,"Block Group 2, Census Tract 309.01, Cobb County, Georgia",1134,288,1134,288,0,13
1500000US130670309013,130670309013,"Block Group 3, Census Tract 309.01, Cobb County, Georgia",1759,952,1759,952,0,13
1500000US130670309014,130670309014,"Block Group 4, Census Tract 309.01, Cobb County, Georgia",1229,269,1229,269,0,13
1500000US130670309015,130670309015,"Block Group 5, Census Tract 309.01, Cobb County, Georgia",2747,543,2423,547,324,277
1500000US130670309021,130670309021,"Block Group 1, Census Tract 309.02, Cobb County, Georgia",1304,509,799,211,505,507
1500000US130670309022,130670309022,"Block Group 2, Census Tract 309.02, Cobb County, Georgia",2287,404,1198,357,1089,416
1500000US130670309023,130670309023,"Block Group 3, Census Tract 309.02, Cobb County, Georgia",1354,421,1354,421,0,13
1500000US130670309024,130670309024,"Block Group 4, Census Tract 309.02, Cobb County, Georgia",840,348,578,147,262,312
1500000US130670309041,130670309041,"Block Group 1, Census Tract 309.04, Cobb County, Georgia",1529,709,586,303,943,637
1500000US130670309042,130670309042,"Block Group 2, Census Tract 309.04, Cobb County, Georgia",1723,436,1572,420,151,170
1500000US130670309043,130670309043,"Block Group 3, Census Tract 309.04, Cobb County, Georgia",1679,543,1283,514,396,309
1500000US130670309044,130670309044,"Block Group 4, Census Tract 309.04, Cobb County, Georgia",1615,528,1122,399,493,442
1500000US130670309051,130670309051,"Block Group 1, Census Tract 309.05, Cobb County, Georgia",2934,519,2623,491,311,92
1500000US130670309052,130670309052,"Block Group 2, Census Tract 309.05, Cobb County, Georgia",833,375,668,317,165,235
1500000US130670309053,130670309053,"Block Group 3, Census Tract 309.05, Cobb County, Georgia",3511,650,2086,443,1425,492
1500000US130670309054,130670309054,"Block Group 4, Census Tract 309.05, Cobb County, Georgia",930,343,597,200,333,277
1500000US130670310011,130670310011,"Block Group 1, Census Tract 310.01, Cobb County, Georgia",1634,537,637,257,997,474
1500000US130670310012,130670310012,"Block Group 2, Census Tract 310.01, Cobb County, Georgia",946,303,577,199,369,270
1500000US130670310013,130670310013,"Block Group 3, Census Tract 310.01, Cobb County, Georgia",2987,591,1572,413,1415,564
1500000US130670310021,130670310021,"Block Group 1, Census Tract 310.02, Cobb County, Georgia",3679,800,1634,551,2045,833
1500000US130670310022,130670310022,"Block Group 2, Census Tract 310.02, Cobb County, Georgia",1848,714,954,524,894,573
1500000US130670310023,130670310023,"Block Group 3, Census Tract 310.02, Cobb County, Georgia",1960,634,1231,429,729,459
1500000US130670310024,130670310024,"Block Group 4, Census Tract 310.02, Cobb County, Georgia",2227,602,1709,452,518,466
1500000US130670310041,130670310041,"Block Group 1, Census Tract 310.04, Cobb County, Georgia",2770,637,1358,450,1412,484
1500000US130670310042,130670310042,"Block Group 2, Census Tract 310.04, Cobb County, Georgia",1088,416,877,392,211,209
1500000US130670310043,130670310043,"Block Group 3, Census Tract 310.04, Cobb County, Georgia",2414,567,1464,391,950,500
1500000US130670310044,130670310044,"Block Group 4, Census Tract 310.04, Cobb County, Georgia",1269,387,1229,386,40,64
1500000US130670310051,130670310051,"Block Group 1, Census Tract 310.05, Cobb County, Georgia",2988,531,2115,432,873,422
1500000US130670310052,130670310052,"Block Group 2, Census Tract 310.05, Cobb County, Georgia",2558,472,1735,426,823,302
1500000US130670311011,130670311011,"Block Group 1, Census Tract 311.01, Cobb County, Georgia",2153,498,1257,305,896,454
1500000US130670311012,130670311012,"Block Group 2, Census Tract 311.01, Cobb County, Georgia",1322,418,807,291,515,364
1500000US130670311013,130670311013,"Block Group 3, Census Tract 311.01, Cobb County, Georgia",1236,303,847,252,389,235
1500000US130670311061,130670311061,"Block Group 1, Census Tract 311.06, Cobb County, Georgia",1400,698,1400,698,0,13
1500000US130670311062,130670311062,"Block Group 2, Census Tract 311.06, Cobb County, Georgia",2744,773,2340,677,404,251
1500000US130670311063,130670311063,"Block Group 3, Census Tract 311.06, Cobb County, Georgia",1841,389,1624,345,217,233
1500000US130670311064,130670311064,"Block Group 4, Census Tract 311.06, Cobb County, Georgia",2923,922,2013,755,910,427
1500000US130670311081,130670311081,"Block Group 1, Census Tract 311.08, Cobb County, Georgia",591,396,591,396,0,13
1500000US130670311082,130670311082,"Block Group 2, Census Tract 311.08, Cobb County, Georgia",539,201,493,190,46,44
1500000US130670311083,130670311083,"Block Group 3, Census Tract 311.08, Cobb County, Georgia",2725,634,2403,604,322,238
1500000US130670311084,130670311084,"Block Group 4, Census Tract 311.08, Cobb County, Georgia",1452,434,1235,404,217,223
1500000US130670311101,130670311101,"Block Group 1, Census Tract 311.10, Cobb County, Georgia",2521,398,1742,378,779,323
1500000US130670311102,130670311102,"Block Group 2, Census Tract 311.10, Cobb County, Georgia",1017,197,921,194,96,74
1500000US130670311111,130670311111,"Block Group 1, Census Tract 311.11, Cobb County, Georgia",1976,268,1911,275,65,50
1500000US130670311112,130670311112,"Block Group 2, Census Tract 311.11, Cobb County, Georgia",1462,330,1333,281,129,155
1500000US130670311121,130670311121,"Block Group 1, Census Tract 311.12, Cobb County, Georgia",711,215,679,208,32,53
1500000US130670311122,130670311122,"Block Group 2, Census Tract 311.12, Cobb County, Georgia",1952,432,1673,379,279,296
1500000US130670311123,130670311123,"Block Group 3, Census Tract 311.12, Cobb County, Georgia",2662,440,2581,455,81,72
1500000US130670311131,130670311131,"Block Group 1, Census Tract 311.13, Cobb County, Georgia",942,164,741,151,201,102
1500000US130670311141,130670311141,"Block Group 1, Census Tract 311.14, Cobb County, Georgia",3471,799,2357,543,1114,615
1500000US130670311142,130670311142,"Block Group 2, Census Tract 311.14, Cobb County, Georgia",1893,427,1796,421,97,84
1500000US130670311143,130670311143,"Block Group 3, Census Tract 311.14, Cobb County, Georgia",1560,341,1250,334,310,218
1500000US130670311144,130670311144,"Block Group 4, Census Tract 311.14, Cobb County, Georgia",529,321,133,122,396,282
1500000US130670311151,130670311151,"Block Group 1, Census Tract 311.15, Cobb County, Georgia",2238,534,1303,411,935,514
1500000US130670311152,130670311152,"Block Group 2, Census Tract 311.15, Cobb County, Georgia",2721,505,2155,450,566,264
1500000US130670311161,130670311161,"Block Group 1, Census Tract 311.16, Cobb County, Georgia",2319,757,1590,532,729,583
1500000US130670311162,130670311162,"Block Group 2, Census Tract 311.16, Cobb County, Georgia",1681,498,756,323,925,454
1500000US130670311163,130670311163,"Block Group 3, Census Tract 311.16, Cobb County, Georgia",169,149,79,130,90,154
1500000US130670311171,130670311171,"Block Group 1, Census Tract 311.17, Cobb County, Georgia",2685,490,2068,361,617,339
1500000US130670311172,130670311172,"Block Group 2, Census Tract 311.17, Cobb County, Georgia",1768,260,1756,265,12,23
1500000US130670311173,130670311173,"Block Group 3, Census Tract 311.17, Cobb County, Georgia",844,237,766,203,78,92
1500000US130670311181,130670311181,"Block Group 1, Census Tract 311.18, Cobb County, Georgia",1471,603,1429,592,42,72
1500000US130670311182,130670311182,"Block Group 2, Census Tract 311.18, Cobb County, Georgia",2204,524,2076,530,128,164
1500000US130670311183,130670311183,"Block Group 3, Census Tract 311.18, Cobb County, Georgia",2040,374,1905,365,135,191
1500000US130670312051,130670312051,"Block Group 1, Census Tract 312.05, Cobb County, Georgia",1450,467,1350,446,100,114
1500000US130670312052,130670312052,"Block Group 2, Census Tract 312.05, Cobb County, Georgia",2256,581,1955,414,301,396
1500000US130670312053,130670312053,"Block Group 3, Census Tract 312.05, Cobb County, Georgia",2103,600,1619,502,484,396
1500000US130670312061,130670312061,"Block Group 1, Census Tract 312.06, Cobb County, Georgia",5457,821,5120,849,337,167
1500000US130670312062,130670312062,"Block Group 2, Census Tract 312.06, Cobb County, Georgia",602,499,581,515,21,37
1500000US130670312063,130670312063,"Block Group 3, Census Tract 312.06, Cobb County, Georgia",3971,811,3913,828,58,98
1500000US130670312071,130670312071,"Block Group 1, Census Tract 312.07, Cobb County, Georgia",1033,383,1033,383,0,13
1500000US130670312072,130670312072,"Block Group 2, Census Tract 312.07, Cobb County, Georgia",2058,492,2009,484,49,56
1500000US130670312073,130670312073,"Block Group 3, Census Tract 312.07, Cobb County, Georgia",877,299,851,313,26,59
1500000US130670312081,130670312081,"Block Group 1, Census Tract 312.08, Cobb County, Georgia",556,158,513,174,43,60
1500000US130670312082,130670312082,"Block Group 2, Census Tract 312.08, Cobb County, Georgia",1953,415,1953,415,0,13
1500000US130670312083,130670312083,"Block Group 3, Census Tract 312.08, Cobb County, Georgia",3833,548,3416,564,417,396
1500000US130670312091,130670312091,"Block Group 1, Census Tract 312.09, Cobb County, Georgia",2794,275,2602,274,192,119
1500000US130670312092,130670312092,"Block Group 2, Census Tract 312.09, Cobb County, Georgia",1378,267,1252,275,126,114
1500000US130670312111,130670312111,"Block Group 1, Census Tract 312.11, Cobb County, Georgia",360,204,360,204,0,13
1500000US130670312112,130670312112,"Block Group 2, Census Tract 312.11, Cobb County, Georgia",3087,587,2810,548,277,237
1500000US130670312113,130670312113,"Block Group 3, Census Tract 312.11, Cobb County, Georgia",525,318,393,193,132,209
1500000US130670312121,130670312121,"Block Group 1, Census Tract 312.12, Cobb County, Georgia",2476,296,2408,310,68,52
1500000US130670313061,130670313061,"Block Group 1, Census Tract 313.06, Cobb County, Georgia",2480,459,2266,456,214,205
1500000US130670313062,130670313062,"Block Group 2, Census Tract 313.06, Cobb County, Georgia",1504,413,1366,364,138,214
1500000US130670313071,130670313071,"Block Group 1, Census Tract 313.07, Cobb County, Georgia",925,305,925,305,0,13
1500000US130670313072,130670313072,"Block Group 2, Census Tract 313.07, Cobb County, Georgia",2368,438,1939,461,429,130
1500000US130670313073,130670313073,"Block Group 3, Census Tract 313.07, Cobb County, Georgia",2311,561,2311,561,0,13
1500000US130670313081,130670313081,"Block Group 1, Census Tract 313.08, Cobb County, Georgia",924,272,634,186,290,264
1500000US130670313082,130670313082,"Block Group 2, Census Tract 313.08, Cobb County, Georgia",2190,615,1333,470,857,481
1500000US130670313083,130670313083,"Block Group 3, Census Tract 313.08, Cobb County, Georgia",2403,493,1772,344,631,329
1500000US130670313091,130670313091,"Block Group 1, Census Tract 313.09, Cobb County, Georgia",1516,603,722,365,794,479
1500000US130670313092,130670313092,"Block Group 2, Census Tract 313.09, Cobb County, Georgia",1869,598,1777,566,92,147
1500000US130670313093,130670313093,"Block Group 3, Census Tract 313.09, Cobb County, Georgia",2941,678,1933,697,1008,569
1500000US130670313094,130670313094,"Block Group 4, Census Tract 313.09, Cobb County, Georgia",2030,480,1991,488,39,63
1500000US130670313101,130670313101,"Block Group 1, Census Tract 313.10, Cobb County, Georgia",1698,372,1603,381,95,137
1500000US130670313102,130670313102,"Block Group 2, Census Tract 313.10, Cobb County, Georgia",3504,589,1751,588,1753,669
1500000US130670313103,130670313103,"Block Group 3, Census Tract 313.10, Cobb County, Georgia",2440,608,1862,493,578,397
1500000US130670313111,130670313111,"Block Group 1, Census Tract 313.11, Cobb County, Georgia",3783,629,2869,498,914,445
1500000US130670313112,130670313112,"Block Group 2, Census Tract 313.11, Cobb County, Georgia",2733,640,2645,628,88,104
1500000US130670313113,130670313113,"Block Group 3, Census Tract 313.11, Cobb County, Georgia",2887,515,2419,504,468,314
1500000US130670313121,130670313121,"Block Group 1, Census Tract 313.12, Cobb County, Georgia",1343,670,1135,580,208,301
1500000US130670313122,130670313122,"Block Group 2, Census Tract 313.12, Cobb County, Georgia",563,256,558,254,5,12
1500000US130670313123,130670313123,"Block Group 3, Census Tract 313.12, Cobb County, Georgia",4775,796,4102,737,673,534
1500000US130670313124,130670313124,"Block Group 4, Census Tract 313.12, Cobb County, Georgia",2872,628,2165,565,707,304
1500000US130670313131,130670313131,"Block Group 1, Census Tract 313.13, Cobb County, Georgia",7154,796,6239,798,915,545
1500000US130670313132,130670313132,"Block Group 2, Census Tract 313.13, Cobb County, Georgia",3176,613,2920,594,256,237
1500000US130670314041,130670314041,"Block Group 1, Census Tract 314.04, Cobb County, Georgia",1019,415,893,289,126,205
1500000US130670314042,130670314042,"Block Group 2, Census Tract 314.04, Cobb County, Georgia",2996,554,2670,429,326,300
1500000US130670314043,130670314043,"Block Group 3, Census Tract 314.04, Cobb County, Georgia",1284,422,1117,405,167,207
1500000US130670314044,130670314044,"Block Group 4, Census Tract 314.04, Cobb County, Georgia",458,235,458,235,0,13
1500000US130670314051,130670314051,"Block Group 1, Census Tract 314.05, Cobb County, Georgia",1690,666,1232,431,458,473
1500000US130670314052,130670314052,"Block Group 2, Census Tract 314.05, Cobb County, Georgia",2892,592,2760,627,132,167
1500000US130670314053,130670314053,"Block Group 3, Census Tract 314.05, Cobb County, Georgia",1181,508,496,319,685,419
1500000US130670314054,130670314054,"Block Group 4, Census Tract 314.05, Cobb County, Georgia",1517,467,1149,377,368,370
1500000US130670314055,130670314055,"Block Group 5, Census Tract 314.05, Cobb County, Georgia",1123,448,1038,444,85,105
1500000US130670314061,130670314061,"Block Group 1, Census Tract 314.06, Cobb County, Georgia",1025,395,900,363,125,158
1500000US130670314062,130670314062,"Block Group 2, Census Tract 314.06, Cobb County, Georgia",3000,675,2487,597,513,379
1500000US130670314063,130670314063,"Block Group 3, Census Tract 314.06, Cobb County, Georgia",3561,744,3248,677,313,337
1500000US130670314081,130670314081,"Block Group 1, Census Tract 314.08, Cobb County, Georgia",838,498,664,483,174,192
1500000US130670314082,130670314082,"Block Group 2, Census Tract 314.08, Cobb County, Georgia",3646,564,3514,591,132,160
1500000US130670314083,130670314083,"Block Group 3, Census Tract 314.08, Cobb County, Georgia",1156,310,1156,310,0,13
1500000US130670314091,130670314091,"Block Group 1, Census Tract 314.09, Cobb County, Georgia",2805,425,2269,334,536,276
1500000US130670314092,130670314092,"Block Group 2, Census Tract 314.09, Cobb County, Georgia",2175,422,1947,398,228,158
1500000US130670315031,130670315031,"Block Group 1, Census Tract 315.03, Cobb County, Georgia",1408,511,1364,498,44,84
1500000US130670315032,130670315032,"Block Group 2, Census Tract 315.03, Cobb County, Georgia",3054,778,2739,732,315,458
1500000US130670315033,130670315033,"Block Group 3, Census Tract 315.03, Cobb County, Georgia",3451,996,2545,674,906,653
1500000US130670315034,130670315034,"Block Group 4, Census Tract 315.03, Cobb County, Georgia",2159,810,1937,741,222,301
1500000US130670315051,130670315051,"Block Group 1, Census Tract 315.05, Cobb County, Georgia",2454,534,2220,512,234,307
1500000US130670315052,130670315052,"Block Group 2, Census Tract 315.05, Cobb County, Georgia",1652,410,1447,404,205,84
1500000US130670315053,130670315053,"Block Group 3, Census Tract 315.05, Cobb County, Georgia",1853,465,1820,461,33,38
1500000US130670315061,130670315061,"Block Group 1, Census Tract 315.06, Cobb County, Georgia",2092,452,1855,453,237,214
1500000US130670315062,130670315062,"Block Group 2, Census Tract 315.06, Cobb County, Georgia",1885,379,1363,254,522,312
1500000US130670315063,130670315063,"Block Group 3, Census Tract 315.06, Cobb County, Georgia",627,178,559,174,68,74
1500000US130670315071,130670315071,"Block Group 1, Census Tract 315.07, Cobb County, Georgia",2256,543,1911,508,345,222
1500000US130670315072,130670315072,"Block Group 2, Census Tract 315.07, Cobb County, Georgia",1474,502,1459,504,15,24
1500000US130670315081,130670315081,"Block Group 1, Census Tract 315.08, Cobb County, Georgia",1651,422,1559,401,92,94
1500000US130670315082,130670315082,"Block Group 2, Census Tract 315.08, Cobb County, Georgia",3422,730,2782,376,640,659
1500000US130670315091,130670315091,"Block Group 1, Census Tract 315.09, Cobb County, Georgia",2363,630,2247,625,116,139
1500000US130670315092,130670315092,"Block Group 2, Census Tract 315.09, Cobb County, Georgia",1958,618,1495,529,463,302
1500000US130670315093,130670315093,"Block Group 3, Census Tract 315.09, Cobb County, Georgia",1703,478,1637,486,66,104
1500000US130670315094,130670315094,"Block Group 4, Census Tract 315.09, Cobb County, Georgia",2097,616,1956,616,141,222
1500000US130670315095,130670315095,"Block Group 5, Census Tract 315.09, Cobb County, Georgia",2018,495,1984,485,34,47
1500000US130690101001,130690101001,"Block Group 1, Census Tract 101, Coffee County, Georgia",811,243,801,241,10,16
1500000US130690101002,130690101002,"Block Group 2, Census Tract 101, Coffee County, Georgia",708,185,608,162,100,106
1500000US130690101003,130690101003,"Block Group 3, Census Tract 101, Coffee County, Georgia",1917,312,1687,298,230,162
1500000US130690102001,130690102001,"Block Group 1, Census Tract 102, Coffee County, Georgia",1884,468,1589,334,295,326
1500000US130690102002,130690102002,"Block Group 2, Census Tract 102, Coffee County, Georgia",1033,288,855,206,178,205
1500000US130690103001,130690103001,"Block Group 1, Census Tract 103, Coffee County, Georgia",1624,373,1367,319,257,334
1500000US130690103002,130690103002,"Block Group 2, Census Tract 103, Coffee County, Georgia",4501,1412,4167,1148,334,286
1500000US130690104001,130690104001,"Block Group 1, Census Tract 104, Coffee County, Georgia",2172,577,2070,568,102,115
1500000US130690104002,130690104002,"Block Group 2, Census Tract 104, Coffee County, Georgia",386,247,386,247,0,13
1500000US130690104003,130690104003,"Block Group 3, Census Tract 104, Coffee County, Georgia",706,253,679,255,27,42
1500000US130690104004,130690104004,"Block Group 4, Census Tract 104, Coffee County, Georgia",1134,386,1134,386,0,13
1500000US130690105001,130690105001,"Block Group 1, Census Tract 105, Coffee County, Georgia",731,344,523,163,208,301
1500000US130690105002,130690105002,"Block Group 2, Census Tract 105, Coffee County, Georgia",691,251,605,220,86,126
1500000US130690105003,130690105003,"Block Group 3, Census Tract 105, Coffee County, Georgia",2063,529,1871,521,192,192
1500000US130690106001,130690106001,"Block Group 1, Census Tract 106, Coffee County, Georgia",2806,591,2708,576,98,107
1500000US130690106002,130690106002,"Block Group 2, Census Tract 106, Coffee County, Georgia",1371,577,1208,540,163,124
1500000US130690106003,130690106003,"Block Group 3, Census Tract 106, Coffee County, Georgia",1474,397,1469,399,5,14
1500000US130690107001,130690107001,"Block Group 1, Census Tract 107, Coffee County, Georgia",1431,472,1267,398,164,216
1500000US130690107002,130690107002,"Block Group 2, Census Tract 107, Coffee County, Georgia",1456,406,1312,387,144,119
1500000US130690107003,130690107003,"Block Group 3, Census Tract 107, Coffee County, Georgia",756,282,717,291,39,72
1500000US130690107004,130690107004,"Block Group 4, Census Tract 107, Coffee County, Georgia",3138,535,1870,360,1268,542
1500000US130690108011,130690108011,"Block Group 1, Census Tract 108.01, Coffee County, Georgia",2158,359,2019,347,139,208
1500000US130690108012,130690108012,"Block Group 2, Census Tract 108.01, Coffee County, Georgia",2695,631,2385,478,310,382
1500000US130690108013,130690108013,"Block Group 3, Census Tract 108.01, Coffee County, Georgia",827,327,827,327,0,13
1500000US130690108021,130690108021,"Block Group 1, Census Tract 108.02, Coffee County, Georgia",1004,338,970,330,34,55
1500000US130690108022,130690108022,"Block Group 2, Census Tract 108.02, Coffee County, Georgia",1992,378,1751,283,241,322
1500000US130690108023,130690108023,"Block Group 3, Census Tract 108.02, Coffee County, Georgia",1534,456,1486,457,48,49
1500000US130719701001,130719701001,"Block Group 1, Census Tract 9701, Colquitt County, Georgia",2414,517,1865,311,549,435
1500000US130719701002,130719701002,"Block Group 2, Census Tract 9701, Colquitt County, Georgia",2955,493,2509,364,446,305
1500000US130719702001,130719702001,"Block Group 1, Census Tract 9702, Colquitt County, Georgia",1554,345,1480,342,74,114
1500000US130719702002,130719702002,"Block Group 2, Census Tract 9702, Colquitt County, Georgia",1366,280,1355,280,11,17
1500000US130719703001,130719703001,"Block Group 1, Census Tract 9703, Colquitt County, Georgia",1294,409,1237,402,57,104
1500000US130719703002,130719703002,"Block Group 2, Census Tract 9703, Colquitt County, Georgia",1406,540,990,409,416,410
1500000US130719703003,130719703003,"Block Group 3, Census Tract 9703, Colquitt County, Georgia",819,360,819,360,0,13
1500000US130719703004,130719703004,"Block Group 4, Census Tract 9703, Colquitt County, Georgia",521,342,521,342,0,13
1500000US130719703005,130719703005,"Block Group 5, Census Tract 9703, Colquitt County, Georgia",1095,422,1095,422,0,13
1500000US130719704001,130719704001,"Block Group 1, Census Tract 9704, Colquitt County, Georgia",1313,359,1138,321,175,204
1500000US130719704002,130719704002,"Block Group 2, Census Tract 9704, Colquitt County, Georgia",1059,308,932,257,127,125
1500000US130719704003,130719704003,"Block Group 3, Census Tract 9704, Colquitt County, Georgia",1111,310,741,150,370,269
1500000US130719705001,130719705001,"Block Group 1, Census Tract 9705, Colquitt County, Georgia",1716,353,1382,336,334,234
1500000US130719705002,130719705002,"Block Group 2, Census Tract 9705, Colquitt County, Georgia",1651,345,1498,302,153,140
1500000US130719706001,130719706001,"Block Group 1, Census Tract 9706, Colquitt County, Georgia",2253,605,1524,494,729,526
1500000US130719706002,130719706002,"Block Group 2, Census Tract 9706, Colquitt County, Georgia",2082,539,1161,410,921,373
1500000US130719706003,130719706003,"Block Group 3, Census Tract 9706, Colquitt County, Georgia",2252,337,2119,352,133,178
1500000US130719707011,130719707011,"Block Group 1, Census Tract 9707.01, Colquitt County, Georgia",1386,370,1349,363,37,49
1500000US130719707012,130719707012,"Block Group 2, Census Tract 9707.01, Colquitt County, Georgia",1338,511,1338,511,0,13
1500000US130719707013,130719707013,"Block Group 3, Census Tract 9707.01, Colquitt County, Georgia",3103,696,2473,484,630,605
1500000US130719707014,130719707014,"Block Group 4, Census Tract 9707.01, Colquitt County, Georgia",1121,388,840,286,281,239
1500000US130719707021,130719707021,"Block Group 1, Census Tract 9707.02, Colquitt County, Georgia",2287,366,1562,253,725,335
1500000US130719708001,130719708001,"Block Group 1, Census Tract 9708, Colquitt County, Georgia",1650,398,1115,375,535,365
1500000US130719708002,130719708002,"Block Group 2, Census Tract 9708, Colquitt County, Georgia",763,234,594,241,169,159
1500000US130719708003,130719708003,"Block Group 3, Census Tract 9708, Colquitt County, Georgia",475,313,308,196,167,231
1500000US130719708004,130719708004,"Block Group 4, Census Tract 9708, Colquitt County, Georgia",368,119,343,116,25,39
1500000US130719709001,130719709001,"Block Group 1, Census Tract 9709, Colquitt County, Georgia",1962,654,1655,568,307,338
1500000US130719709002,130719709002,"Block Group 2, Census Tract 9709, Colquitt County, Georgia",1177,472,1177,472,0,13
1500000US130719709003,130719709003,"Block Group 3, Census Tract 9709, Colquitt County, Georgia",2146,535,1306,456,840,513
1500000US130719709004,130719709004,"Block Group 4, Census Tract 9709, Colquitt County, Georgia",1387,379,1282,426,105,165
1500000US130730301021,130730301021,"Block Group 1, Census Tract 301.02, Columbia County, Georgia",965,340,965,340,0,13
1500000US130730301022,130730301022,"Block Group 2, Census Tract 301.02, Columbia County, Georgia",2139,368,2089,373,50,74
1500000US130730301023,130730301023,"Block Group 3, Census Tract 301.02, Columbia County, Georgia",2195,394,2086,349,109,105
1500000US130730301024,130730301024,"Block Group 4, Census Tract 301.02, Columbia County, Georgia",2591,511,2576,522,15,26
1500000US130730301025,130730301025,"Block Group 5, Census Tract 301.02, Columbia County, Georgia",2036,464,1914,460,122,192
1500000US130730301031,130730301031,"Block Group 1, Census Tract 301.03, Columbia County, Georgia",3362,318,3218,323,144,138
1500000US130730301051,130730301051,"Block Group 1, Census Tract 301.05, Columbia County, Georgia",1554,502,1536,502,18,30
1500000US130730301052,130730301052,"Block Group 2, Census Tract 301.05, Columbia County, Georgia",3243,569,3076,598,167,205
1500000US130730301053,130730301053,"Block Group 3, Census Tract 301.05, Columbia County, Georgia",727,250,727,250,0,13
1500000US130730301061,130730301061,"Block Group 1, Census Tract 301.06, Columbia County, Georgia",2573,485,2466,488,107,95
1500000US130730301062,130730301062,"Block Group 2, Census Tract 301.06, Columbia County, Georgia",1270,333,1251,330,19,30
1500000US130730302011,130730302011,"Block Group 1, Census Tract 302.01, Columbia County, Georgia",2229,619,2174,621,55,68
1500000US130730302012,130730302012,"Block Group 2, Census Tract 302.01, Columbia County, Georgia",3312,749,3293,751,19,31
1500000US130730302013,130730302013,"Block Group 3, Census Tract 302.01, Columbia County, Georgia",820,180,739,146,81,86
1500000US130730302021,130730302021,"Block Group 1, Census Tract 302.02, Columbia County, Georgia",3261,363,2966,335,295,209
1500000US130730302031,130730302031,"Block Group 1, Census Tract 302.03, Columbia County, Georgia",1456,357,1456,357,0,13
1500000US130730302032,130730302032,"Block Group 2, Census Tract 302.03, Columbia County, Georgia",1417,425,1329,411,88,146
1500000US130730302033,130730302033,"Block Group 3, Census Tract 302.03, Columbia County, Georgia",792,296,792,296,0,13
1500000US130730302034,130730302034,"Block Group 4, Census Tract 302.03, Columbia County, Georgia",2665,426,2665,426,0,13
1500000US130730303021,130730303021,"Block Group 1, Census Tract 303.02, Columbia County, Georgia",1299,305,1281,302,18,30
1500000US130730303022,130730303022,"Block Group 2, Census Tract 303.02, Columbia County, Georgia",3518,614,3342,615,176,162
1500000US130730303023,130730303023,"Block Group 3, Census Tract 303.02, Columbia County, Georgia",941,244,941,244,0,13
1500000US130730303024,130730303024,"Block Group 4, Census Tract 303.02, Columbia County, Georgia",1758,328,1719,327,39,50
1500000US130730303025,130730303025,"Block Group 5, Census Tract 303.02, Columbia County, Georgia",3012,615,2610,527,402,348
1500000US130730303041,130730303041,"Block Group 1, Census Tract 303.04, Columbia County, Georgia",1724,406,1707,409,17,29
1500000US130730303042,130730303042,"Block Group 2, Census Tract 303.04, Columbia County, Georgia",5469,623,5252,577,217,208
1500000US130730303061,130730303061,"Block Group 1, Census Tract 303.06, Columbia County, Georgia",3610,447,3467,427,143,120
1500000US130730303062,130730303062,"Block Group 2, Census Tract 303.06, Columbia County, Georgia",1977,716,1653,627,324,386
1500000US130730303071,130730303071,"Block Group 1, Census Tract 303.07, Columbia County, Georgia",1432,299,1369,288,63,76
1500000US130730303072,130730303072,"Block Group 2, Census Tract 303.07, Columbia County, Georgia",1556,393,1543,396,13,22
1500000US130730303073,130730303073,"Block Group 3, Census Tract 303.07, Columbia County, Georgia",2619,709,2619,709,0,13
1500000US130730303074,130730303074,"Block Group 4, Census Tract 303.07, Columbia County, Georgia",1366,326,1163,283,203,255
1500000US130730303081,130730303081,"Block Group 1, Census Tract 303.08, Columbia County, Georgia",3320,542,3292,546,28,36
1500000US130730303082,130730303082,"Block Group 2, Census Tract 303.08, Columbia County, Georgia",6402,666,5623,705,779,414
1500000US130730303091,130730303091,"Block Group 1, Census Tract 303.09, Columbia County, Georgia",4409,622,4336,622,73,107
1500000US130730303092,130730303092,"Block Group 2, Census Tract 303.09, Columbia County, Georgia",1740,594,1740,594,0,13
1500000US130730303093,130730303093,"Block Group 3, Census Tract 303.09, Columbia County, Georgia",2071,676,2029,669,42,70
1500000US130730303094,130730303094,"Block Group 4, Census Tract 303.09, Columbia County, Georgia",2780,528,2764,528,16,27
1500000US130730304011,130730304011,"Block Group 1, Census Tract 304.01, Columbia County, Georgia",1267,220,1224,209,43,68
1500000US130730304012,130730304012,"Block Group 2, Census Tract 304.01, Columbia County, Georgia",1028,305,1028,305,0,13
1500000US130730304021,130730304021,"Block Group 1, Census Tract 304.02, Columbia County, Georgia",2013,622,1732,439,281,420
1500000US130730304022,130730304022,"Block Group 2, Census Tract 304.02, Columbia County, Georgia",5668,854,4938,741,730,307
1500000US130730304023,130730304023,"Block Group 3, Census Tract 304.02, Columbia County, Georgia",2060,434,2006,440,54,67
1500000US130730305031,130730305031,"Block Group 1, Census Tract 305.03, Columbia County, Georgia",2541,677,2307,633,234,180
1500000US130730305032,130730305032,"Block Group 2, Census Tract 305.03, Columbia County, Georgia",2419,581,2340,583,79,102
1500000US130730305033,130730305033,"Block Group 3, Census Tract 305.03, Columbia County, Georgia",2805,629,2760,625,45,55
1500000US130730305041,130730305041,"Block Group 1, Census Tract 305.04, Columbia County, Georgia",2151,290,1934,257,217,169
1500000US130730305042,130730305042,"Block Group 2, Census Tract 305.04, Columbia County, Georgia",1184,279,1184,279,0,13
1500000US130730305051,130730305051,"Block Group 1, Census Tract 305.05, Columbia County, Georgia",6922,881,5540,754,1382,708
1500000US130730305061,130730305061,"Block Group 1, Census Tract 305.06, Columbia County, Georgia",4869,1066,4490,1073,379,290
1500000US130730305062,130730305062,"Block Group 2, Census Tract 305.06, Columbia County, Georgia",975,476,792,419,183,273
1500000US130730305063,130730305063,"Block Group 3, Census Tract 305.06, Columbia County, Georgia",2516,675,2015,588,501,347
1500000US130730305064,130730305064,"Block Group 4, Census Tract 305.06, Columbia County, Georgia",3166,1006,3041,988,125,181
1500000US130730306031,130730306031,"Block Group 1, Census Tract 306.03, Columbia County, Georgia",2791,504,2755,500,36,33
1500000US130730306032,130730306032,"Block Group 2, Census Tract 306.03, Columbia County, Georgia",2219,476,2219,476,0,13
1500000US130759601001,130759601001,"Block Group 1, Census Tract 9601, Cook County, Georgia",1359,188,1282,178,77,76
1500000US130759601002,130759601002,"Block Group 2, Census Tract 9601, Cook County, Georgia",776,161,714,161,62,59
1500000US130759602001,130759602001,"Block Group 1, Census Tract 9602, Cook County, Georgia",538,151,517,149,21,31
1500000US130759602002,130759602002,"Block Group 2, Census Tract 9602, Cook County, Georgia",1137,266,1130,266,7,14
1500000US130759602003,130759602003,"Block Group 3, Census Tract 9602, Cook County, Georgia",895,201,883,200,12,23
1500000US130759602004,130759602004,"Block Group 4, Census Tract 9602, Cook County, Georgia",730,250,523,180,207,196
1500000US130759602005,130759602005,"Block Group 5, Census Tract 9602, Cook County, Georgia",601,218,601,218,0,13
1500000US130759603001,130759603001,"Block Group 1, Census Tract 9603, Cook County, Georgia",1633,377,1589,367,44,57
1500000US130759603002,130759603002,"Block Group 2, Census Tract 9603, Cook County, Georgia",1317,297,1210,265,107,129
1500000US130759603003,130759603003,"Block Group 3, Census Tract 9603, Cook County, Georgia",1435,295,1263,245,172,183
1500000US130759603004,130759603004,"Block Group 4, Census Tract 9603, Cook County, Georgia",764,255,750,255,14,26
1500000US130759603005,130759603005,"Block Group 5, Census Tract 9603, Cook County, Georgia",885,248,832,251,53,63
1500000US130759604001,130759604001,"Block Group 1, Census Tract 9604, Cook County, Georgia",2415,400,2366,400,49,44
1500000US130759604002,130759604002,"Block Group 2, Census Tract 9604, Cook County, Georgia",1748,243,1654,239,94,81
1500000US130759604003,130759604003,"Block Group 3, Census Tract 9604, Cook County, Georgia",800,243,719,216,81,101
1500000US130771701001,130771701001,"Block Group 1, Census Tract 1701, Coweta County, Georgia",2156,555,2127,553,29,46
1500000US130771701002,130771701002,"Block Group 2, Census Tract 1701, Coweta County, Georgia",3769,686,3596,664,173,145
1500000US130771701003,130771701003,"Block Group 3, Census Tract 1701, Coweta County, Georgia",1695,509,1646,499,49,81
1500000US130771702001,130771702001,"Block Group 1, Census Tract 1702, Coweta County, Georgia",3404,641,3345,616,59,77
1500000US130771702002,130771702002,"Block Group 2, Census Tract 1702, Coweta County, Georgia",1389,580,1389,580,0,13
1500000US130771702003,130771702003,"Block Group 3, Census Tract 1702, Coweta County, Georgia",685,217,685,217,0,13
1500000US130771702004,130771702004,"Block Group 4, Census Tract 1702, Coweta County, Georgia",1483,452,1290,383,193,240
1500000US130771703031,130771703031,"Block Group 1, Census Tract 1703.03, Coweta County, Georgia",5214,322,5082,311,132,109
1500000US130771703041,130771703041,"Block Group 1, Census Tract 1703.04, Coweta County, Georgia",1248,401,1248,401,0,13
1500000US130771703042,130771703042,"Block Group 2, Census Tract 1703.04, Coweta County, Georgia",3378,525,3119,573,259,281
1500000US130771703043,130771703043,"Block Group 3, Census Tract 1703.04, Coweta County, Georgia",2118,481,2118,481,0,13
1500000US130771703051,130771703051,"Block Group 1, Census Tract 1703.05, Coweta County, Georgia",2920,807,2202,601,718,475
1500000US130771703052,130771703052,"Block Group 2, Census Tract 1703.05, Coweta County, Georgia",5780,803,4357,740,1423,717
1500000US130771703053,130771703053,"Block Group 3, Census Tract 1703.05, Coweta County, Georgia",1883,843,1883,843,0,13
1500000US130771703061,130771703061,"Block Group 1, Census Tract 1703.06, Coweta County, Georgia",578,216,578,216,0,13
1500000US130771703062,130771703062,"Block Group 2, Census Tract 1703.06, Coweta County, Georgia",3631,616,3525,587,106,126
1500000US130771703063,130771703063,"Block Group 3, Census Tract 1703.06, Coweta County, Georgia",3968,671,3368,664,600,239
1500000US130771704021,130771704021,"Block Group 1, Census Tract 1704.02, Coweta County, Georgia",1623,525,941,489,682,416
1500000US130771704022,130771704022,"Block Group 2, Census Tract 1704.02, Coweta County, Georgia",4600,613,4447,629,153,196
1500000US130771704023,130771704023,"Block Group 3, Census Tract 1704.02, Coweta County, Georgia",3554,612,3402,597,152,144
1500000US130771704031,130771704031,"Block Group 1, Census Tract 1704.03, Coweta County, Georgia",1065,248,1065,248,0,13
1500000US130771704032,130771704032,"Block Group 2, Census Tract 1704.03, Coweta County, Georgia",3407,376,3222,411,185,132
1500000US130771704041,130771704041,"Block Group 1, Census Tract 1704.04, Coweta County, Georgia",2130,458,2075,463,55,98
1500000US130771704042,130771704042,"Block Group 2, Census Tract 1704.04, Coweta County, Georgia",2216,481,2216,481,0,13
1500000US130771704043,130771704043,"Block Group 3, Census Tract 1704.04, Coweta County, Georgia",1485,353,1360,361,125,115
1500000US130771704051,130771704051,"Block Group 1, Census Tract 1704.05, Coweta County, Georgia",2765,502,2423,507,342,247
1500000US130771704052,130771704052,"Block Group 2, Census Tract 1704.05, Coweta County, Georgia",2384,502,2213,457,171,187
1500000US130771704053,130771704053,"Block Group 3, Census Tract 1704.05, Coweta County, Georgia",2219,493,2037,468,182,299
1500000US130771704061,130771704061,"Block Group 1, Census Tract 1704.06, Coweta County, Georgia",3634,292,3571,296,63,56
1500000US130771705011,130771705011,"Block Group 1, Census Tract 1705.01, Coweta County, Georgia",2426,586,2078,549,348,356
1500000US130771705012,130771705012,"Block Group 2, Census Tract 1705.01, Coweta County, Georgia",2025,456,1771,422,254,169
1500000US130771705013,130771705013,"Block Group 3, Census Tract 1705.01, Coweta County, Georgia",2462,577,2304,570,158,170
1500000US130771705021,130771705021,"Block Group 1, Census Tract 1705.02, Coweta County, Georgia",2313,550,2275,539,38,58
1500000US130771705022,130771705022,"Block Group 2, Census Tract 1705.02, Coweta County, Georgia",2286,389,2190,368,96,111
1500000US130771705023,130771705023,"Block Group 3, Census Tract 1705.02, Coweta County, Georgia",1407,340,1401,340,6,11
1500000US130771705031,130771705031,"Block Group 1, Census Tract 1705.03, Coweta County, Georgia",1994,329,1584,302,410,277
1500000US130771705032,130771705032,"Block Group 2, Census Tract 1705.03, Coweta County, Georgia",2212,347,2171,360,41,49
1500000US130771705033,130771705033,"Block Group 3, Census Tract 1705.03, Coweta County, Georgia",1609,383,1539,372,70,56
1500000US130771706011,130771706011,"Block Group 1, Census Tract 1706.01, Coweta County, Georgia",2644,845,2329,733,315,445
1500000US130771706012,130771706012,"Block Group 2, Census Tract 1706.01, Coweta County, Georgia",1453,431,1453,431,0,13
1500000US130771706013,130771706013,"Block Group 3, Census Tract 1706.01, Coweta County, Georgia",1981,662,1856,642,125,169
1500000US130771706014,130771706014,"Block Group 4, Census Tract 1706.01, Coweta County, Georgia",1420,423,1224,389,196,185
1500000US130771706021,130771706021,"Block Group 1, Census Tract 1706.02, Coweta County, Georgia",2349,515,2275,519,74,67
1500000US130771706022,130771706022,"Block Group 2, Census Tract 1706.02, Coweta County, Georgia",2006,606,1994,603,12,24
1500000US130771706023,130771706023,"Block Group 3, Census Tract 1706.02, Coweta County, Georgia",2936,538,2836,537,100,105
1500000US130771706024,130771706024,"Block Group 4, Census Tract 1706.02, Coweta County, Georgia",1442,397,1323,436,119,136
1500000US130771706031,130771706031,"Block Group 1, Census Tract 1706.03, Coweta County, Georgia",1235,418,1224,420,11,18
1500000US130771706032,130771706032,"Block Group 2, Census Tract 1706.03, Coweta County, Georgia",3889,473,3625,491,264,258
1500000US130771707001,130771707001,"Block Group 1, Census Tract 1707, Coweta County, Georgia",1315,361,1255,358,60,63
1500000US130771707002,130771707002,"Block Group 2, Census Tract 1707, Coweta County, Georgia",2078,451,2034,455,44,47
1500000US130771707003,130771707003,"Block Group 3, Census Tract 1707, Coweta County, Georgia",2032,465,2032,465,0,13
1500000US130771707004,130771707004,"Block Group 4, Census Tract 1707, Coweta County, Georgia",843,290,843,290,0,13
1500000US130771707005,130771707005,"Block Group 5, Census Tract 1707, Coweta County, Georgia",657,222,657,222,0,13
1500000US130771708011,130771708011,"Block Group 1, Census Tract 1708.01, Coweta County, Georgia",2524,464,2396,448,128,177
1500000US130771708012,130771708012,"Block Group 2, Census Tract 1708.01, Coweta County, Georgia",3074,396,2881,419,193,171
1500000US130771708021,130771708021,"Block Group 1, Census Tract 1708.02, Coweta County, Georgia",1798,367,1795,367,3,6
1500000US130771708022,130771708022,"Block Group 2, Census Tract 1708.02, Coweta County, Georgia",2625,301,2586,308,39,49
1500000US130790701001,130790701001,"Block Group 1, Census Tract 701, Crawford County, Georgia",1582,323,1582,323,0,13
1500000US130790701002,130790701002,"Block Group 2, Census Tract 701, Crawford County, Georgia",1336,375,1333,375,3,6
1500000US130790701003,130790701003,"Block Group 3, Census Tract 701, Crawford County, Georgia",1116,313,1116,313,0,13
1500000US130790702011,130790702011,"Block Group 1, Census Tract 702.01, Crawford County, Georgia",1423,325,1412,325,11,18
1500000US130790702012,130790702012,"Block Group 2, Census Tract 702.01, Crawford County, Georgia",1276,319,1276,319,0,13
1500000US130790702013,130790702013,"Block Group 3, Census Tract 702.01, Crawford County, Georgia",2501,319,2462,311,39,61
1500000US130790702021,130790702021,"Block Group 1, Census Tract 702.02, Crawford County, Georgia",1613,351,1601,352,12,16
1500000US130790702022,130790702022,"Block Group 2, Census Tract 702.02, Crawford County, Georgia",1692,274,1692,274,0,13
1500000US130810101001,130810101001,"Block Group 1, Census Tract 101, Crisp County, Georgia",1765,342,1620,330,145,157
1500000US130810101002,130810101002,"Block Group 2, Census Tract 101, Crisp County, Georgia",1801,404,1801,404,0,13
1500000US130810101003,130810101003,"Block Group 3, Census Tract 101, Crisp County, Georgia",1040,416,1040,416,0,13
1500000US130810102011,130810102011,"Block Group 1, Census Tract 102.01, Crisp County, Georgia",1820,384,1724,391,96,146
1500000US130810102012,130810102012,"Block Group 2, Census Tract 102.01, Crisp County, Georgia",1095,289,1077,293,18,24
1500000US130810102013,130810102013,"Block Group 3, Census Tract 102.01, Crisp County, Georgia",913,365,913,365,0,13
1500000US130810102014,130810102014,"Block Group 4, Census Tract 102.01, Crisp County, Georgia",1126,466,1126,466,0,13
1500000US130810102021,130810102021,"Block Group 1, Census Tract 102.02, Crisp County, Georgia",1238,397,1238,397,0,13
1500000US130810102022,130810102022,"Block Group 2, Census Tract 102.02, Crisp County, Georgia",967,329,967,329,0,13
1500000US130810102023,130810102023,"Block Group 3, Census Tract 102.02, Crisp County, Georgia",596,296,596,296,0,13
1500000US130810103001,130810103001,"Block Group 1, Census Tract 103, Crisp County, Georgia",1049,287,1032,286,17,29
1500000US130810103002,130810103002,"Block Group 2, Census Tract 103, Crisp County, Georgia",2056,367,2056,367,0,13
1500000US130810103003,130810103003,"Block Group 3, Census Tract 103, Crisp County, Georgia",827,544,749,525,78,137
1500000US130810104001,130810104001,"Block Group 1, Census Tract 104, Crisp County, Georgia",1453,480,1453,480,0,13
1500000US130810104002,130810104002,"Block Group 2, Census Tract 104, Crisp County, Georgia",995,352,665,223,330,269
1500000US130810104003,130810104003,"Block Group 3, Census Tract 104, Crisp County, Georgia",712,425,712,425,0,13
1500000US130810104004,130810104004,"Block Group 4, Census Tract 104, Crisp County, Georgia",1726,480,1726,480,0,13
1500000US130810104005,130810104005,"Block Group 5, Census Tract 104, Crisp County, Georgia",592,335,516,322,76,108
1500000US130810105001,130810105001,"Block Group 1, Census Tract 105, Crisp County, Georgia",874,161,874,161,0,13
1500000US130810105002,130810105002,"Block Group 2, Census Tract 105, Crisp County, Georgia",669,179,669,179,0,13
1500000US130830401011,130830401011,"Block Group 1, Census Tract 401.01, Dade County, Georgia",2490,445,2472,447,18,30
1500000US130830401012,130830401012,"Block Group 2, Census Tract 401.01, Dade County, Georgia",2072,386,2003,388,69,62
1500000US130830401021,130830401021,"Block Group 1, Census Tract 401.02, Dade County, Georgia",1046,206,1046,206,0,13
1500000US130830401022,130830401022,"Block Group 2, Census Tract 401.02, Dade County, Georgia",2511,324,2383,325,128,77
1500000US130830402001,130830402001,"Block Group 1, Census Tract 402, Dade County, Georgia",1984,291,1977,292,7,14
1500000US130830402002,130830402002,"Block Group 2, Census Tract 402, Dade County, Georgia",2209,339,2209,339,0,13
1500000US130830403001,130830403001,"Block Group 1, Census Tract 403, Dade County, Georgia",1293,288,1272,287,21,36
1500000US130830403002,130830403002,"Block Group 2, Census Tract 403, Dade County, Georgia",2840,477,2733,464,107,72
1500000US130859701001,130859701001,"Block Group 1, Census Tract 9701, Dawson County, Georgia",2698,558,2613,552,85,108
1500000US130859701002,130859701002,"Block Group 2, Census Tract 9701, Dawson County, Georgia",3428,292,3376,291,52,57
1500000US130859701003,130859701003,"Block Group 3, Census Tract 9701, Dawson County, Georgia",1846,331,1846,331,0,13
1500000US130859702011,130859702011,"Block Group 1, Census Tract 9702.01, Dawson County, Georgia",1571,446,1405,409,166,205
1500000US130859702012,130859702012,"Block Group 2, Census Tract 9702.01, Dawson County, Georgia",2246,672,2156,632,90,118
1500000US130859702013,130859702013,"Block Group 3, Census Tract 9702.01, Dawson County, Georgia",1124,395,872,275,252,315
1500000US130859702014,130859702014,"Block Group 4, Census Tract 9702.01, Dawson County, Georgia",2241,418,2191,406,50,85
1500000US130859702021,130859702021,"Block Group 1, Census Tract 9702.02, Dawson County, Georgia",2750,637,2741,638,9,17
1500000US130859702022,130859702022,"Block Group 2, Census Tract 9702.02, Dawson County, Georgia",1277,512,1265,504,12,22
1500000US130859702023,130859702023,"Block Group 3, Census Tract 9702.02, Dawson County, Georgia",3492,908,3317,866,175,173
1500000US130879701001,130879701001,"Block Group 1, Census Tract 9701, Decatur County, Georgia",588,172,561,170,27,29
1500000US130879701002,130879701002,"Block Group 2, Census Tract 9701, Decatur County, Georgia",1429,307,1312,276,117,83
1500000US130879701003,130879701003,"Block Group 3, Census Tract 9701, Decatur County, Georgia",1398,227,1398,227,0,13
1500000US130879702001,130879702001,"Block Group 1, Census Tract 9702, Decatur County, Georgia",1239,338,1239,338,0,13
1500000US130879702002,130879702002,"Block Group 2, Census Tract 9702, Decatur County, Georgia",1648,407,1363,348,285,184
1500000US130879703001,130879703001,"Block Group 1, Census Tract 9703, Decatur County, Georgia",1777,362,1721,358,56,79
1500000US130879703002,130879703002,"Block Group 2, Census Tract 9703, Decatur County, Georgia",2332,556,2270,549,62,42
1500000US130879703003,130879703003,"Block Group 3, Census Tract 9703, Decatur County, Georgia",1454,439,1454,439,0,13
1500000US130879703004,130879703004,"Block Group 4, Census Tract 9703, Decatur County, Georgia",1207,369,1207,369,0,13
1500000US130879704001,130879704001,"Block Group 1, Census Tract 9704, Decatur County, Georgia",1203,314,1203,314,0,13
1500000US130879704002,130879704002,"Block Group 2, Census Tract 9704, Decatur County, Georgia",937,296,937,296,0,13
1500000US130879704003,130879704003,"Block Group 3, Census Tract 9704, Decatur County, Georgia",1481,378,1481,378,0,13
1500000US130879704004,130879704004,"Block Group 4, Census Tract 9704, Decatur County, Georgia",1063,278,960,254,103,117
1500000US130879706001,130879706001,"Block Group 1, Census Tract 9706, Decatur County, Georgia",458,262,458,262,0,13
1500000US130879706002,130879706002,"Block Group 2, Census Tract 9706, Decatur County, Georgia",757,229,757,229,0,13
1500000US130879706003,130879706003,"Block Group 3, Census Tract 9706, Decatur County, Georgia",1867,439,1804,451,63,77
1500000US130879706004,130879706004,"Block Group 4, Census Tract 9706, Decatur County, Georgia",1969,378,1910,371,59,51
1500000US130879707001,130879707001,"Block Group 1, Census Tract 9707, Decatur County, Georgia",1154,267,712,125,442,274
1500000US130879707002,130879707002,"Block Group 2, Census Tract 9707, Decatur County, Georgia",651,118,648,117,3,7
1500000US130879708001,130879708001,"Block Group 1, Census Tract 9708, Decatur County, Georgia",1522,293,1324,285,198,144
1500000US130879708002,130879708002,"Block Group 2, Census Tract 9708, Decatur County, Georgia",1244,287,1151,266,93,101
1500000US130890201001,130890201001,"Block Group 1, Census Tract 201, DeKalb County, Georgia",1908,124,1831,130,77,68
1500000US130890202001,130890202001,"Block Group 1, Census Tract 202, DeKalb County, Georgia",901,155,861,161,40,55
1500000US130890202002,130890202002,"Block Group 2, Census Tract 202, DeKalb County, Georgia",1188,210,1104,209,84,70
1500000US130890203001,130890203001,"Block Group 1, Census Tract 203, DeKalb County, Georgia",840,206,818,206,22,25
1500000US130890203002,130890203002,"Block Group 2, Census Tract 203, DeKalb County, Georgia",1049,199,1003,209,46,74
1500000US130890203003,130890203003,"Block Group 3, Census Tract 203, DeKalb County, Georgia",1930,273,1825,259,105,95
1500000US130890204001,130890204001,"Block Group 1, Census Tract 204, DeKalb County, Georgia",1684,202,1604,226,80,72
1500000US130890204002,130890204002,"Block Group 2, Census Tract 204, DeKalb County, Georgia",901,144,876,138,25,23
1500000US130890205001,130890205001,"Block Group 1, Census Tract 205, DeKalb County, Georgia",1193,273,1086,209,107,152
1500000US130890205002,130890205002,"Block Group 2, Census Tract 205, DeKalb County, Georgia",1722,256,1652,263,70,58
1500000US130890206001,130890206001,"Block Group 1, Census Tract 206, DeKalb County, Georgia",616,186,597,188,19,23
1500000US130890206002,130890206002,"Block Group 2, Census Tract 206, DeKalb County, Georgia",1433,252,1387,255,46,29
1500000US130890207001,130890207001,"Block Group 1, Census Tract 207, DeKalb County, Georgia",1717,249,1687,253,30,31
1500000US130890207002,130890207002,"Block Group 2, Census Tract 207, DeKalb County, Georgia",528,111,528,111,0,13
1500000US130890208011,130890208011,"Block Group 1, Census Tract 208.01, DeKalb County, Georgia",1041,236,1031,237,10,12
1500000US130890208012,130890208012,"Block Group 2, Census Tract 208.01, DeKalb County, Georgia",1559,249,1520,251,39,31
1500000US130890208021,130890208021,"Block Group 1, Census Tract 208.02, DeKalb County, Georgia",713,176,706,176,7,12
1500000US130890208022,130890208022,"Block Group 2, Census Tract 208.02, DeKalb County, Georgia",1720,266,1629,262,91,102
1500000US130890208023,130890208023,"Block Group 3, Census Tract 208.02, DeKalb County, Georgia",951,247,824,230,127,166
1500000US130890208024,130890208024,"Block Group 4, Census Tract 208.02, DeKalb County, Georgia",873,258,873,258,0,13
1500000US130890209001,130890209001,"Block Group 1, Census Tract 209, DeKalb County, Georgia",1525,318,1447,299,78,110
1500000US130890209002,130890209002,"Block Group 2, Census Tract 209, DeKalb County, Georgia",1235,413,1208,412,27,45
1500000US130890209003,130890209003,"Block Group 3, Census Tract 209, DeKalb County, Georgia",1776,641,1714,656,62,66
1500000US130890209004,130890209004,"Block Group 4, Census Tract 209, DeKalb County, Georgia",1164,562,1137,563,27,32
1500000US130890211011,130890211011,"Block Group 1, Census Tract 211.01, DeKalb County, Georgia",3784,220,3682,228,102,66
1500000US130890211021,130890211021,"Block Group 1, Census Tract 211.02, DeKalb County, Georgia",209,100,209,100,0,13
1500000US130890211022,130890211022,"Block Group 2, Census Tract 211.02, DeKalb County, Georgia",1757,287,1690,280,67,47
1500000US130890211023,130890211023,"Block Group 3, Census Tract 211.02, DeKalb County, Georgia",1142,227,1031,213,111,126
1500000US130890211024,130890211024,"Block Group 4, Census Tract 211.02, DeKalb County, Georgia",2203,385,2153,390,50,56
1500000US130890212021,130890212021,"Block Group 1, Census Tract 212.02, DeKalb County, Georgia",3004,480,2980,480,24,29
1500000US130890212022,130890212022,"Block Group 2, Census Tract 212.02, DeKalb County, Georgia",1914,465,1856,461,58,87
1500000US130890212023,130890212023,"Block Group 3, Census Tract 212.02, DeKalb County, Georgia",2386,517,2169,528,217,154
1500000US130890212041,130890212041,"Block Group 1, Census Tract 212.04, DeKalb County, Georgia",1253,356,304,207,949,341
1500000US130890212042,130890212042,"Block Group 2, Census Tract 212.04, DeKalb County, Georgia",1763,446,76,76,1687,444
1500000US130890212043,130890212043,"Block Group 3, Census Tract 212.04, DeKalb County, Georgia",989,292,109,102,880,286
1500000US130890212081,130890212081,"Block Group 1, Census Tract 212.08, DeKalb County, Georgia",2432,392,2033,354,399,294
1500000US130890212082,130890212082,"Block Group 2, Census Tract 212.08, DeKalb County, Georgia",1600,240,1589,237,11,17
1500000US130890212091,130890212091,"Block Group 1, Census Tract 212.09, DeKalb County, Georgia",1167,337,1093,330,74,72
1500000US130890212092,130890212092,"Block Group 2, Census Tract 212.09, DeKalb County, Georgia",1516,299,1489,294,27,42
1500000US130890212093,130890212093,"Block Group 3, Census Tract 212.09, DeKalb County, Georgia",2041,310,1985,301,56,56
1500000US130890212094,130890212094,"Block Group 4, Census Tract 212.09, DeKalb County, Georgia",1173,232,1038,239,135,109
1500000US130890212101,130890212101,"Block Group 1, Census Tract 212.10, DeKalb County, Georgia",1813,285,1750,284,63,66
1500000US130890212102,130890212102,"Block Group 2, Census Tract 212.10, DeKalb County, Georgia",1207,284,1179,284,28,32
1500000US130890212103,130890212103,"Block Group 3, Census Tract 212.10, DeKalb County, Georgia",2498,320,2492,320,6,10
1500000US130890212111,130890212111,"Block Group 1, Census Tract 212.11, DeKalb County, Georgia",1323,219,1323,219,0,13
1500000US130890212112,130890212112,"Block Group 2, Census Tract 212.11, DeKalb County, Georgia",2110,380,1981,394,129,120
1500000US130890212113,130890212113,"Block Group 3, Census Tract 212.11, DeKalb County, Georgia",1349,216,1336,215,13,19
1500000US130890212131,130890212131,"Block Group 1, Census Tract 212.13, DeKalb County, Georgia",1076,179,987,152,89,91
1500000US130890212132,130890212132,"Block Group 2, Census Tract 212.13, DeKalb County, Georgia",2379,180,2372,179,7,12
1500000US130890212141,130890212141,"Block Group 1, Census Tract 212.14, DeKalb County, Georgia",1801,492,1753,494,48,62
1500000US130890212142,130890212142,"Block Group 2, Census Tract 212.14, DeKalb County, Georgia",3002,408,2867,392,135,150
1500000US130890212143,130890212143,"Block Group 3, Census Tract 212.14, DeKalb County, Georgia",1529,345,1438,367,91,121
1500000US130890212151,130890212151,"Block Group 1, Census Tract 212.15, DeKalb County, Georgia",3401,533,3154,462,247,377
1500000US130890212152,130890212152,"Block Group 2, Census Tract 212.15, DeKalb County, Georgia",2544,456,2331,500,213,225
1500000US130890212161,130890212161,"Block Group 1, Census Tract 212.16, DeKalb County, Georgia",1876,512,1722,455,154,210
1500000US130890212162,130890212162,"Block Group 2, Census Tract 212.16, DeKalb County, Georgia",3807,766,3303,584,504,589
1500000US130890212163,130890212163,"Block Group 3, Census Tract 212.16, DeKalb County, Georgia",2857,545,2733,533,124,89
1500000US130890212171,130890212171,"Block Group 1, Census Tract 212.17, DeKalb County, Georgia",2466,284,2346,299,120,98
1500000US130890212181,130890212181,"Block Group 1, Census Tract 212.18, DeKalb County, Georgia",1266,339,1229,346,37,44
1500000US130890212182,130890212182,"Block Group 2, Census Tract 212.18, DeKalb County, Georgia",2239,510,2038,505,201,123
1500000US130890212183,130890212183,"Block Group 3, Census Tract 212.18, DeKalb County, Georgia",1319,364,1282,362,37,43
1500000US130890213011,130890213011,"Block Group 1, Census Tract 213.01, DeKalb County, Georgia",1107,405,216,70,891,408
1500000US130890213012,130890213012,"Block Group 2, Census Tract 213.01, DeKalb County, Georgia",2898,489,2531,464,367,267
1500000US130890213031,130890213031,"Block Group 1, Census Tract 213.03, DeKalb County, Georgia",3051,457,1471,296,1580,445
1500000US130890213032,130890213032,"Block Group 2, Census Tract 213.03, DeKalb County, Georgia",1314,309,914,228,400,224
1500000US130890213033,130890213033,"Block Group 3, Census Tract 213.03, DeKalb County, Georgia",2131,432,352,164,1779,414
1500000US130890213051,130890213051,"Block Group 1, Census Tract 213.05, DeKalb County, Georgia",928,298,770,225,158,192
1500000US130890213052,130890213052,"Block Group 2, Census Tract 213.05, DeKalb County, Georgia",4256,548,2051,494,2205,469
1500000US130890213061,130890213061,"Block Group 1, Census Tract 213.06, DeKalb County, Georgia",2570,579,1479,356,1091,492
1500000US130890213062,130890213062,"Block Group 2, Census Tract 213.06, DeKalb County, Georgia",667,222,421,148,246,166
1500000US130890213063,130890213063,"Block Group 3, Census Tract 213.06, DeKalb County, Georgia",1885,389,702,256,1183,394
1500000US130890213071,130890213071,"Block Group 1, Census Tract 213.07, DeKalb County, Georgia",1430,429,787,238,643,413
1500000US130890213072,130890213072,"Block Group 2, Census Tract 213.07, DeKalb County, Georgia",2946,418,1817,361,1129,376
1500000US130890213081,130890213081,"Block Group 1, Census Tract 213.08, DeKalb County, Georgia",1648,456,989,253,659,437
1500000US130890213082,130890213082,"Block Group 2, Census Tract 213.08, DeKalb County, Georgia",525,202,505,207,20,30
1500000US130890213083,130890213083,"Block Group 3, Census Tract 213.08, DeKalb County, Georgia",1926,498,720,249,1206,483
1500000US130890214051,130890214051,"Block Group 1, Census Tract 214.05, DeKalb County, Georgia",1042,200,912,210,130,127
1500000US130890214052,130890214052,"Block Group 2, Census Tract 214.05, DeKalb County, Georgia",1850,462,1423,261,427,359
1500000US130890214053,130890214053,"Block Group 3, Census Tract 214.05, DeKalb County, Georgia",1367,298,1283,293,84,84
1500000US130890214091,130890214091,"Block Group 1, Census Tract 214.09, DeKalb County, Georgia",2735,408,1892,320,843,376
1500000US130890214092,130890214092,"Block Group 2, Census Tract 214.09, DeKalb County, Georgia",975,501,199,88,776,501
1500000US130890214101,130890214101,"Block Group 1, Census Tract 214.10, DeKalb County, Georgia",1964,501,752,247,1212,462
1500000US130890214102,130890214102,"Block Group 2, Census Tract 214.10, DeKalb County, Georgia",1757,501,290,181,1467,484
1500000US130890214103,130890214103,"Block Group 3, Census Tract 214.10, DeKalb County, Georgia",1651,295,1442,214,209,190
1500000US130890214111,130890214111,"Block Group 1, Census Tract 214.11, DeKalb County, Georgia",1832,225,1722,228,110,78
1500000US130890214112,130890214112,"Block Group 2, Census Tract 214.11, DeKalb County, Georgia",1718,219,1541,184,177,120
1500000US130890214121,130890214121,"Block Group 1, Census Tract 214.12, DeKalb County, Georgia",1167,237,1167,237,0,13
1500000US130890214122,130890214122,"Block Group 2, Census Tract 214.12, DeKalb County, Georgia",1480,294,1046,220,434,281
1500000US130890214123,130890214123,"Block Group 3, Census Tract 214.12, DeKalb County, Georgia",1227,246,1213,248,14,19
1500000US130890214131,130890214131,"Block Group 1, Census Tract 214.13, DeKalb County, Georgia",3030,545,917,191,2113,489
1500000US130890214132,130890214132,"Block Group 2, Census Tract 214.13, DeKalb County, Georgia",1451,408,294,155,1157,390
1500000US130890214141,130890214141,"Block Group 1, Census Tract 214.14, DeKalb County, Georgia",3022,382,1330,260,1692,414
1500000US130890214142,130890214142,"Block Group 2, Census Tract 214.14, DeKalb County, Georgia",947,220,714,130,233,190
1500000US130890214151,130890214151,"Block Group 1, Census Tract 214.15, DeKalb County, Georgia",1103,214,1073,215,30,40
1500000US130890214152,130890214152,"Block Group 2, Census Tract 214.15, DeKalb County, Georgia",1229,203,1115,203,114,72
1500000US130890214153,130890214153,"Block Group 3, Census Tract 214.15, DeKalb County, Georgia",1846,408,1224,297,622,389
1500000US130890214161,130890214161,"Block Group 1, Census Tract 214.16, DeKalb County, Georgia",1978,401,654,210,1324,389
1500000US130890214162,130890214162,"Block Group 2, Census Tract 214.16, DeKalb County, Georgia",614,165,555,168,59,50
1500000US130890214171,130890214171,"Block Group 1, Census Tract 214.17, DeKalb County, Georgia",1117,284,1076,285,41,39
1500000US130890214172,130890214172,"Block Group 2, Census Tract 214.17, DeKalb County, Georgia",1231,486,684,371,547,404
1500000US130890214173,130890214173,"Block Group 3, Census Tract 214.17, DeKalb County, Georgia",2793,597,313,230,2480,620
1500000US130890215021,130890215021,"Block Group 1, Census Tract 215.02, DeKalb County, Georgia",1298,237,1109,229,189,177
1500000US130890215022,130890215022,"Block Group 2, Census Tract 215.02, DeKalb County, Georgia",1445,483,1390,495,55,48
1500000US130890215023,130890215023,"Block Group 3, Census Tract 215.02, DeKalb County, Georgia",1839,341,1780,329,59,49
1500000US130890215031,130890215031,"Block Group 1, Census Tract 215.03, DeKalb County, Georgia",1478,324,1328,313,150,144
1500000US130890215032,130890215032,"Block Group 2, Census Tract 215.03, DeKalb County, Georgia",1023,277,1023,277,0,13
1500000US130890215033,130890215033,"Block Group 3, Census Tract 215.03, DeKalb County, Georgia",1741,482,958,343,783,412
1500000US130890215041,130890215041,"Block Group 1, Census Tract 215.04, DeKalb County, Georgia",1619,384,1588,390,31,35
1500000US130890215042,130890215042,"Block Group 2, Census Tract 215.04, DeKalb County, Georgia",2104,360,2053,377,51,76
1500000US130890215043,130890215043,"Block Group 3, Census Tract 215.04, DeKalb County, Georgia",1333,267,1220,250,113,79
1500000US130890216021,130890216021,"Block Group 1, Census Tract 216.02, DeKalb County, Georgia",1605,334,1511,330,94,83
1500000US130890216022,130890216022,"Block Group 2, Census Tract 216.02, DeKalb County, Georgia",2399,258,2374,252,25,41
1500000US130890216031,130890216031,"Block Group 1, Census Tract 216.03, DeKalb County, Georgia",1665,257,1581,263,84,67
1500000US130890216032,130890216032,"Block Group 2, Census Tract 216.03, DeKalb County, Georgia",1653,282,1581,288,72,69
1500000US130890216033,130890216033,"Block Group 3, Census Tract 216.03, DeKalb County, Georgia",1203,239,1138,242,65,72
1500000US130890216041,130890216041,"Block Group 1, Census Tract 216.04, DeKalb County, Georgia",2046,207,2000,215,46,49
1500000US130890216042,130890216042,"Block Group 2, Census Tract 216.04, DeKalb County, Georgia",1091,198,1054,193,37,37
1500000US130890216051,130890216051,"Block Group 1, Census Tract 216.05, DeKalb County, Georgia",1662,284,1605,287,57,57
1500000US130890216052,130890216052,"Block Group 2, Census Tract 216.05, DeKalb County, Georgia",1035,252,1021,247,14,22
1500000US130890216053,130890216053,"Block Group 3, Census Tract 216.05, DeKalb County, Georgia",2827,625,2013,574,814,505
1500000US130890217031,130890217031,"Block Group 1, Census Tract 217.03, DeKalb County, Georgia",2409,270,2278,245,131,98
1500000US130890217032,130890217032,"Block Group 2, Census Tract 217.03, DeKalb County, Georgia",2479,243,2294,249,185,156
1500000US130890217041,130890217041,"Block Group 1, Census Tract 217.04, DeKalb County, Georgia",1577,440,1547,443,30,46
1500000US130890217042,130890217042,"Block Group 2, Census Tract 217.04, DeKalb County, Georgia",1123,356,1074,339,49,58
1500000US130890217043,130890217043,"Block Group 3, Census Tract 217.04, DeKalb County, Georgia",2877,306,2838,303,39,37
1500000US130890217051,130890217051,"Block Group 1, Census Tract 217.05, DeKalb County, Georgia",2152,476,1649,325,503,332
1500000US130890217052,130890217052,"Block Group 2, Census Tract 217.05, DeKalb County, Georgia",1262,319,889,224,373,233
1500000US130890217053,130890217053,"Block Group 3, Census Tract 217.05, DeKalb County, Georgia",1317,322,1285,314,32,42
1500000US130890217061,130890217061,"Block Group 1, Census Tract 217.06, DeKalb County, Georgia",787,207,760,204,27,45
1500000US130890217062,130890217062,"Block Group 2, Census Tract 217.06, DeKalb County, Georgia",2192,402,1975,376,217,215
1500000US130890217063,130890217063,"Block Group 3, Census Tract 217.06, DeKalb County, Georgia",1072,266,1072,266,0,13
1500000US130890217064,130890217064,"Block Group 4, Census Tract 217.06, DeKalb County, Georgia",1530,274,1448,263,82,135
1500000US130890218051,130890218051,"Block Group 1, Census Tract 218.05, DeKalb County, Georgia",1864,427,1709,433,155,98
1500000US130890218052,130890218052,"Block Group 2, Census Tract 218.05, DeKalb County, Georgia",1883,466,1764,446,119,98
1500000US130890218053,130890218053,"Block Group 3, Census Tract 218.05, DeKalb County, Georgia",2665,578,2174,440,491,441
1500000US130890218061,130890218061,"Block Group 1, Census Tract 218.06, DeKalb County, Georgia",2491,577,1855,511,636,380
1500000US130890218062,130890218062,"Block Group 2, Census Tract 218.06, DeKalb County, Georgia",1074,255,1022,242,52,58
1500000US130890218063,130890218063,"Block Group 3, Census Tract 218.06, DeKalb County, Georgia",2228,509,1871,499,357,243
1500000US130890218081,130890218081,"Block Group 1, Census Tract 218.08, DeKalb County, Georgia",1706,335,1657,331,49,62
1500000US130890218082,130890218082,"Block Group 2, Census Tract 218.08, DeKalb County, Georgia",3293,426,2702,324,591,299
1500000US130890218091,130890218091,"Block Group 1, Census Tract 218.09, DeKalb County, Georgia",535,194,499,181,36,56
1500000US130890218092,130890218092,"Block Group 2, Census Tract 218.09, DeKalb County, Georgia",1678,390,1670,387,8,14
1500000US130890218093,130890218093,"Block Group 3, Census Tract 218.09, DeKalb County, Georgia",1888,293,1824,303,64,66
1500000US130890218094,130890218094,"Block Group 4, Census Tract 218.09, DeKalb County, Georgia",1367,358,1193,270,174,271
1500000US130890218095,130890218095,"Block Group 5, Census Tract 218.09, DeKalb County, Georgia",1210,244,1154,236,56,83
1500000US130890218101,130890218101,"Block Group 1, Census Tract 218.10, DeKalb County, Georgia",2190,430,2130,424,60,78
1500000US130890218102,130890218102,"Block Group 2, Census Tract 218.10, DeKalb County, Georgia",1319,306,1319,306,0,13
1500000US130890218103,130890218103,"Block Group 3, Census Tract 218.10, DeKalb County, Georgia",1639,312,1482,297,157,112
1500000US130890218121,130890218121,"Block Group 1, Census Tract 218.12, DeKalb County, Georgia",983,156,797,164,186,162
1500000US130890218122,130890218122,"Block Group 2, Census Tract 218.12, DeKalb County, Georgia",1291,194,847,135,444,186
1500000US130890218131,130890218131,"Block Group 1, Census Tract 218.13, DeKalb County, Georgia",2859,485,1753,414,1106,479
1500000US130890218141,130890218141,"Block Group 1, Census Tract 218.14, DeKalb County, Georgia",1045,372,727,252,318,298
1500000US130890218142,130890218142,"Block Group 2, Census Tract 218.14, DeKalb County, Georgia",1397,454,603,226,794,440
1500000US130890218143,130890218143,"Block Group 3, Census Tract 218.14, DeKalb County, Georgia",1339,420,624,210,715,431
1500000US130890218144,130890218144,"Block Group 4, Census Tract 218.14, DeKalb County, Georgia",1870,447,940,296,930,415
1500000US130890219061,130890219061,"Block Group 1, Census Tract 219.06, DeKalb County, Georgia",1659,368,1536,377,123,114
1500000US130890219062,130890219062,"Block Group 2, Census Tract 219.06, DeKalb County, Georgia",758,255,721,246,37,53
1500000US130890219063,130890219063,"Block Group 3, Census Tract 219.06, DeKalb County, Georgia",2824,550,2757,526,67,64
1500000US130890219071,130890219071,"Block Group 1, Census Tract 219.07, DeKalb County, Georgia",4875,547,4412,537,463,502
1500000US130890219072,130890219072,"Block Group 2, Census Tract 219.07, DeKalb County, Georgia",2217,520,2169,515,48,77
1500000US130890219073,130890219073,"Block Group 3, Census Tract 219.07, DeKalb County, Georgia",1883,458,1790,459,93,103
1500000US130890219081,130890219081,"Block Group 1, Census Tract 219.08, DeKalb County, Georgia",1943,720,1902,736,41,68
1500000US130890219082,130890219082,"Block Group 2, Census Tract 219.08, DeKalb County, Georgia",4193,621,4077,602,116,118
1500000US130890219091,130890219091,"Block Group 1, Census Tract 219.09, DeKalb County, Georgia",2234,564,2071,516,163,134
1500000US130890219092,130890219092,"Block Group 2, Census Tract 219.09, DeKalb County, Georgia",1609,503,1571,508,38,59
1500000US130890219093,130890219093,"Block Group 3, Census Tract 219.09, DeKalb County, Georgia",1013,563,978,557,35,56
1500000US130890219094,130890219094,"Block Group 4, Census Tract 219.09, DeKalb County, Georgia",1755,655,1726,655,29,35
1500000US130890219101,130890219101,"Block Group 1, Census Tract 219.10, DeKalb County, Georgia",1341,549,1248,548,93,118
1500000US130890219102,130890219102,"Block Group 2, Census Tract 219.10, DeKalb County, Georgia",1796,434,1668,393,128,141
1500000US130890219103,130890219103,"Block Group 3, Census Tract 219.10, DeKalb County, Georgia",1683,451,1636,439,47,59
1500000US130890219111,130890219111,"Block Group 1, Census Tract 219.11, DeKalb County, Georgia",816,526,816,526,0,13
1500000US130890219112,130890219112,"Block Group 2, Census Tract 219.11, DeKalb County, Georgia",1373,504,1329,496,44,74
1500000US130890219121,130890219121,"Block Group 1, Census Tract 219.12, DeKalb County, Georgia",1451,299,1410,299,41,33
1500000US130890219122,130890219122,"Block Group 2, Census Tract 219.12, DeKalb County, Georgia",1364,261,1344,260,20,20
1500000US130890219123,130890219123,"Block Group 3, Census Tract 219.12, DeKalb County, Georgia",644,153,620,155,24,30
1500000US130890219131,130890219131,"Block Group 1, Census Tract 219.13, DeKalb County, Georgia",2554,617,2449,602,105,128
1500000US130890219132,130890219132,"Block Group 2, Census Tract 219.13, DeKalb County, Georgia",848,294,743,303,105,123
1500000US130890219133,130890219133,"Block Group 3, Census Tract 219.13, DeKalb County, Georgia",1243,574,872,348,371,482
1500000US130890220011,130890220011,"Block Group 1, Census Tract 220.01, DeKalb County, Georgia",2018,509,1959,508,59,48
1500000US130890220012,130890220012,"Block Group 2, Census Tract 220.01, DeKalb County, Georgia",2321,361,2182,352,139,74
1500000US130890220041,130890220041,"Block Group 1, Census Tract 220.04, DeKalb County, Georgia",2668,538,2668,538,0,13
1500000US130890220042,130890220042,"Block Group 2, Census Tract 220.04, DeKalb County, Georgia",1381,474,1338,480,43,47
1500000US130890220043,130890220043,"Block Group 3, Census Tract 220.04, DeKalb County, Georgia",1977,498,1977,498,0,13
1500000US130890220051,130890220051,"Block Group 1, Census Tract 220.05, DeKalb County, Georgia",1727,546,1727,546,0,13
1500000US130890220052,130890220052,"Block Group 2, Census Tract 220.05, DeKalb County, Georgia",1128,268,1014,262,114,138
1500000US130890220053,130890220053,"Block Group 3, Census Tract 220.05, DeKalb County, Georgia",1736,318,1725,319,11,13
1500000US130890220071,130890220071,"Block Group 1, Census Tract 220.07, DeKalb County, Georgia",2254,470,2116,457,138,163
1500000US130890220072,130890220072,"Block Group 2, Census Tract 220.07, DeKalb County, Georgia",1850,341,1806,322,44,47
1500000US130890220081,130890220081,"Block Group 1, Census Tract 220.08, DeKalb County, Georgia",1057,394,953,423,104,105
1500000US130890220082,130890220082,"Block Group 2, Census Tract 220.08, DeKalb County, Georgia",2580,712,2580,712,0,13
1500000US130890220083,130890220083,"Block Group 3, Census Tract 220.08, DeKalb County, Georgia",3693,774,3670,777,23,40
1500000US130890220084,130890220084,"Block Group 4, Census Tract 220.08, DeKalb County, Georgia",1037,468,1037,468,0,13
1500000US130890220091,130890220091,"Block Group 1, Census Tract 220.09, DeKalb County, Georgia",1844,490,1844,490,0,13
1500000US130890220092,130890220092,"Block Group 2, Census Tract 220.09, DeKalb County, Georgia",1905,439,1905,439,0,13
1500000US130890220093,130890220093,"Block Group 3, Census Tract 220.09, DeKalb County, Georgia",1341,353,1341,353,0,13
1500000US130890220101,130890220101,"Block Group 1, Census Tract 220.10, DeKalb County, Georgia",2669,317,2560,322,109,105
1500000US130890221001,130890221001,"Block Group 1, Census Tract 221, DeKalb County, Georgia",2090,511,2058,511,32,31
1500000US130890221002,130890221002,"Block Group 2, Census Tract 221, DeKalb County, Georgia",1511,296,1357,297,154,98
1500000US130890222031,130890222031,"Block Group 1, Census Tract 222.03, DeKalb County, Georgia",2090,235,1984,236,106,93
1500000US130890222041,130890222041,"Block Group 1, Census Tract 222.04, DeKalb County, Georgia",3732,985,2623,785,1109,852
1500000US130890222042,130890222042,"Block Group 2, Census Tract 222.04, DeKalb County, Georgia",765,310,752,307,13,21
1500000US130890222043,130890222043,"Block Group 3, Census Tract 222.04, DeKalb County, Georgia",1628,484,1628,484,0,13
1500000US130890222044,130890222044,"Block Group 4, Census Tract 222.04, DeKalb County, Georgia",898,467,857,444,41,63
1500000US130890223011,130890223011,"Block Group 1, Census Tract 223.01, DeKalb County, Georgia",1306,278,1257,270,49,61
1500000US130890223012,130890223012,"Block Group 2, Census Tract 223.01, DeKalb County, Georgia",498,124,498,124,0,13
1500000US130890223013,130890223013,"Block Group 3, Census Tract 223.01, DeKalb County, Georgia",909,202,880,205,29,33
1500000US130890223014,130890223014,"Block Group 4, Census Tract 223.01, DeKalb County, Georgia",1376,224,1321,232,55,53
1500000US130890223015,130890223015,"Block Group 5, Census Tract 223.01, DeKalb County, Georgia",1801,370,1682,382,119,92
1500000US130890223021,130890223021,"Block Group 1, Census Tract 223.02, DeKalb County, Georgia",1572,282,1526,288,46,76
1500000US130890223022,130890223022,"Block Group 2, Census Tract 223.02, DeKalb County, Georgia",1274,300,856,229,418,294
1500000US130890223023,130890223023,"Block Group 3, Census Tract 223.02, DeKalb County, Georgia",1728,332,1682,338,46,43
1500000US130890224011,130890224011,"Block Group 1, Census Tract 224.01, DeKalb County, Georgia",1862,305,1821,311,41,42
1500000US130890224012,130890224012,"Block Group 2, Census Tract 224.01, DeKalb County, Georgia",1109,238,1104,234,5,9
1500000US130890224013,130890224013,"Block Group 3, Census Tract 224.01, DeKalb County, Georgia",973,240,965,240,8,16
1500000US130890224021,130890224021,"Block Group 1, Census Tract 224.02, DeKalb County, Georgia",2394,297,2278,306,116,67
1500000US130890224022,130890224022,"Block Group 2, Census Tract 224.02, DeKalb County, Georgia",3326,324,3143,298,183,75
1500000US130890224031,130890224031,"Block Group 1, Census Tract 224.03, DeKalb County, Georgia",1304,189,1255,185,49,41
1500000US130890224032,130890224032,"Block Group 2, Census Tract 224.03, DeKalb County, Georgia",1619,279,1586,284,33,38
1500000US130890224033,130890224033,"Block Group 3, Census Tract 224.03, DeKalb County, Georgia",1065,190,1065,190,0,13
1500000US130890225001,130890225001,"Block Group 1, Census Tract 225, DeKalb County, Georgia",1992,869,1980,870,12,19
1500000US130890225002,130890225002,"Block Group 2, Census Tract 225, DeKalb County, Georgia",1052,293,1001,287,51,67
1500000US130890225003,130890225003,"Block Group 3, Census Tract 225, DeKalb County, Georgia",1425,299,1300,298,125,140
1500000US130890225004,130890225004,"Block Group 4, Census Tract 225, DeKalb County, Georgia",1784,309,1784,309,0,13
1500000US130890226001,130890226001,"Block Group 1, Census Tract 226, DeKalb County, Georgia",1756,351,1698,353,58,56
1500000US130890226002,130890226002,"Block Group 2, Census Tract 226, DeKalb County, Georgia",1985,322,1891,327,94,117
1500000US130890226003,130890226003,"Block Group 3, Census Tract 226, DeKalb County, Georgia",1883,304,1842,304,41,48
1500000US130890227001,130890227001,"Block Group 1, Census Tract 227, DeKalb County, Georgia",1963,300,1919,295,44,64
1500000US130890227002,130890227002,"Block Group 2, Census Tract 227, DeKalb County, Georgia",972,200,909,168,63,85
1500000US130890227003,130890227003,"Block Group 3, Census Tract 227, DeKalb County, Georgia",1511,245,1475,245,36,36
1500000US130890228001,130890228001,"Block Group 1, Census Tract 228, DeKalb County, Georgia",1111,261,1046,247,65,32
1500000US130890228002,130890228002,"Block Group 2, Census Tract 228, DeKalb County, Georgia",1689,311,1652,313,37,47
1500000US130890228003,130890228003,"Block Group 3, Census Tract 228, DeKalb County, Georgia",1041,177,1041,177,0,13
1500000US130890229001,130890229001,"Block Group 1, Census Tract 229, DeKalb County, Georgia",1547,281,1443,264,104,80
1500000US130890229002,130890229002,"Block Group 2, Census Tract 229, DeKalb County, Georgia",151,51,151,51,0,13
1500000US130890229003,130890229003,"Block Group 3, Census Tract 229, DeKalb County, Georgia",1980,272,1900,267,80,77
1500000US130890230001,130890230001,"Block Group 1, Census Tract 230, DeKalb County, Georgia",2096,162,2048,163,48,54
1500000US130890231011,130890231011,"Block Group 1, Census Tract 231.01, DeKalb County, Georgia",647,247,647,247,0,13
1500000US130890231012,130890231012,"Block Group 2, Census Tract 231.01, DeKalb County, Georgia",1664,391,1521,334,143,134
1500000US130890231013,130890231013,"Block Group 3, Census Tract 231.01, DeKalb County, Georgia",833,308,833,308,0,13
1500000US130890231014,130890231014,"Block Group 4, Census Tract 231.01, DeKalb County, Georgia",1455,372,1358,332,97,108
1500000US130890231021,130890231021,"Block Group 1, Census Tract 231.02, DeKalb County, Georgia",1449,217,1387,224,62,49
1500000US130890231022,130890231022,"Block Group 2, Census Tract 231.02, DeKalb County, Georgia",1781,315,1708,315,73,65
1500000US130890231071,130890231071,"Block Group 1, Census Tract 231.07, DeKalb County, Georgia",1788,418,1658,384,130,131
1500000US130890231072,130890231072,"Block Group 2, Census Tract 231.07, DeKalb County, Georgia",1320,451,1154,440,166,187
1500000US130890231073,130890231073,"Block Group 3, Census Tract 231.07, DeKalb County, Georgia",1401,323,1392,322,9,15
1500000US130890231081,130890231081,"Block Group 1, Census Tract 231.08, DeKalb County, Georgia",1648,428,1627,427,21,24
1500000US130890231082,130890231082,"Block Group 2, Census Tract 231.08, DeKalb County, Georgia",1238,300,1232,300,6,9
1500000US130890231083,130890231083,"Block Group 3, Census Tract 231.08, DeKalb County, Georgia",1854,442,1841,441,13,21
1500000US130890231111,130890231111,"Block Group 1, Census Tract 231.11, DeKalb County, Georgia",2054,239,1967,245,87,75
1500000US130890231121,130890231121,"Block Group 1, Census Tract 231.12, DeKalb County, Georgia",1390,280,1330,274,60,61
1500000US130890231122,130890231122,"Block Group 2, Census Tract 231.12, DeKalb County, Georgia",2334,406,2138,426,196,143
1500000US130890231123,130890231123,"Block Group 3, Census Tract 231.12, DeKalb County, Georgia",541,209,459,190,82,121
1500000US130890231131,130890231131,"Block Group 1, Census Tract 231.13, DeKalb County, Georgia",2059,379,1907,383,152,109
1500000US130890231132,130890231132,"Block Group 2, Census Tract 231.13, DeKalb County, Georgia",1338,290,1306,282,32,39
1500000US130890231141,130890231141,"Block Group 1, Census Tract 231.14, DeKalb County, Georgia",1094,242,1075,239,19,30
1500000US130890231142,130890231142,"Block Group 2, Census Tract 231.14, DeKalb County, Georgia",1346,265,1287,256,59,49
1500000US130890231151,130890231151,"Block Group 1, Census Tract 231.15, DeKalb County, Georgia",3083,504,2884,518,199,90
1500000US130890232041,130890232041,"Block Group 1, Census Tract 232.04, DeKalb County, Georgia",2661,632,2635,626,26,31
1500000US130890232042,130890232042,"Block Group 2, Census Tract 232.04, DeKalb County, Georgia",2575,829,2456,835,119,125
1500000US130890232043,130890232043,"Block Group 3, Census Tract 232.04, DeKalb County, Georgia",1934,629,1850,628,84,126
1500000US130890232061,130890232061,"Block Group 1, Census Tract 232.06, DeKalb County, Georgia",2967,628,2819,638,148,133
1500000US130890232062,130890232062,"Block Group 2, Census Tract 232.06, DeKalb County, Georgia",3187,866,3132,882,55,59
1500000US130890232063,130890232063,"Block Group 3, Census Tract 232.06, DeKalb County, Georgia",1510,505,1509,505,1,2
1500000US130890232081,130890232081,"Block Group 1, Census Tract 232.08, DeKalb County, Georgia",2566,698,2499,691,67,66
1500000US130890232082,130890232082,"Block Group 2, Census Tract 232.08, DeKalb County, Georgia",1318,445,1232,416,86,136
1500000US130890232083,130890232083,"Block Group 3, Census Tract 232.08, DeKalb County, Georgia",3174,725,3174,725,0,13
1500000US130890232091,130890232091,"Block Group 1, Census Tract 232.09, DeKalb County, Georgia",1490,527,1179,425,311,341
1500000US130890232092,130890232092,"Block Group 2, Census Tract 232.09, DeKalb County, Georgia",2533,590,2533,590,0,13
1500000US130890232093,130890232093,"Block Group 3, Census Tract 232.09, DeKalb County, Georgia",1607,397,1575,394,32,38
1500000US130890232101,130890232101,"Block Group 1, Census Tract 232.10, DeKalb County, Georgia",1274,446,1274,446,0,13
1500000US130890232102,130890232102,"Block Group 2, Census Tract 232.10, DeKalb County, Georgia",753,471,753,471,0,13
1500000US130890232103,130890232103,"Block Group 3, Census Tract 232.10, DeKalb County, Georgia",1792,647,1792,647,0,13
1500000US130890232104,130890232104,"Block Group 4, Census Tract 232.10, DeKalb County, Georgia",653,352,653,352,0,13
1500000US130890232105,130890232105,"Block Group 5, Census Tract 232.10, DeKalb County, Georgia",2042,517,1981,534,61,80
1500000US130890232111,130890232111,"Block Group 1, Census Tract 232.11, DeKalb County, Georgia",1489,338,1451,349,38,62
1500000US130890232112,130890232112,"Block Group 2, Census Tract 232.11, DeKalb County, Georgia",1528,287,1517,288,11,18
1500000US130890232121,130890232121,"Block Group 1, Census Tract 232.12, DeKalb County, Georgia",1514,375,1497,375,17,26
1500000US130890232122,130890232122,"Block Group 2, Census Tract 232.12, DeKalb County, Georgia",2100,314,2021,319,79,61
1500000US130890232131,130890232131,"Block Group 1, Census Tract 232.13, DeKalb County, Georgia",1247,541,1247,541,0,13
1500000US130890232132,130890232132,"Block Group 2, Census Tract 232.13, DeKalb County, Georgia",1514,582,1514,582,0,13
1500000US130890232133,130890232133,"Block Group 3, Census Tract 232.13, DeKalb County, Georgia",3222,712,3158,700,64,50
1500000US130890232141,130890232141,"Block Group 1, Census Tract 232.14, DeKalb County, Georgia",3199,494,3052,490,147,138
1500000US130890232142,130890232142,"Block Group 2, Census Tract 232.14, DeKalb County, Georgia",2887,676,2877,673,10,37
1500000US130890233031,130890233031,"Block Group 1, Census Tract 233.03, DeKalb County, Georgia",3480,652,3086,486,394,429
1500000US130890233032,130890233032,"Block Group 2, Census Tract 233.03, DeKalb County, Georgia",809,266,772,243,37,47
1500000US130890233033,130890233033,"Block Group 3, Census Tract 233.03, DeKalb County, Georgia",960,346,693,177,267,292
1500000US130890233034,130890233034,"Block Group 4, Census Tract 233.03, DeKalb County, Georgia",1566,372,1538,372,28,44
1500000US130890233061,130890233061,"Block Group 1, Census Tract 233.06, DeKalb County, Georgia",2635,794,2466,700,169,219
1500000US130890233062,130890233062,"Block Group 2, Census Tract 233.06, DeKalb County, Georgia",2012,699,2012,699,0,13
1500000US130890233063,130890233063,"Block Group 3, Census Tract 233.06, DeKalb County, Georgia",2323,621,1930,521,393,293
1500000US130890233091,130890233091,"Block Group 1, Census Tract 233.09, DeKalb County, Georgia",1216,364,1160,357,56,69
1500000US130890233092,130890233092,"Block Group 2, Census Tract 233.09, DeKalb County, Georgia",1896,563,1896,563,0,13
1500000US130890233093,130890233093,"Block Group 3, Census Tract 233.09, DeKalb County, Georgia",4417,836,4246,824,171,151
1500000US130890233094,130890233094,"Block Group 4, Census Tract 233.09, DeKalb County, Georgia",1914,564,1905,562,9,14
1500000US130890233101,130890233101,"Block Group 1, Census Tract 233.10, DeKalb County, Georgia",2321,699,2290,700,31,49
1500000US130890233102,130890233102,"Block Group 2, Census Tract 233.10, DeKalb County, Georgia",3920,836,3881,812,39,60
1500000US130890233103,130890233103,"Block Group 3, Census Tract 233.10, DeKalb County, Georgia",1958,641,1953,640,5,16
1500000US130890233104,130890233104,"Block Group 4, Census Tract 233.10, DeKalb County, Georgia",1339,407,1330,406,9,14
1500000US130890233111,130890233111,"Block Group 1, Census Tract 233.11, DeKalb County, Georgia",3090,479,3065,494,25,31
1500000US130890233112,130890233112,"Block Group 2, Census Tract 233.11, DeKalb County, Georgia",1909,539,1873,516,36,56
1500000US130890233121,130890233121,"Block Group 1, Census Tract 233.12, DeKalb County, Georgia",3898,697,3742,739,156,212
1500000US130890233122,130890233122,"Block Group 2, Census Tract 233.12, DeKalb County, Georgia",2905,813,2905,813,0,13
1500000US130890233123,130890233123,"Block Group 3, Census Tract 233.12, DeKalb County, Georgia",2399,806,2132,760,267,307
1500000US130890233131,130890233131,"Block Group 1, Census Tract 233.13, DeKalb County, Georgia",1926,347,1926,347,0,13
1500000US130890233132,130890233132,"Block Group 2, Census Tract 233.13, DeKalb County, Georgia",3006,503,2913,481,93,127
1500000US130890233141,130890233141,"Block Group 1, Census Tract 233.14, DeKalb County, Georgia",1639,456,1518,443,121,125
1500000US130890233142,130890233142,"Block Group 2, Census Tract 233.14, DeKalb County, Georgia",2022,441,2022,441,0,13
1500000US130890233143,130890233143,"Block Group 3, Census Tract 233.14, DeKalb County, Georgia",1433,400,1433,400,0,13
1500000US130890233151,130890233151,"Block Group 1, Census Tract 233.15, DeKalb County, Georgia",3211,478,3201,478,10,17
1500000US130890233152,130890233152,"Block Group 2, Census Tract 233.15, DeKalb County, Georgia",1543,518,1532,516,11,18
1500000US130890233161,130890233161,"Block Group 1, Census Tract 233.16, DeKalb County, Georgia",2913,553,2653,498,260,404
1500000US130890233162,130890233162,"Block Group 2, Census Tract 233.16, DeKalb County, Georgia",3487,908,3380,916,107,134
1500000US130890233163,130890233163,"Block Group 3, Census Tract 233.16, DeKalb County, Georgia",1652,602,1623,607,29,43
1500000US130890234101,130890234101,"Block Group 1, Census Tract 234.10, DeKalb County, Georgia",1417,304,1417,304,0,13
1500000US130890234102,130890234102,"Block Group 2, Census Tract 234.10, DeKalb County, Georgia",1715,325,1684,325,31,39
1500000US130890234111,130890234111,"Block Group 1, Census Tract 234.11, DeKalb County, Georgia",1921,452,1892,446,29,39
1500000US130890234112,130890234112,"Block Group 2, Census Tract 234.11, DeKalb County, Georgia",2031,327,1987,320,44,69
1500000US130890234121,130890234121,"Block Group 1, Census Tract 234.12, DeKalb County, Georgia",2020,690,2020,690,0,13
1500000US130890234122,130890234122,"Block Group 2, Census Tract 234.12, DeKalb County, Georgia",1810,579,1810,579,0,13
1500000US130890234123,130890234123,"Block Group 3, Census Tract 234.12, DeKalb County, Georgia",2661,864,2661,864,0,13
1500000US130890234131,130890234131,"Block Group 1, Census Tract 234.13, DeKalb County, Georgia",1703,473,1703,473,0,13
1500000US130890234132,130890234132,"Block Group 2, Census Tract 234.13, DeKalb County, Georgia",1707,257,1604,260,103,75
1500000US130890234141,130890234141,"Block Group 1, Census Tract 234.14, DeKalb County, Georgia",2144,705,2144,705,0,13
1500000US130890234142,130890234142,"Block Group 2, Census Tract 234.14, DeKalb County, Georgia",1237,419,1237,419,0,13
1500000US130890234143,130890234143,"Block Group 3, Census Tract 234.14, DeKalb County, Georgia",3100,704,3089,705,11,18
1500000US130890234161,130890234161,"Block Group 1, Census Tract 234.16, DeKalb County, Georgia",1979,652,1948,651,31,47
1500000US130890234162,130890234162,"Block Group 2, Census Tract 234.16, DeKalb County, Georgia",2807,645,2807,645,0,13
1500000US130890234163,130890234163,"Block Group 3, Census Tract 234.16, DeKalb County, Georgia",1577,470,1545,467,32,52
1500000US130890234164,130890234164,"Block Group 4, Census Tract 234.16, DeKalb County, Georgia",1561,402,1561,402,0,13
1500000US130890234181,130890234181,"Block Group 1, Census Tract 234.18, DeKalb County, Georgia",6278,1680,6278,1680,0,18
1500000US130890234182,130890234182,"Block Group 2, Census Tract 234.18, DeKalb County, Georgia",3327,1160,3327,1160,0,13
1500000US130890234183,130890234183,"Block Group 3, Census Tract 234.18, DeKalb County, Georgia",3750,1551,3750,1551,0,13
1500000US130890234184,130890234184,"Block Group 4, Census Tract 234.18, DeKalb County, Georgia",5968,1780,5695,1667,273,310
1500000US130890234191,130890234191,"Block Group 1, Census Tract 234.19, DeKalb County, Georgia",6097,1011,6005,1018,92,126
1500000US130890234192,130890234192,"Block Group 2, Census Tract 234.19, DeKalb County, Georgia",1448,465,1448,465,0,13
1500000US130890234193,130890234193,"Block Group 3, Census Tract 234.19, DeKalb County, Georgia",1960,682,1960,682,0,13
1500000US130890234211,130890234211,"Block Group 1, Census Tract 234.21, DeKalb County, Georgia",3190,732,3190,732,0,13
1500000US130890234212,130890234212,"Block Group 2, Census Tract 234.21, DeKalb County, Georgia",1167,476,1155,477,12,20
1500000US130890234213,130890234213,"Block Group 3, Census Tract 234.21, DeKalb County, Georgia",3572,690,3540,689,32,41
1500000US130890234221,130890234221,"Block Group 1, Census Tract 234.22, DeKalb County, Georgia",1762,431,1618,421,144,176
1500000US130890234222,130890234222,"Block Group 2, Census Tract 234.22, DeKalb County, Georgia",3177,488,3148,483,29,38
1500000US130890234231,130890234231,"Block Group 1, Census Tract 234.23, DeKalb County, Georgia",2802,552,2730,548,72,58
1500000US130890234232,130890234232,"Block Group 2, Census Tract 234.23, DeKalb County, Georgia",1368,524,1293,518,75,115
1500000US130890234233,130890234233,"Block Group 3, Census Tract 234.23, DeKalb County, Georgia",3337,619,3289,612,48,73
1500000US130890234241,130890234241,"Block Group 1, Census Tract 234.24, DeKalb County, Georgia",4005,619,3844,592,161,177
1500000US130890234242,130890234242,"Block Group 2, Census Tract 234.24, DeKalb County, Georgia",1889,539,1889,539,0,13
1500000US130890234251,130890234251,"Block Group 1, Census Tract 234.25, DeKalb County, Georgia",2355,525,2334,534,21,39
1500000US130890234252,130890234252,"Block Group 2, Census Tract 234.25, DeKalb County, Georgia",3424,754,3413,749,11,20
1500000US130890234261,130890234261,"Block Group 1, Census Tract 234.26, DeKalb County, Georgia",2614,407,2570,403,44,49
1500000US130890234262,130890234262,"Block Group 2, Census Tract 234.26, DeKalb County, Georgia",2211,440,2211,440,0,13
1500000US130890234271,130890234271,"Block Group 1, Census Tract 234.27, DeKalb County, Georgia",2099,311,2099,311,0,13
1500000US130890234272,130890234272,"Block Group 2, Census Tract 234.27, DeKalb County, Georgia",739,197,739,197,0,13
1500000US130890234281,130890234281,"Block Group 1, Census Tract 234.28, DeKalb County, Georgia",831,427,831,427,0,13
1500000US130890234282,130890234282,"Block Group 2, Census Tract 234.28, DeKalb County, Georgia",2665,652,2665,652,0,13
1500000US130890234283,130890234283,"Block Group 3, Census Tract 234.28, DeKalb County, Georgia",4534,789,4407,766,127,170
1500000US130890234284,130890234284,"Block Group 4, Census Tract 234.28, DeKalb County, Georgia",1688,607,1688,607,0,13
1500000US130890235011,130890235011,"Block Group 1, Census Tract 235.01, DeKalb County, Georgia",1472,574,1463,575,9,15
1500000US130890235012,130890235012,"Block Group 2, Census Tract 235.01, DeKalb County, Georgia",1828,347,1811,343,17,20
1500000US130890235041,130890235041,"Block Group 1, Census Tract 235.04, DeKalb County, Georgia",787,245,703,189,84,126
1500000US130890235042,130890235042,"Block Group 2, Census Tract 235.04, DeKalb County, Georgia",687,172,687,172,0,13
1500000US130890235043,130890235043,"Block Group 3, Census Tract 235.04, DeKalb County, Georgia",1555,460,1511,460,44,65
1500000US130890235051,130890235051,"Block Group 1, Census Tract 235.05, DeKalb County, Georgia",1283,219,1246,211,37,66
1500000US130890235052,130890235052,"Block Group 2, Census Tract 235.05, DeKalb County, Georgia",1188,294,1188,294,0,13
1500000US130890235061,130890235061,"Block Group 1, Census Tract 235.06, DeKalb County, Georgia",2139,544,2131,546,8,15
1500000US130890235062,130890235062,"Block Group 2, Census Tract 235.06, DeKalb County, Georgia",2033,462,2033,462,0,13
1500000US130890235063,130890235063,"Block Group 3, Census Tract 235.06, DeKalb County, Georgia",1795,511,1795,511,0,13
1500000US130890235071,130890235071,"Block Group 1, Census Tract 235.07, DeKalb County, Georgia",1109,297,1101,295,8,12
1500000US130890235072,130890235072,"Block Group 2, Census Tract 235.07, DeKalb County, Georgia",1018,316,1010,316,8,12
1500000US130890235073,130890235073,"Block Group 3, Census Tract 235.07, DeKalb County, Georgia",1743,357,1724,356,19,21
1500000US130890236011,130890236011,"Block Group 1, Census Tract 236.01, DeKalb County, Georgia",1018,237,1014,235,4,9
1500000US130890236012,130890236012,"Block Group 2, Census Tract 236.01, DeKalb County, Georgia",1208,301,1208,301,0,13
1500000US130890236013,130890236013,"Block Group 3, Census Tract 236.01, DeKalb County, Georgia",878,352,835,362,43,67
1500000US130890236021,130890236021,"Block Group 1, Census Tract 236.02, DeKalb County, Georgia",1000,261,1000,261,0,13
1500000US130890236022,130890236022,"Block Group 2, Census Tract 236.02, DeKalb County, Georgia",1591,280,1571,281,20,23
1500000US130890236031,130890236031,"Block Group 1, Census Tract 236.03, DeKalb County, Georgia",1688,428,1672,429,16,26
1500000US130890236032,130890236032,"Block Group 2, Census Tract 236.03, DeKalb County, Georgia",1747,334,1747,334,0,13
1500000US130890237001,130890237001,"Block Group 1, Census Tract 237, DeKalb County, Georgia",1747,422,1632,381,115,152
1500000US130890237002,130890237002,"Block Group 2, Census Tract 237, DeKalb County, Georgia",1343,452,1314,452,29,44
1500000US130890237003,130890237003,"Block Group 3, Census Tract 237, DeKalb County, Georgia",1469,485,1430,486,39,62
1500000US130890237004,130890237004,"Block Group 4, Census Tract 237, DeKalb County, Georgia",1147,501,1147,501,0,13
1500000US130890238011,130890238011,"Block Group 1, Census Tract 238.01, DeKalb County, Georgia",675,224,654,225,21,25
1500000US130890238012,130890238012,"Block Group 2, Census Tract 238.01, DeKalb County, Georgia",1642,335,1549,347,93,108
1500000US130890238013,130890238013,"Block Group 3, Census Tract 238.01, DeKalb County, Georgia",1268,277,1234,278,34,35
1500000US130890238021,130890238021,"Block Group 1, Census Tract 238.02, DeKalb County, Georgia",1314,471,1277,464,37,43
1500000US130890238022,130890238022,"Block Group 2, Census Tract 238.02, DeKalb County, Georgia",3683,775,3406,762,277,201
1500000US130890238031,130890238031,"Block Group 1, Census Tract 238.03, DeKalb County, Georgia",1131,338,1081,338,50,55
1500000US130890238032,130890238032,"Block Group 2, Census Tract 238.03, DeKalb County, Georgia",804,305,687,259,117,179
1500000US130890238033,130890238033,"Block Group 3, Census Tract 238.03, DeKalb County, Georgia",1672,396,1634,380,38,43
1500000US130890238034,130890238034,"Block Group 4, Census Tract 238.03, DeKalb County, Georgia",1713,386,1613,374,100,86
1500000US130899800001,130899800001,"Block Group 1, Census Tract 9800, DeKalb County, Georgia",0,13,0,13,0,13
1500000US130919601001,130919601001,"Block Group 1, Census Tract 9601, Dodge County, Georgia",2704,313,2657,306,47,33
1500000US130919601002,130919601002,"Block Group 2, Census Tract 9601, Dodge County, Georgia",874,194,821,177,53,69
1500000US130919602001,130919602001,"Block Group 1, Census Tract 9602, Dodge County, Georgia",1736,284,1724,283,12,32
1500000US130919602002,130919602002,"Block Group 2, Census Tract 9602, Dodge County, Georgia",971,316,909,268,62,94
1500000US130919602003,130919602003,"Block Group 3, Census Tract 9602, Dodge County, Georgia",577,239,560,240,17,28
1500000US130919603001,130919603001,"Block Group 1, Census Tract 9603, Dodge County, Georgia",1583,375,1471,357,112,157
1500000US130919603002,130919603002,"Block Group 2, Census Tract 9603, Dodge County, Georgia",1463,461,1163,395,300,261
1500000US130919603003,130919603003,"Block Group 3, Census Tract 9603, Dodge County, Georgia",894,346,894,346,0,13
1500000US130919603004,130919603004,"Block Group 4, Census Tract 9603, Dodge County, Georgia",1059,391,1059,391,0,13
1500000US130919603005,130919603005,"Block Group 5, Census Tract 9603, Dodge County, Georgia",1371,403,1371,403,0,13
1500000US130919604001,130919604001,"Block Group 1, Census Tract 9604, Dodge County, Georgia",1007,281,1007,281,0,13
1500000US130919604002,130919604002,"Block Group 2, Census Tract 9604, Dodge County, Georgia",1365,271,1308,271,57,83
1500000US130919604003,130919604003,"Block Group 3, Census Tract 9604, Dodge County, Georgia",1448,311,1444,311,4,9
1500000US130919605001,130919605001,"Block Group 1, Census Tract 9605, Dodge County, Georgia",1046,213,1018,200,28,50
1500000US130919605002,130919605002,"Block Group 2, Census Tract 9605, Dodge County, Georgia",1128,203,1128,203,0,13
1500000US130919606001,130919606001,"Block Group 1, Census Tract 9606, Dodge County, Georgia",1031,187,1031,187,0,13
1500000US130919606002,130919606002,"Block Group 2, Census Tract 9606, Dodge County, Georgia",923,205,870,200,53,43
1500000US130939701001,130939701001,"Block Group 1, Census Tract 9701, Dooly County, Georgia",3179,415,2800,399,379,261
1500000US130939701002,130939701002,"Block Group 2, Census Tract 9701, Dooly County, Georgia",1732,381,1726,380,6,14
1500000US130939701003,130939701003,"Block Group 3, Census Tract 9701, Dooly County, Georgia",760,175,754,176,6,10
1500000US130939702001,130939702001,"Block Group 1, Census Tract 9702, Dooly County, Georgia",790,183,783,180,7,15
1500000US130939702002,130939702002,"Block Group 2, Census Tract 9702, Dooly County, Georgia",1305,276,1146,220,159,176
1500000US130939703001,130939703001,"Block Group 1, Census Tract 9703, Dooly County, Georgia",2016,436,1890,389,126,188
1500000US130939703002,130939703002,"Block Group 2, Census Tract 9703, Dooly County, Georgia",1611,434,1267,386,344,301
1500000US130939703003,130939703003,"Block Group 3, Census Tract 9703, Dooly County, Georgia",2021,541,2021,541,0,13
1500000US130939703004,130939703004,"Block Group 4, Census Tract 9703, Dooly County, Georgia",879,451,879,451,0,13
1500000US130950001001,130950001001,"Block Group 1, Census Tract 1, Dougherty County, Georgia",878,419,878,419,0,13
1500000US130950001002,130950001002,"Block Group 2, Census Tract 1, Dougherty County, Georgia",386,220,386,220,0,13
1500000US130950001003,130950001003,"Block Group 3, Census Tract 1, Dougherty County, Georgia",971,420,971,420,0,13
1500000US130950001004,130950001004,"Block Group 4, Census Tract 1, Dougherty County, Georgia",1439,399,1383,393,56,91
1500000US130950001005,130950001005,"Block Group 5, Census Tract 1, Dougherty County, Georgia",895,403,849,395,46,78
1500000US130950002001,130950002001,"Block Group 1, Census Tract 2, Dougherty County, Georgia",785,332,773,331,12,20
1500000US130950002002,130950002002,"Block Group 2, Census Tract 2, Dougherty County, Georgia",291,158,250,135,41,51
1500000US130950002003,130950002003,"Block Group 3, Census Tract 2, Dougherty County, Georgia",1328,418,1328,418,0,13
1500000US130950002004,130950002004,"Block Group 4, Census Tract 2, Dougherty County, Georgia",556,291,555,291,1,4
1500000US130950004001,130950004001,"Block Group 1, Census Tract 4, Dougherty County, Georgia",1354,407,1312,408,42,44
1500000US130950004002,130950004002,"Block Group 2, Census Tract 4, Dougherty County, Georgia",2320,568,2277,567,43,45
1500000US130950004003,130950004003,"Block Group 3, Census Tract 4, Dougherty County, Georgia",2324,467,2288,474,36,44
1500000US130950005011,130950005011,"Block Group 1, Census Tract 5.01, Dougherty County, Georgia",3564,573,3525,566,39,45
1500000US130950005012,130950005012,"Block Group 2, Census Tract 5.01, Dougherty County, Georgia",1511,241,1462,232,49,66
1500000US130950005021,130950005021,"Block Group 1, Census Tract 5.02, Dougherty County, Georgia",1752,293,1752,293,0,13
1500000US130950005022,130950005022,"Block Group 2, Census Tract 5.02, Dougherty County, Georgia",1500,316,1218,346,282,169
1500000US130950005023,130950005023,"Block Group 3, Census Tract 5.02, Dougherty County, Georgia",686,278,686,278,0,13
1500000US130950005024,130950005024,"Block Group 4, Census Tract 5.02, Dougherty County, Georgia",969,189,969,189,0,13
1500000US130950006001,130950006001,"Block Group 1, Census Tract 6, Dougherty County, Georgia",1284,333,1261,326,23,37
1500000US130950006002,130950006002,"Block Group 2, Census Tract 6, Dougherty County, Georgia",1661,344,1620,342,41,68
1500000US130950007001,130950007001,"Block Group 1, Census Tract 7, Dougherty County, Georgia",1903,244,1845,255,58,98
1500000US130950008001,130950008001,"Block Group 1, Census Tract 8, Dougherty County, Georgia",889,218,889,218,0,13
1500000US130950008002,130950008002,"Block Group 2, Census Tract 8, Dougherty County, Georgia",662,177,621,177,41,38
1500000US130950009001,130950009001,"Block Group 1, Census Tract 9, Dougherty County, Georgia",1049,199,1031,197,18,25
1500000US130950009002,130950009002,"Block Group 2, Census Tract 9, Dougherty County, Georgia",1020,193,1006,193,14,20
1500000US130950010001,130950010001,"Block Group 1, Census Tract 10, Dougherty County, Georgia",517,210,517,210,0,13
1500000US130950010002,130950010002,"Block Group 2, Census Tract 10, Dougherty County, Georgia",1808,308,1773,314,35,43
1500000US130950011001,130950011001,"Block Group 1, Census Tract 11, Dougherty County, Georgia",1517,547,1503,548,14,24
1500000US130950011002,130950011002,"Block Group 2, Census Tract 11, Dougherty County, Georgia",1110,643,1110,643,0,13
1500000US130950011003,130950011003,"Block Group 3, Census Tract 11, Dougherty County, Georgia",916,294,902,291,14,20
1500000US130950011004,130950011004,"Block Group 4, Census Tract 11, Dougherty County, Georgia",1086,301,1086,301,0,13
1500000US130950011005,130950011005,"Block Group 5, Census Tract 11, Dougherty County, Georgia",1508,528,1508,528,0,13
1500000US130950014031,130950014031,"Block Group 1, Census Tract 14.03, Dougherty County, Georgia",1081,244,1081,244,0,13
1500000US130950014032,130950014032,"Block Group 2, Census Tract 14.03, Dougherty County, Georgia",1399,315,1399,315,0,13
1500000US130950015001,130950015001,"Block Group 1, Census Tract 15, Dougherty County, Georgia",711,373,707,373,4,5
1500000US130950015002,130950015002,"Block Group 2, Census Tract 15, Dougherty County, Georgia",1164,371,1164,371,0,13
1500000US130950015003,130950015003,"Block Group 3, Census Tract 15, Dougherty County, Georgia",920,315,809,276,111,151
1500000US130950103021,130950103021,"Block Group 1, Census Tract 103.02, Dougherty County, Georgia",805,277,805,277,0,13
1500000US130950103022,130950103022,"Block Group 2, Census Tract 103.02, Dougherty County, Georgia",1092,305,1092,305,0,13
1500000US130950103023,130950103023,"Block Group 3, Census Tract 103.02, Dougherty County, Georgia",1654,499,1654,499,0,13
1500000US130950103024,130950103024,"Block Group 4, Census Tract 103.02, Dougherty County, Georgia",712,207,699,207,13,25
1500000US130950103025,130950103025,"Block Group 5, Census Tract 103.02, Dougherty County, Georgia",1579,446,1545,426,34,41
1500000US130950104011,130950104011,"Block Group 1, Census Tract 104.01, Dougherty County, Georgia",2220,338,2220,338,0,13
1500000US130950104012,130950104012,"Block Group 2, Census Tract 104.01, Dougherty County, Georgia",3110,615,2953,591,157,169
1500000US130950104013,130950104013,"Block Group 3, Census Tract 104.01, Dougherty County, Georgia",2076,515,2059,515,17,26
1500000US130950104021,130950104021,"Block Group 1, Census Tract 104.02, Dougherty County, Georgia",3026,352,2970,349,56,51
1500000US130950104031,130950104031,"Block Group 1, Census Tract 104.03, Dougherty County, Georgia",1581,185,1566,182,15,17
1500000US130950105001,130950105001,"Block Group 1, Census Tract 105, Dougherty County, Georgia",1579,307,1433,270,146,179
1500000US130950105002,130950105002,"Block Group 2, Census Tract 105, Dougherty County, Georgia",754,179,754,179,0,13
1500000US130950106011,130950106011,"Block Group 1, Census Tract 106.01, Dougherty County, Georgia",1181,250,1176,249,5,9
1500000US130950106012,130950106012,"Block Group 2, Census Tract 106.01, Dougherty County, Georgia",1270,254,1270,254,0,13
1500000US130950106021,130950106021,"Block Group 1, Census Tract 106.02, Dougherty County, Georgia",2054,403,2054,403,0,13
1500000US130950106022,130950106022,"Block Group 2, Census Tract 106.02, Dougherty County, Georgia",1942,331,1942,331,0,13
1500000US130950107001,130950107001,"Block Group 1, Census Tract 107, Dougherty County, Georgia",3135,649,2761,603,374,271
1500000US130950107002,130950107002,"Block Group 2, Census Tract 107, Dougherty County, Georgia",949,350,949,350,0,13
1500000US130950107003,130950107003,"Block Group 3, Census Tract 107, Dougherty County, Georgia",2288,458,2270,454,18,21
1500000US130950109001,130950109001,"Block Group 1, Census Tract 109, Dougherty County, Georgia",1079,222,1079,222,0,13
1500000US130950109002,130950109002,"Block Group 2, Census Tract 109, Dougherty County, Georgia",581,167,581,167,0,13
1500000US130950109003,130950109003,"Block Group 3, Census Tract 109, Dougherty County, Georgia",21,27,21,27,0,13
1500000US130950110001,130950110001,"Block Group 1, Census Tract 110, Dougherty County, Georgia",1294,247,1263,249,31,48
1500000US130950110002,130950110002,"Block Group 2, Census Tract 110, Dougherty County, Georgia",1225,200,1178,188,47,56
1500000US130950112001,130950112001,"Block Group 1, Census Tract 112, Dougherty County, Georgia",1553,319,1520,318,33,35
1500000US130950112002,130950112002,"Block Group 2, Census Tract 112, Dougherty County, Georgia",1344,394,1222,334,122,183
1500000US130950112003,130950112003,"Block Group 3, Census Tract 112, Dougherty County, Georgia",1151,407,1140,407,11,17
1500000US130950113001,130950113001,"Block Group 1, Census Tract 113, Dougherty County, Georgia",2566,292,2455,291,111,96
1500000US130950114001,130950114001,"Block Group 1, Census Tract 114, Dougherty County, Georgia",1260,220,1232,212,28,31
1500000US130950114002,130950114002,"Block Group 2, Census Tract 114, Dougherty County, Georgia",471,108,467,107,4,8
1500000US130950116001,130950116001,"Block Group 1, Census Tract 116, Dougherty County, Georgia",1547,306,1494,312,53,52
1500000US130950116002,130950116002,"Block Group 2, Census Tract 116, Dougherty County, Georgia",497,250,418,221,79,92
1500000US130970801021,130970801021,"Block Group 1, Census Tract 801.02, Douglas County, Georgia",1889,650,1571,604,318,248
1500000US130970801022,130970801022,"Block Group 2, Census Tract 801.02, Douglas County, Georgia",5492,720,5139,677,353,229
1500000US130970801031,130970801031,"Block Group 1, Census Tract 801.03, Douglas County, Georgia",1459,490,1459,490,0,13
1500000US130970801032,130970801032,"Block Group 2, Census Tract 801.03, Douglas County, Georgia",1633,540,1485,528,148,170
1500000US130970801033,130970801033,"Block Group 3, Census Tract 801.03, Douglas County, Georgia",1094,393,1019,360,75,129
1500000US130970801034,130970801034,"Block Group 4, Census Tract 801.03, Douglas County, Georgia",2769,789,2008,748,761,396
1500000US130970802011,130970802011,"Block Group 1, Census Tract 802.01, Douglas County, Georgia",750,325,737,323,13,21
1500000US130970802012,130970802012,"Block Group 2, Census Tract 802.01, Douglas County, Georgia",3188,752,2101,575,1087,644
1500000US130970802013,130970802013,"Block Group 3, Census Tract 802.01, Douglas County, Georgia",1873,567,1627,529,246,271
1500000US130970802021,130970802021,"Block Group 1, Census Tract 802.02, Douglas County, Georgia",851,295,823,289,28,43
1500000US130970802022,130970802022,"Block Group 2, Census Tract 802.02, Douglas County, Georgia",2602,750,2204,637,398,425
1500000US130970802023,130970802023,"Block Group 3, Census Tract 802.02, Douglas County, Georgia",3964,763,3269,687,695,435
1500000US130970802024,130970802024,"Block Group 4, Census Tract 802.02, Douglas County, Georgia",2840,793,2185,751,655,506
1500000US130970803011,130970803011,"Block Group 1, Census Tract 803.01, Douglas County, Georgia",3349,770,3098,753,251,210
1500000US130970803012,130970803012,"Block Group 2, Census Tract 803.01, Douglas County, Georgia",3506,820,3283,786,223,165
1500000US130970803013,130970803013,"Block Group 3, Census Tract 803.01, Douglas County, Georgia",3691,1021,3555,1011,136,197
1500000US130970803014,130970803014,"Block Group 4, Census Tract 803.01, Douglas County, Georgia",1798,555,1775,556,23,27
1500000US130970803031,130970803031,"Block Group 1, Census Tract 803.03, Douglas County, Georgia",2966,490,2578,503,388,282
1500000US130970803032,130970803032,"Block Group 2, Census Tract 803.03, Douglas County, Georgia",950,251,746,206,204,204
1500000US130970803041,130970803041,"Block Group 1, Census Tract 803.04, Douglas County, Georgia",1949,788,1847,655,102,154
1500000US130970803042,130970803042,"Block Group 2, Census Tract 803.04, Douglas County, Georgia",3388,519,3242,535,146,163
1500000US130970804021,130970804021,"Block Group 1, Census Tract 804.02, Douglas County, Georgia",1678,472,1572,434,106,146
1500000US130970804022,130970804022,"Block Group 2, Census Tract 804.02, Douglas County, Georgia",3139,546,3139,546,0,13
1500000US130970804023,130970804023,"Block Group 3, Census Tract 804.02, Douglas County, Georgia",3313,486,3138,474,175,189
1500000US130970804031,130970804031,"Block Group 1, Census Tract 804.03, Douglas County, Georgia",3515,480,3493,484,22,47
1500000US130970804032,130970804032,"Block Group 2, Census Tract 804.03, Douglas County, Georgia",1375,404,1151,352,224,249
1500000US130970804041,130970804041,"Block Group 1, Census Tract 804.04, Douglas County, Georgia",2284,684,1260,487,1024,652
1500000US130970804042,130970804042,"Block Group 2, Census Tract 804.04, Douglas County, Georgia",977,419,948,420,29,48
1500000US130970804043,130970804043,"Block Group 3, Census Tract 804.04, Douglas County, Georgia",5356,512,5100,522,256,274
1500000US130970805051,130970805051,"Block Group 1, Census Tract 805.05, Douglas County, Georgia",3285,584,3105,597,180,147
1500000US130970805052,130970805052,"Block Group 2, Census Tract 805.05, Douglas County, Georgia",1568,265,1440,265,128,116
1500000US130970805061,130970805061,"Block Group 1, Census Tract 805.06, Douglas County, Georgia",1259,357,1195,340,64,91
1500000US130970805062,130970805062,"Block Group 2, Census Tract 805.06, Douglas County, Georgia",2315,439,2090,408,225,163
1500000US130970805063,130970805063,"Block Group 3, Census Tract 805.06, Douglas County, Georgia",1898,532,1880,527,18,29
1500000US130970805071,130970805071,"Block Group 1, Census Tract 805.07, Douglas County, Georgia",2699,285,2379,338,320,207
1500000US130970805072,130970805072,"Block Group 2, Census Tract 805.07, Douglas County, Georgia",976,247,927,235,49,56
1500000US130970805081,130970805081,"Block Group 1, Census Tract 805.08, Douglas County, Georgia",1607,483,1545,480,62,93
1500000US130970805082,130970805082,"Block Group 2, Census Tract 805.08, Douglas County, Georgia",2117,508,1833,466,284,284
1500000US130970805083,130970805083,"Block Group 3, Census Tract 805.08, Douglas County, Georgia",1485,428,1454,437,31,35
1500000US130970805091,130970805091,"Block Group 1, Census Tract 805.09, Douglas County, Georgia",2040,466,2040,466,0,13
1500000US130970805092,130970805092,"Block Group 2, Census Tract 805.09, Douglas County, Georgia",2569,477,2455,503,114,176
1500000US130970805093,130970805093,"Block Group 3, Census Tract 805.09, Douglas County, Georgia",1141,408,1034,400,107,133
1500000US130970805101,130970805101,"Block Group 1, Census Tract 805.10, Douglas County, Georgia",2247,611,2226,613,21,41
1500000US130970805102,130970805102,"Block Group 2, Census Tract 805.10, Douglas County, Georgia",3193,700,2596,609,597,440
1500000US130970805103,130970805103,"Block Group 3, Census Tract 805.10, Douglas County, Georgia",2265,570,2158,562,107,160
1500000US130970805111,130970805111,"Block Group 1, Census Tract 805.11, Douglas County, Georgia",3845,686,3477,652,368,221
1500000US130970805112,130970805112,"Block Group 2, Census Tract 805.11, Douglas County, Georgia",5071,537,4783,558,288,165
1500000US130970806021,130970806021,"Block Group 1, Census Tract 806.02, Douglas County, Georgia",3339,425,3287,418,52,55
1500000US130970806022,130970806022,"Block Group 2, Census Tract 806.02, Douglas County, Georgia",2251,419,2185,431,66,76
1500000US130970806031,130970806031,"Block Group 1, Census Tract 806.03, Douglas County, Georgia",3190,731,3112,749,78,103
1500000US130970806032,130970806032,"Block Group 2, Census Tract 806.03, Douglas County, Georgia",2794,799,2398,772,396,338
1500000US130970806041,130970806041,"Block Group 1, Census Tract 806.04, Douglas County, Georgia",825,349,825,349,0,13
1500000US130970806042,130970806042,"Block Group 2, Census Tract 806.04, Douglas County, Georgia",5504,742,5503,742,1,3
1500000US130970806043,130970806043,"Block Group 3, Census Tract 806.04, Douglas County, Georgia",1955,517,1580,444,375,258
1500000US130970806044,130970806044,"Block Group 4, Census Tract 806.04, Douglas County, Georgia",1444,585,1444,585,0,13
1500000US130990901001,130990901001,"Block Group 1, Census Tract 901, Early County, Georgia",578,162,574,162,4,6
1500000US130990901002,130990901002,"Block Group 2, Census Tract 901, Early County, Georgia",802,205,788,205,14,22
1500000US130990902001,130990902001,"Block Group 1, Census Tract 902, Early County, Georgia",629,267,629,267,0,13
1500000US130990902002,130990902002,"Block Group 2, Census Tract 902, Early County, Georgia",614,207,614,207,0,13
1500000US130990902003,130990902003,"Block Group 3, Census Tract 902, Early County, Georgia",746,212,746,212,0,13
1500000US130990902004,130990902004,"Block Group 4, Census Tract 902, Early County, Georgia",421,135,421,135,0,13
1500000US130990903001,130990903001,"Block Group 1, Census Tract 903, Early County, Georgia",905,164,905,164,0,13
1500000US130990903002,130990903002,"Block Group 2, Census Tract 903, Early County, Georgia",674,176,588,166,86,103
1500000US130990904001,130990904001,"Block Group 1, Census Tract 904, Early County, Georgia",1240,249,1240,249,0,13
1500000US130990904002,130990904002,"Block Group 2, Census Tract 904, Early County, Georgia",1003,306,945,284,58,83
1500000US130990904003,130990904003,"Block Group 3, Census Tract 904, Early County, Georgia",1118,268,1108,246,10,48
1500000US130990905001,130990905001,"Block Group 1, Census Tract 905, Early County, Georgia",702,151,702,151,0,13
1500000US130990905002,130990905002,"Block Group 2, Census Tract 905, Early County, Georgia",1147,188,1105,190,42,63
1500000US131018801001,131018801001,"Block Group 1, Census Tract 8801, Echols County, Georgia",1662,197,1238,208,424,189
1500000US131018802001,131018802001,"Block Group 1, Census Tract 8802, Echols County, Georgia",820,231,674,188,146,147
1500000US131018802002,131018802002,"Block Group 2, Census Tract 8802, Echols County, Georgia",1566,264,1100,255,466,208
1500000US131030301001,131030301001,"Block Group 1, Census Tract 301, Effingham County, Georgia",1927,358,1927,358,0,13
1500000US131030301002,131030301002,"Block Group 2, Census Tract 301, Effingham County, Georgia",580,169,580,169,0,13
1500000US131030301003,131030301003,"Block Group 3, Census Tract 301, Effingham County, Georgia",907,289,888,282,19,34
1500000US131030302021,131030302021,"Block Group 1, Census Tract 302.02, Effingham County, Georgia",1732,414,1732,414,0,13
1500000US131030302022,131030302022,"Block Group 2, Census Tract 302.02, Effingham County, Georgia",4036,474,3928,446,108,107
1500000US131030302031,131030302031,"Block Group 1, Census Tract 302.03, Effingham County, Georgia",1021,344,1013,344,8,10
1500000US131030302032,131030302032,"Block Group 2, Census Tract 302.03, Effingham County, Georgia",4667,595,4273,657,394,277
1500000US131030302033,131030302033,"Block Group 3, Census Tract 302.03, Effingham County, Georgia",2309,479,2309,479,0,13
1500000US131030302041,131030302041,"Block Group 1, Census Tract 302.04, Effingham County, Georgia",2014,460,2014,460,0,13
1500000US131030302042,131030302042,"Block Group 2, Census Tract 302.04, Effingham County, Georgia",1933,301,1892,292,41,50
1500000US131030303011,131030303011,"Block Group 1, Census Tract 303.01, Effingham County, Georgia",2547,454,2523,451,24,28
1500000US131030303012,131030303012,"Block Group 2, Census Tract 303.01, Effingham County, Georgia",2086,384,2068,383,18,32
1500000US131030303031,131030303031,"Block Group 1, Census Tract 303.03, Effingham County, Georgia",2339,264,2199,262,140,102
1500000US131030303041,131030303041,"Block Group 1, Census Tract 303.04, Effingham County, Georgia",2875,669,2811,656,64,105
1500000US131030303042,131030303042,"Block Group 2, Census Tract 303.04, Effingham County, Georgia",2782,555,2458,511,324,243
1500000US131030303043,131030303043,"Block Group 3, Census Tract 303.04, Effingham County, Georgia",1694,533,1694,533,0,13
1500000US131030303051,131030303051,"Block Group 1, Census Tract 303.05, Effingham County, Georgia",2762,771,2699,761,63,53
1500000US131030303052,131030303052,"Block Group 2, Census Tract 303.05, Effingham County, Georgia",5303,675,5017,706,286,215
1500000US131030304011,131030304011,"Block Group 1, Census Tract 304.01, Effingham County, Georgia",2065,514,2011,519,54,84
1500000US131030304012,131030304012,"Block Group 2, Census Tract 304.01, Effingham County, Georgia",3017,581,2916,591,101,153
1500000US131030304021,131030304021,"Block Group 1, Census Tract 304.02, Effingham County, Georgia",3275,524,3118,499,157,172
1500000US131030304022,131030304022,"Block Group 2, Census Tract 304.02, Effingham County, Georgia",2759,415,2664,415,95,104
1500000US131050001001,131050001001,"Block Group 1, Census Tract 1, Elbert County, Georgia",926,236,871,230,55,63
1500000US131050001002,131050001002,"Block Group 2, Census Tract 1, Elbert County, Georgia",1216,309,1197,311,19,29
1500000US131050001003,131050001003,"Block Group 3, Census Tract 1, Elbert County, Georgia",1387,289,1335,291,52,52
1500000US131050002001,131050002001,"Block Group 1, Census Tract 2, Elbert County, Georgia",961,362,961,362,0,13
1500000US131050002002,131050002002,"Block Group 2, Census Tract 2, Elbert County, Georgia",898,294,845,289,53,67
1500000US131050002003,131050002003,"Block Group 3, Census Tract 2, Elbert County, Georgia",948,245,861,229,87,87
1500000US131050003001,131050003001,"Block Group 1, Census Tract 3, Elbert County, Georgia",998,330,998,330,0,13
1500000US131050003002,131050003002,"Block Group 2, Census Tract 3, Elbert County, Georgia",1087,355,1087,355,0,13
1500000US131050003003,131050003003,"Block Group 3, Census Tract 3, Elbert County, Georgia",1660,349,1365,285,295,219
1500000US131050004001,131050004001,"Block Group 1, Census Tract 4, Elbert County, Georgia",945,257,945,257,0,13
1500000US131050004002,131050004002,"Block Group 2, Census Tract 4, Elbert County, Georgia",878,232,741,187,137,150
1500000US131050004003,131050004003,"Block Group 3, Census Tract 4, Elbert County, Georgia",1048,251,876,221,172,180
1500000US131050004004,131050004004,"Block Group 4, Census Tract 4, Elbert County, Georgia",597,248,459,179,138,202
1500000US131050004005,131050004005,"Block Group 5, Census Tract 4, Elbert County, Georgia",682,200,675,199,7,12
1500000US131050005001,131050005001,"Block Group 1, Census Tract 5, Elbert County, Georgia",863,350,863,350,0,13
1500000US131050005002,131050005002,"Block Group 2, Census Tract 5, Elbert County, Georgia",1391,417,1391,417,0,13
1500000US131050005003,131050005003,"Block Group 3, Census Tract 5, Elbert County, Georgia",791,263,791,263,0,13
1500000US131050005004,131050005004,"Block Group 4, Census Tract 5, Elbert County, Georgia",703,211,685,207,18,29
1500000US131050005005,131050005005,"Block Group 5, Census Tract 5, Elbert County, Georgia",1092,347,1092,347,0,13
1500000US131050005006,131050005006,"Block Group 6, Census Tract 5, Elbert County, Georgia",466,265,466,265,0,13
1500000US131079701001,131079701001,"Block Group 1, Census Tract 9701, Emanuel County, Georgia",1923,325,1771,313,152,140
1500000US131079701002,131079701002,"Block Group 2, Census Tract 9701, Emanuel County, Georgia",424,159,424,159,0,13
1500000US131079701003,131079701003,"Block Group 3, Census Tract 9701, Emanuel County, Georgia",2114,427,2053,417,61,87
1500000US131079701004,131079701004,"Block Group 4, Census Tract 9701, Emanuel County, Georgia",1290,291,1290,291,0,13
1500000US131079702001,131079702001,"Block Group 1, Census Tract 9702, Emanuel County, Georgia",818,170,818,170,0,13
1500000US131079702002,131079702002,"Block Group 2, Census Tract 9702, Emanuel County, Georgia",803,169,803,169,0,13
1500000US131079703001,131079703001,"Block Group 1, Census Tract 9703, Emanuel County, Georgia",1333,302,1278,305,55,92
1500000US131079703002,131079703002,"Block Group 2, Census Tract 9703, Emanuel County, Georgia",1254,287,1179,289,75,96
1500000US131079703003,131079703003,"Block Group 3, Census Tract 9703, Emanuel County, Georgia",1333,341,1256,338,77,85
1500000US131079704001,131079704001,"Block Group 1, Census Tract 9704, Emanuel County, Georgia",2182,455,2150,446,32,41
1500000US131079704002,131079704002,"Block Group 2, Census Tract 9704, Emanuel County, Georgia",1428,319,1393,316,35,56
1500000US131079704003,131079704003,"Block Group 3, Census Tract 9704, Emanuel County, Georgia",1179,396,1179,396,0,13
1500000US131079705001,131079705001,"Block Group 1, Census Tract 9705, Emanuel County, Georgia",510,140,510,140,0,13
1500000US131079705002,131079705002,"Block Group 2, Census Tract 9705, Emanuel County, Georgia",783,190,783,190,0,13
1500000US131079706001,131079706001,"Block Group 1, Census Tract 9706, Emanuel County, Georgia",1430,491,1430,491,0,13
1500000US131079706002,131079706002,"Block Group 2, Census Tract 9706, Emanuel County, Georgia",1475,373,1348,350,127,132
1500000US131079706003,131079706003,"Block Group 3, Census Tract 9706, Emanuel County, Georgia",1041,363,1030,361,11,20
1500000US131079706004,131079706004,"Block Group 4, Census Tract 9706, Emanuel County, Georgia",1411,398,1020,332,391,303
1500000US131099701001,131099701001,"Block Group 1, Census Tract 9701, Evans County, Georgia",1501,363,1111,276,390,209
1500000US131099701002,131099701002,"Block Group 2, Census Tract 9701, Evans County, Georgia",1479,317,1245,281,234,152
1500000US131099702001,131099702001,"Block Group 1, Census Tract 9702, Evans County, Georgia",1047,260,1029,259,18,29
1500000US131099702002,131099702002,"Block Group 2, Census Tract 9702, Evans County, Georgia",1019,231,1013,230,6,12
1500000US131099702003,131099702003,"Block Group 3, Census Tract 9702, Evans County, Georgia",978,222,968,221,10,15
1500000US131099702004,131099702004,"Block Group 4, Census Tract 9702, Evans County, Georgia",715,264,683,254,32,33
1500000US131099703001,131099703001,"Block Group 1, Census Tract 9703, Evans County, Georgia",649,183,643,183,6,10
1500000US131099703002,131099703002,"Block Group 2, Census Tract 9703, Evans County, Georgia",1507,373,1096,267,411,239
1500000US131099703003,131099703003,"Block Group 3, Census Tract 9703, Evans County, Georgia",934,273,755,251,179,124
1500000US131099703004,131099703004,"Block Group 4, Census Tract 9703, Evans County, Georgia",985,279,985,279,0,13
1500000US131110501001,131110501001,"Block Group 1, Census Tract 501, Fannin County, Georgia",2196,386,2146,380,50,55
1500000US131110501002,131110501002,"Block Group 2, Census Tract 501, Fannin County, Georgia",1386,313,1369,310,17,30
1500000US131110502001,131110502001,"Block Group 1, Census Tract 502, Fannin County, Georgia",1784,569,1784,569,0,13
1500000US131110502002,131110502002,"Block Group 2, Census Tract 502, Fannin County, Georgia",614,167,596,164,18,31
1500000US131110502003,131110502003,"Block Group 3, Census Tract 502, Fannin County, Georgia",810,251,800,248,10,16
1500000US131110502004,131110502004,"Block Group 4, Census Tract 502, Fannin County, Georgia",1665,367,1665,367,0,13
1500000US131110502005,131110502005,"Block Group 5, Census Tract 502, Fannin County, Georgia",1255,287,1255,287,0,13
1500000US131110503001,131110503001,"Block Group 1, Census Tract 503, Fannin County, Georgia",1574,352,1574,352,0,13
1500000US131110503002,131110503002,"Block Group 2, Census Tract 503, Fannin County, Georgia",1188,295,1188,295,0,13
1500000US131110504001,131110504001,"Block Group 1, Census Tract 504, Fannin County, Georgia",1005,361,1005,361,0,13
1500000US131110504002,131110504002,"Block Group 2, Census Tract 504, Fannin County, Georgia",1056,310,1056,310,0,13
1500000US131110504003,131110504003,"Block Group 3, Census Tract 504, Fannin County, Georgia",1974,594,1919,583,55,69
1500000US131110504004,131110504004,"Block Group 4, Census Tract 504, Fannin County, Georgia",1359,290,1249,270,110,130
1500000US131110504005,131110504005,"Block Group 5, Census Tract 504, Fannin County, Georgia",1758,449,1618,460,140,121
1500000US131110505001,131110505001,"Block Group 1, Census Tract 505, Fannin County, Georgia",444,228,444,228,0,13
1500000US131110505002,131110505002,"Block Group 2, Census Tract 505, Fannin County, Georgia",1752,518,1687,510,65,70
1500000US131110505003,131110505003,"Block Group 3, Census Tract 505, Fannin County, Georgia",1374,346,1374,346,0,13
1500000US131110505004,131110505004,"Block Group 4, Census Tract 505, Fannin County, Georgia",548,261,548,261,0,13
1500000US131131401011,131131401011,"Block Group 1, Census Tract 1401.01, Fayette County, Georgia",1940,443,1809,377,131,276
1500000US131131401012,131131401012,"Block Group 2, Census Tract 1401.01, Fayette County, Georgia",1318,287,1165,214,153,197
1500000US131131401013,131131401013,"Block Group 3, Census Tract 1401.01, Fayette County, Georgia",3535,643,3203,597,332,239
1500000US131131401021,131131401021,"Block Group 1, Census Tract 1401.02, Fayette County, Georgia",1070,328,1070,328,0,13
1500000US131131401022,131131401022,"Block Group 2, Census Tract 1401.02, Fayette County, Georgia",2303,524,2268,543,35,49
1500000US131131401023,131131401023,"Block Group 3, Census Tract 1401.02, Fayette County, Georgia",2252,477,2111,469,141,192
1500000US131131402031,131131402031,"Block Group 1, Census Tract 1402.03, Fayette County, Georgia",3683,486,3241,472,442,304
1500000US131131402032,131131402032,"Block Group 2, Census Tract 1402.03, Fayette County, Georgia",2073,386,1927,367,146,172
1500000US131131402041,131131402041,"Block Group 1, Census Tract 1402.04, Fayette County, Georgia",1127,431,455,216,672,348
1500000US131131402042,131131402042,"Block Group 2, Census Tract 1402.04, Fayette County, Georgia",2156,364,2006,324,150,193
1500000US131131402043,131131402043,"Block Group 3, Census Tract 1402.04, Fayette County, Georgia",2267,440,2068,419,199,222
1500000US131131402061,131131402061,"Block Group 1, Census Tract 1402.06, Fayette County, Georgia",2893,418,2709,420,184,111
1500000US131131402062,131131402062,"Block Group 2, Census Tract 1402.06, Fayette County, Georgia",1600,280,1536,275,64,75
1500000US131131402071,131131402071,"Block Group 1, Census Tract 1402.07, Fayette County, Georgia",1760,340,1608,311,152,143
1500000US131131402072,131131402072,"Block Group 2, Census Tract 1402.07, Fayette County, Georgia",930,195,859,188,71,68
1500000US131131402073,131131402073,"Block Group 3, Census Tract 1402.07, Fayette County, Georgia",2575,324,2541,319,34,40
1500000US131131402081,131131402081,"Block Group 1, Census Tract 1402.08, Fayette County, Georgia",4314,713,3821,654,493,412
1500000US131131402082,131131402082,"Block Group 2, Census Tract 1402.08, Fayette County, Georgia",1195,316,1130,335,65,97
1500000US131131402083,131131402083,"Block Group 3, Census Tract 1402.08, Fayette County, Georgia",2404,548,2253,553,151,127
1500000US131131403031,131131403031,"Block Group 1, Census Tract 1403.03, Fayette County, Georgia",1207,280,1050,226,157,183
1500000US131131403032,131131403032,"Block Group 2, Census Tract 1403.03, Fayette County, Georgia",2041,339,1967,343,74,59
1500000US131131403033,131131403033,"Block Group 3, Census Tract 1403.03, Fayette County, Georgia",1339,284,1272,293,67,60
1500000US131131403041,131131403041,"Block Group 1, Census Tract 1403.04, Fayette County, Georgia",2277,509,2171,494,106,143
1500000US131131403042,131131403042,"Block Group 2, Census Tract 1403.04, Fayette County, Georgia",1208,314,1141,306,67,99
1500000US131131403043,131131403043,"Block Group 3, Census Tract 1403.04, Fayette County, Georgia",2270,430,2065,417,205,257
1500000US131131403051,131131403051,"Block Group 1, Census Tract 1403.05, Fayette County, Georgia",5325,378,4593,433,732,312
1500000US131131403061,131131403061,"Block Group 1, Census Tract 1403.06, Fayette County, Georgia",2753,430,2507,362,246,318
1500000US131131403062,131131403062,"Block Group 2, Census Tract 1403.06, Fayette County, Georgia",3023,473,2669,487,354,254
1500000US131131403063,131131403063,"Block Group 3, Census Tract 1403.06, Fayette County, Georgia",1863,339,1667,359,196,146
1500000US131131403071,131131403071,"Block Group 1, Census Tract 1403.07, Fayette County, Georgia",3131,354,2996,347,135,110
1500000US131131403072,131131403072,"Block Group 2, Census Tract 1403.07, Fayette County, Georgia",1687,278,1687,278,0,13
1500000US131131404031,131131404031,"Block Group 1, Census Tract 1404.03, Fayette County, Georgia",895,197,771,145,124,132
1500000US131131404032,131131404032,"Block Group 2, Census Tract 1404.03, Fayette County, Georgia",925,232,852,222,73,59
1500000US131131404033,131131404033,"Block Group 3, Census Tract 1404.03, Fayette County, Georgia",3548,524,3350,517,198,150
1500000US131131404041,131131404041,"Block Group 1, Census Tract 1404.04, Fayette County, Georgia",1831,445,1776,434,55,64
1500000US131131404042,131131404042,"Block Group 2, Census Tract 1404.04, Fayette County, Georgia",3936,642,3717,634,219,176
1500000US131131404051,131131404051,"Block Group 1, Census Tract 1404.05, Fayette County, Georgia",1394,279,1394,279,0,13
1500000US131131404052,131131404052,"Block Group 2, Census Tract 1404.05, Fayette County, Georgia",2303,374,2262,364,41,59
1500000US131131404061,131131404061,"Block Group 1, Census Tract 1404.06, Fayette County, Georgia",2292,386,2077,356,215,207
1500000US131131404062,131131404062,"Block Group 2, Census Tract 1404.06, Fayette County, Georgia",1462,299,1403,298,59,61
1500000US131131404071,131131404071,"Block Group 1, Census Tract 1404.07, Fayette County, Georgia",1255,410,1155,395,100,127
1500000US131131404072,131131404072,"Block Group 2, Census Tract 1404.07, Fayette County, Georgia",3242,539,3135,528,107,119
1500000US131131404073,131131404073,"Block Group 3, Census Tract 1404.07, Fayette County, Georgia",3475,592,3380,576,95,89
1500000US131131404081,131131404081,"Block Group 1, Census Tract 1404.08, Fayette County, Georgia",1343,282,1318,279,25,41
1500000US131131404082,131131404082,"Block Group 2, Census Tract 1404.08, Fayette County, Georgia",1710,291,1636,277,74,73
1500000US131131405011,131131405011,"Block Group 1, Census Tract 1405.01, Fayette County, Georgia",2950,375,2896,373,54,57
1500000US131131405012,131131405012,"Block Group 2, Census Tract 1405.01, Fayette County, Georgia",2965,406,2947,411,18,25
1500000US131131405021,131131405021,"Block Group 1, Census Tract 1405.02, Fayette County, Georgia",2503,271,2370,289,133,91
1500000US131131405022,131131405022,"Block Group 2, Census Tract 1405.02, Fayette County, Georgia",1107,388,1088,389,19,17
1500000US131150001001,131150001001,"Block Group 1, Census Tract 1, Floyd County, Georgia",2381,280,2319,295,62,77
1500000US131150001002,131150001002,"Block Group 2, Census Tract 1, Floyd County, Georgia",857,266,778,229,79,137
1500000US131150001003,131150001003,"Block Group 3, Census Tract 1, Floyd County, Georgia",1306,334,1306,334,0,13
1500000US131150002011,131150002011,"Block Group 1, Census Tract 2.01, Floyd County, Georgia",1503,521,1028,403,475,475
1500000US131150002012,131150002012,"Block Group 2, Census Tract 2.01, Floyd County, Georgia",2549,596,2056,505,493,487
1500000US131150002013,131150002013,"Block Group 3, Census Tract 2.01, Floyd County, Georgia",2422,406,2322,388,100,144
1500000US131150002021,131150002021,"Block Group 1, Census Tract 2.02, Floyd County, Georgia",2012,398,2012,398,0,13
1500000US131150002022,131150002022,"Block Group 2, Census Tract 2.02, Floyd County, Georgia",1888,302,1888,302,0,13
1500000US131150003001,131150003001,"Block Group 1, Census Tract 3, Floyd County, Georgia",937,163,876,160,61,60
1500000US131150003002,131150003002,"Block Group 2, Census Tract 3, Floyd County, Georgia",2051,413,1857,366,194,128
1500000US131150004001,131150004001,"Block Group 1, Census Tract 4, Floyd County, Georgia",1604,345,1488,311,116,222
1500000US131150004002,131150004002,"Block Group 2, Census Tract 4, Floyd County, Georgia",2423,648,1658,527,765,503
1500000US131150004003,131150004003,"Block Group 3, Census Tract 4, Floyd County, Georgia",1312,455,1312,455,0,13
1500000US131150004004,131150004004,"Block Group 4, Census Tract 4, Floyd County, Georgia",2178,755,1708,663,470,426
1500000US131150005001,131150005001,"Block Group 1, Census Tract 5, Floyd County, Georgia",758,216,758,216,0,13
1500000US131150005002,131150005002,"Block Group 2, Census Tract 5, Floyd County, Georgia",2007,552,1351,448,656,346
1500000US131150005003,131150005003,"Block Group 3, Census Tract 5, Floyd County, Georgia",1403,500,582,268,821,430
1500000US131150006001,131150006001,"Block Group 1, Census Tract 6, Floyd County, Georgia",1347,444,1237,413,110,114
1500000US131150006002,131150006002,"Block Group 2, Census Tract 6, Floyd County, Georgia",2306,385,2274,384,32,21
1500000US131150006003,131150006003,"Block Group 3, Census Tract 6, Floyd County, Georgia",1473,407,1396,384,77,116
1500000US131150007001,131150007001,"Block Group 1, Census Tract 7, Floyd County, Georgia",2111,385,2078,375,33,40
1500000US131150007002,131150007002,"Block Group 2, Census Tract 7, Floyd County, Georgia",2626,400,2615,401,11,19
1500000US131150008001,131150008001,"Block Group 1, Census Tract 8, Floyd County, Georgia",2358,371,2358,371,0,13
1500000US131150008002,131150008002,"Block Group 2, Census Tract 8, Floyd County, Georgia",2482,365,2473,362,9,19
1500000US131150009001,131150009001,"Block Group 1, Census Tract 9, Floyd County, Georgia",2505,322,2494,330,11,18
1500000US131150011001,131150011001,"Block Group 1, Census Tract 11, Floyd County, Georgia",1441,373,862,221,579,305
1500000US131150011002,131150011002,"Block Group 2, Census Tract 11, Floyd County, Georgia",779,141,779,141,0,13
1500000US131150011003,131150011003,"Block Group 3, Census Tract 11, Floyd County, Georgia",521,159,514,159,7,14
1500000US131150012001,131150012001,"Block Group 1, Census Tract 12, Floyd County, Georgia",893,331,448,149,445,338
1500000US131150012002,131150012002,"Block Group 2, Census Tract 12, Floyd County, Georgia",1909,443,1457,363,452,311
1500000US131150012003,131150012003,"Block Group 3, Census Tract 12, Floyd County, Georgia",1583,469,990,300,593,383
1500000US131150013001,131150013001,"Block Group 1, Census Tract 13, Floyd County, Georgia",2198,547,1488,362,710,564
1500000US131150013002,131150013002,"Block Group 2, Census Tract 13, Floyd County, Georgia",1897,622,1673,566,224,332
1500000US131150013003,131150013003,"Block Group 3, Census Tract 13, Floyd County, Georgia",1970,478,1599,450,371,255
1500000US131150014001,131150014001,"Block Group 1, Census Tract 14, Floyd County, Georgia",1927,644,1749,659,178,270
1500000US131150014002,131150014002,"Block Group 2, Census Tract 14, Floyd County, Georgia",2858,636,2858,636,0,13
1500000US131150014003,131150014003,"Block Group 3, Census Tract 14, Floyd County, Georgia",1871,484,1759,529,112,182
1500000US131150016001,131150016001,"Block Group 1, Census Tract 16, Floyd County, Georgia",1217,266,1159,252,58,93
1500000US131150016002,131150016002,"Block Group 2, Census Tract 16, Floyd County, Georgia",936,287,611,242,325,205
1500000US131150016003,131150016003,"Block Group 3, Census Tract 16, Floyd County, Georgia",1314,291,1276,280,38,95
1500000US131150017011,131150017011,"Block Group 1, Census Tract 17.01, Floyd County, Georgia",2586,625,2586,625,0,13
1500000US131150017012,131150017012,"Block Group 2, Census Tract 17.01, Floyd County, Georgia",2457,420,2352,428,105,124
1500000US131150017013,131150017013,"Block Group 3, Census Tract 17.01, Floyd County, Georgia",1341,355,1335,355,6,6
1500000US131150017021,131150017021,"Block Group 1, Census Tract 17.02, Floyd County, Georgia",1663,469,1663,469,0,13
1500000US131150017022,131150017022,"Block Group 2, Census Tract 17.02, Floyd County, Georgia",2440,584,2385,603,55,59
1500000US131150017023,131150017023,"Block Group 3, Census Tract 17.02, Floyd County, Georgia",1361,389,1310,389,51,82
1500000US131150017024,131150017024,"Block Group 4, Census Tract 17.02, Floyd County, Georgia",1023,416,1023,416,0,13
1500000US131150018001,131150018001,"Block Group 1, Census Tract 18, Floyd County, Georgia",1708,402,1660,397,48,62
1500000US131150018002,131150018002,"Block Group 2, Census Tract 18, Floyd County, Georgia",685,263,639,260,46,66
1500000US131150018003,131150018003,"Block Group 3, Census Tract 18, Floyd County, Georgia",2115,426,1976,415,139,172
1500000US131150020001,131150020001,"Block Group 1, Census Tract 20, Floyd County, Georgia",1764,259,1759,258,5,8
1500000US131150020002,131150020002,"Block Group 2, Census Tract 20, Floyd County, Georgia",1357,222,1357,222,0,13
1500000US131150020003,131150020003,"Block Group 3, Census Tract 20, Floyd County, Georgia",1003,224,1003,224,0,13
1500000US131150021001,131150021001,"Block Group 1, Census Tract 21, Floyd County, Georgia",1633,323,1633,323,0,13
1500000US131150021002,131150021002,"Block Group 2, Census Tract 21, Floyd County, Georgia",1665,453,1398,474,267,246
1500000US131150021003,131150021003,"Block Group 3, Census Tract 21, Floyd County, Georgia",1255,381,913,303,342,280
1500000US131171301011,131171301011,"Block Group 1, Census Tract 1301.01, Forsyth County, Georgia",2704,361,2594,384,110,124
1500000US131171301012,131171301012,"Block Group 2, Census Tract 1301.01, Forsyth County, Georgia",1393,430,1221,342,172,262
1500000US131171301021,131171301021,"Block Group 1, Census Tract 1301.02, Forsyth County, Georgia",2728,270,2719,271,9,13
1500000US131171301031,131171301031,"Block Group 1, Census Tract 1301.03, Forsyth County, Georgia",1439,440,1229,368,210,212
1500000US131171301032,131171301032,"Block Group 2, Census Tract 1301.03, Forsyth County, Georgia",1218,342,1218,342,0,13
1500000US131171301033,131171301033,"Block Group 3, Census Tract 1301.03, Forsyth County, Georgia",918,279,918,279,0,13
1500000US131171301041,131171301041,"Block Group 1, Census Tract 1301.04, Forsyth County, Georgia",1543,315,1511,310,32,52
1500000US131171301042,131171301042,"Block Group 2, Census Tract 1301.04, Forsyth County, Georgia",1512,339,1512,339,0,13
1500000US131171301043,131171301043,"Block Group 3, Census Tract 1301.04, Forsyth County, Georgia",915,261,880,229,35,50
1500000US131171301051,131171301051,"Block Group 1, Census Tract 1301.05, Forsyth County, Georgia",2571,374,2096,262,475,312
1500000US131171302011,131171302011,"Block Group 1, Census Tract 1302.01, Forsyth County, Georgia",1602,371,1596,374,6,12
1500000US131171302012,131171302012,"Block Group 2, Census Tract 1302.01, Forsyth County, Georgia",1642,445,1590,458,52,63
1500000US131171302013,131171302013,"Block Group 3, Census Tract 1302.01, Forsyth County, Georgia",1565,384,1449,375,116,135
1500000US131171302021,131171302021,"Block Group 1, Census Tract 1302.02, Forsyth County, Georgia",1380,304,1322,321,58,74
1500000US131171302022,131171302022,"Block Group 2, Census Tract 1302.02, Forsyth County, Georgia",673,211,673,211,0,13
1500000US131171302023,131171302023,"Block Group 3, Census Tract 1302.02, Forsyth County, Georgia",1794,476,1755,461,39,69
1500000US131171302031,131171302031,"Block Group 1, Census Tract 1302.03, Forsyth County, Georgia",2835,660,2397,497,438,511
1500000US131171302032,131171302032,"Block Group 2, Census Tract 1302.03, Forsyth County, Georgia",2657,429,2478,429,179,149
1500000US131171302041,131171302041,"Block Group 1, Census Tract 1302.04, Forsyth County, Georgia",2293,516,2154,486,139,181
1500000US131171302042,131171302042,"Block Group 2, Census Tract 1302.04, Forsyth County, Georgia",1988,437,1637,367,351,281
1500000US131171302051,131171302051,"Block Group 1, Census Tract 1302.05, Forsyth County, Georgia",1467,446,1065,382,402,276
1500000US131171302052,131171302052,"Block Group 2, Census Tract 1302.05, Forsyth County, Georgia",509,160,495,158,14,23
1500000US131171302053,131171302053,"Block Group 3, Census Tract 1302.05, Forsyth County, Georgia",556,291,395,115,161,262
1500000US131171303011,131171303011,"Block Group 1, Census Tract 1303.01, Forsyth County, Georgia",1993,405,1899,399,94,104
1500000US131171303012,131171303012,"Block Group 2, Census Tract 1303.01, Forsyth County, Georgia",3721,580,3237,472,484,488
1500000US131171303021,131171303021,"Block Group 1, Census Tract 1303.02, Forsyth County, Georgia",1101,356,1047,351,54,89
1500000US131171303022,131171303022,"Block Group 2, Census Tract 1303.02, Forsyth County, Georgia",2179,589,2088,600,91,100
1500000US131171303023,131171303023,"Block Group 3, Census Tract 1303.02, Forsyth County, Georgia",2270,459,2197,424,73,73
1500000US131171303031,131171303031,"Block Group 1, Census Tract 1303.03, Forsyth County, Georgia",2773,778,2092,430,681,657
1500000US131171303032,131171303032,"Block Group 2, Census Tract 1303.03, Forsyth County, Georgia",1413,328,1413,328,0,13
1500000US131171303041,131171303041,"Block Group 1, Census Tract 1303.04, Forsyth County, Georgia",1864,495,1852,494,12,18
1500000US131171303042,131171303042,"Block Group 2, Census Tract 1303.04, Forsyth County, Georgia",2657,411,1990,329,667,315
1500000US131171303051,131171303051,"Block Group 1, Census Tract 1303.05, Forsyth County, Georgia",905,281,830,243,75,118
1500000US131171303052,131171303052,"Block Group 2, Census Tract 1303.05, Forsyth County, Georgia",3095,567,2768,525,327,311
1500000US131171303053,131171303053,"Block Group 3, Census Tract 1303.05, Forsyth County, Georgia",1679,296,1632,298,47,61
1500000US131171303061,131171303061,"Block Group 1, Census Tract 1303.06, Forsyth County, Georgia",2798,509,2751,507,47,61
1500000US131171303062,131171303062,"Block Group 2, Census Tract 1303.06, Forsyth County, Georgia",1812,307,1721,302,91,83
1500000US131171303071,131171303071,"Block Group 1, Census Tract 1303.07, Forsyth County, Georgia",2509,449,2179,463,330,192
1500000US131171303072,131171303072,"Block Group 2, Census Tract 1303.07, Forsyth County, Georgia",1762,317,1762,317,0,13
1500000US131171304031,131171304031,"Block Group 1, Census Tract 1304.03, Forsyth County, Georgia",783,310,567,201,216,272
1500000US131171304032,131171304032,"Block Group 2, Census Tract 1304.03, Forsyth County, Georgia",1488,451,1244,374,244,236
1500000US131171304033,131171304033,"Block Group 3, Census Tract 1304.03, Forsyth County, Georgia",1136,391,1114,390,22,38
1500000US131171304034,131171304034,"Block Group 4, Census Tract 1304.03, Forsyth County, Georgia",2302,549,1694,415,608,608
1500000US131171304041,131171304041,"Block Group 1, Census Tract 1304.04, Forsyth County, Georgia",2074,409,1931,413,143,155
1500000US131171304042,131171304042,"Block Group 2, Census Tract 1304.04, Forsyth County, Georgia",2565,350,2423,381,142,109
1500000US131171304051,131171304051,"Block Group 1, Census Tract 1304.05, Forsyth County, Georgia",2153,608,2022,540,131,178
1500000US131171304052,131171304052,"Block Group 2, Census Tract 1304.05, Forsyth County, Georgia",1854,447,1786,445,68,78
1500000US131171304061,131171304061,"Block Group 1, Census Tract 1304.06, Forsyth County, Georgia",2165,458,1518,352,647,263
1500000US131171304062,131171304062,"Block Group 2, Census Tract 1304.06, Forsyth County, Georgia",2105,411,2056,403,49,114
1500000US131171304063,131171304063,"Block Group 3, Census Tract 1304.06, Forsyth County, Georgia",1242,348,1151,342,91,99
1500000US131171304081,131171304081,"Block Group 1, Census Tract 1304.08, Forsyth County, Georgia",2500,418,1775,261,725,439
1500000US131171304082,131171304082,"Block Group 2, Census Tract 1304.08, Forsyth County, Georgia",1303,359,892,207,411,321
1500000US131171304091,131171304091,"Block Group 1, Census Tract 1304.09, Forsyth County, Georgia",654,253,534,214,120,171
1500000US131171304092,131171304092,"Block Group 2, Census Tract 1304.09, Forsyth County, Georgia",1810,318,1392,225,418,241
1500000US131171304101,131171304101,"Block Group 1, Census Tract 1304.10, Forsyth County, Georgia",741,190,585,200,156,139
1500000US131171304102,131171304102,"Block Group 2, Census Tract 1304.10, Forsyth County, Georgia",1830,350,1094,255,736,354
1500000US131171304103,131171304103,"Block Group 3, Census Tract 1304.10, Forsyth County, Georgia",1664,358,1565,338,99,102
1500000US131171305031,131171305031,"Block Group 1, Census Tract 1305.03, Forsyth County, Georgia",1604,228,1604,228,0,13
1500000US131171305032,131171305032,"Block Group 2, Census Tract 1305.03, Forsyth County, Georgia",1113,244,1100,242,13,21
1500000US131171305041,131171305041,"Block Group 1, Census Tract 1305.04, Forsyth County, Georgia",1985,406,1746,452,239,226
1500000US131171305042,131171305042,"Block Group 2, Census Tract 1305.04, Forsyth County, Georgia",1755,392,1739,392,16,26
1500000US131171305051,131171305051,"Block Group 1, Census Tract 1305.05, Forsyth County, Georgia",1169,296,1097,268,72,104
1500000US131171305052,131171305052,"Block Group 2, Census Tract 1305.05, Forsyth County, Georgia",1469,248,1450,255,19,34
1500000US131171305061,131171305061,"Block Group 1, Census Tract 1305.06, Forsyth County, Georgia",1092,298,1014,296,78,116
1500000US131171305062,131171305062,"Block Group 2, Census Tract 1305.06, Forsyth County, Georgia",2380,293,2249,311,131,139
1500000US131171305071,131171305071,"Block Group 1, Census Tract 1305.07, Forsyth County, Georgia",873,220,820,209,53,90
1500000US131171305072,131171305072,"Block Group 2, Census Tract 1305.07, Forsyth County, Georgia",1442,409,1406,406,36,49
1500000US131171305081,131171305081,"Block Group 1, Census Tract 1305.08, Forsyth County, Georgia",2543,347,2365,320,178,140
1500000US131171305082,131171305082,"Block Group 2, Census Tract 1305.08, Forsyth County, Georgia",2687,413,2520,391,167,152
1500000US131171305091,131171305091,"Block Group 1, Census Tract 1305.09, Forsyth County, Georgia",1944,351,1575,290,369,186
1500000US131171305092,131171305092,"Block Group 2, Census Tract 1305.09, Forsyth County, Georgia",1442,359,1117,195,325,295
1500000US131171305101,131171305101,"Block Group 1, Census Tract 1305.10, Forsyth County, Georgia",2029,434,1797,376,232,203
1500000US131171305102,131171305102,"Block Group 2, Census Tract 1305.10, Forsyth County, Georgia",2332,465,2332,465,0,13
1500000US131171305103,131171305103,"Block Group 3, Census Tract 1305.10, Forsyth County, Georgia",2131,408,1744,338,387,236
1500000US131171306011,131171306011,"Block Group 1, Census Tract 1306.01, Forsyth County, Georgia",2605,606,2078,502,527,330
1500000US131171306012,131171306012,"Block Group 2, Census Tract 1306.01, Forsyth County, Georgia",762,346,684,331,78,117
1500000US131171306013,131171306013,"Block Group 3, Census Tract 1306.01, Forsyth County, Georgia",1379,377,1308,374,71,64
1500000US131171306021,131171306021,"Block Group 1, Census Tract 1306.02, Forsyth County, Georgia",2721,695,1484,392,1237,640
1500000US131171306022,131171306022,"Block Group 2, Census Tract 1306.02, Forsyth County, Georgia",2761,465,2246,292,515,378
1500000US131171306031,131171306031,"Block Group 1, Census Tract 1306.03, Forsyth County, Georgia",2890,418,2557,441,333,255
1500000US131171306032,131171306032,"Block Group 2, Census Tract 1306.03, Forsyth County, Georgia",1312,414,1028,290,284,296
1500000US131171306033,131171306033,"Block Group 3, Census Tract 1306.03, Forsyth County, Georgia",842,292,821,295,21,24
1500000US131171306041,131171306041,"Block Group 1, Census Tract 1306.04, Forsyth County, Georgia",2572,464,2446,452,126,155
1500000US131171306042,131171306042,"Block Group 2, Census Tract 1306.04, Forsyth County, Georgia",981,256,973,252,8,14
1500000US131171306043,131171306043,"Block Group 3, Census Tract 1306.04, Forsyth County, Georgia",1584,354,1352,326,232,254
1500000US131171306051,131171306051,"Block Group 1, Census Tract 1306.05, Forsyth County, Georgia",1326,336,1238,327,88,114
1500000US131171306052,131171306052,"Block Group 2, Census Tract 1306.05, Forsyth County, Georgia",2601,340,2491,339,110,91
1500000US131171306061,131171306061,"Block Group 1, Census Tract 1306.06, Forsyth County, Georgia",1790,298,1686,300,104,100
1500000US131171306062,131171306062,"Block Group 2, Census Tract 1306.06, Forsyth County, Georgia",2701,426,2552,473,149,120
1500000US131171306071,131171306071,"Block Group 1, Census Tract 1306.07, Forsyth County, Georgia",2210,321,2162,322,48,73
1500000US131171306072,131171306072,"Block Group 2, Census Tract 1306.07, Forsyth County, Georgia",662,154,620,146,42,53
1500000US131171306073,131171306073,"Block Group 3, Census Tract 1306.07, Forsyth County, Georgia",2694,418,2694,418,0,13
1500000US131171306081,131171306081,"Block Group 1, Census Tract 1306.08, Forsyth County, Georgia",2885,649,2785,635,100,143
1500000US131171306082,131171306082,"Block Group 2, Census Tract 1306.08, Forsyth County, Georgia",1881,384,1863,381,18,29
1500000US131171306083,131171306083,"Block Group 3, Census Tract 1306.08, Forsyth County, Georgia",813,275,772,283,41,55
1500000US131171306091,131171306091,"Block Group 1, Census Tract 1306.09, Forsyth County, Georgia",2954,443,2841,447,113,102
1500000US131171306092,131171306092,"Block Group 2, Census Tract 1306.09, Forsyth County, Georgia",1170,276,1102,275,68,106
1500000US131171306093,131171306093,"Block Group 3, Census Tract 1306.09, Forsyth County, Georgia",1274,402,1022,268,252,288
1500000US131171306101,131171306101,"Block Group 1, Census Tract 1306.10, Forsyth County, Georgia",1417,252,1384,248,33,55
1500000US131171306102,131171306102,"Block Group 2, Census Tract 1306.10, Forsyth County, Georgia",1801,401,1497,313,304,341
1500000US131171306103,131171306103,"Block Group 3, Census Tract 1306.10, Forsyth County, Georgia",1167,253,1131,251,36,52
1500000US131171306111,131171306111,"Block Group 1, Census Tract 1306.11, Forsyth County, Georgia",1334,377,1321,376,13,22
1500000US131171306112,131171306112,"Block Group 2, Census Tract 1306.11, Forsyth County, Georgia",2667,421,2531,421,136,122
1500000US131171306121,131171306121,"Block Group 1, Census Tract 1306.12, Forsyth County, Georgia",2065,460,1998,448,67,75
1500000US131171306122,131171306122,"Block Group 2, Census Tract 1306.12, Forsyth County, Georgia",845,246,845,246,0,13
1500000US131171306123,131171306123,"Block Group 3, Census Tract 1306.12, Forsyth County, Georgia",3666,455,3565,454,101,80
1500000US131171306131,131171306131,"Block Group 1, Census Tract 1306.13, Forsyth County, Georgia",1442,282,1346,263,96,100
1500000US131171306132,131171306132,"Block Group 2, Census Tract 1306.13, Forsyth County, Georgia",1670,306,1640,306,30,30
1500000US131198901011,131198901011,"Block Group 1, Census Tract 8901.01, Franklin County, Georgia",899,212,829,196,70,81
1500000US131198901012,131198901012,"Block Group 2, Census Tract 8901.01, Franklin County, Georgia",1141,239,1122,241,19,25
1500000US131198901013,131198901013,"Block Group 3, Census Tract 8901.01, Franklin County, Georgia",1807,333,1448,327,359,176
1500000US131198901021,131198901021,"Block Group 1, Census Tract 8901.02, Franklin County, Georgia",1152,293,1042,274,110,122
1500000US131198901022,131198901022,"Block Group 2, Census Tract 8901.02, Franklin County, Georgia",1172,439,1172,439,0,13
1500000US131198901023,131198901023,"Block Group 3, Census Tract 8901.02, Franklin County, Georgia",1795,399,1755,406,40,55
1500000US131198902001,131198902001,"Block Group 1, Census Tract 8902, Franklin County, Georgia",1758,497,1566,432,192,172
1500000US131198902002,131198902002,"Block Group 2, Census Tract 8902, Franklin County, Georgia",1567,502,1567,502,0,13
1500000US131198902003,131198902003,"Block Group 3, Census Tract 8902, Franklin County, Georgia",1336,330,1322,330,14,15
1500000US131198902004,131198902004,"Block Group 4, Census Tract 8902, Franklin County, Georgia",1060,392,1060,392,0,13
1500000US131198903001,131198903001,"Block Group 1, Census Tract 8903, Franklin County, Georgia",1706,400,1696,401,10,18
1500000US131198903002,131198903002,"Block Group 2, Census Tract 8903, Franklin County, Georgia",1473,302,1473,302,0,13
1500000US131198904001,131198904001,"Block Group 1, Census Tract 8904, Franklin County, Georgia",1035,216,1025,214,10,19
1500000US131198904002,131198904002,"Block Group 2, Census Tract 8904, Franklin County, Georgia",1003,312,1003,312,0,13
1500000US131198904003,131198904003,"Block Group 3, Census Tract 8904, Franklin County, Georgia",595,187,592,187,3,6
1500000US131198904004,131198904004,"Block Group 4, Census Tract 8904, Franklin County, Georgia",2611,385,2504,377,107,72
1500000US131210001001,131210001001,"Block Group 1, Census Tract 1, Fulton County, Georgia",1068,237,1066,237,2,4
1500000US131210001002,131210001002,"Block Group 2, Census Tract 1, Fulton County, Georgia",637,172,615,169,22,36
1500000US131210001003,131210001003,"Block Group 3, Census Tract 1, Fulton County, Georgia",1795,248,1676,245,119,83
1500000US131210001004,131210001004,"Block Group 4, Census Tract 1, Fulton County, Georgia",1150,269,1106,269,44,56
1500000US131210002001,131210002001,"Block Group 1, Census Tract 2, Fulton County, Georgia",1475,303,1466,302,9,15
1500000US131210002002,131210002002,"Block Group 2, Census Tract 2, Fulton County, Georgia",1473,262,1401,226,72,60
1500000US131210002003,131210002003,"Block Group 3, Census Tract 2, Fulton County, Georgia",1129,230,1101,231,28,42
1500000US131210002004,131210002004,"Block Group 4, Census Tract 2, Fulton County, Georgia",934,257,858,226,76,121
1500000US131210002005,131210002005,"Block Group 5, Census Tract 2, Fulton County, Georgia",1267,281,1199,281,68,62
1500000US131210004001,131210004001,"Block Group 1, Census Tract 4, Fulton County, Georgia",592,188,551,186,41,28
1500000US131210004002,131210004002,"Block Group 2, Census Tract 4, Fulton County, Georgia",1000,200,1000,200,0,13
1500000US131210005001,131210005001,"Block Group 1, Census Tract 5, Fulton County, Georgia",3480,635,3322,617,158,104
1500000US131210005002,131210005002,"Block Group 2, Census Tract 5, Fulton County, Georgia",1060,358,1060,358,0,13
1500000US131210005003,131210005003,"Block Group 3, Census Tract 5, Fulton County, Georgia",931,342,911,333,20,27
1500000US131210006001,131210006001,"Block Group 1, Census Tract 6, Fulton County, Georgia",5906,689,5447,729,459,259
1500000US131210007001,131210007001,"Block Group 1, Census Tract 7, Fulton County, Georgia",2086,195,1996,180,90,35
1500000US131210007002,131210007002,"Block Group 2, Census Tract 7, Fulton County, Georgia",848,126,803,112,45,45
1500000US131210010011,131210010011,"Block Group 1, Census Tract 10.01, Fulton County, Georgia",1716,566,1631,540,85,66
1500000US131210010012,131210010012,"Block Group 2, Census Tract 10.01, Fulton County, Georgia",961,112,905,116,56,41
1500000US131210010021,131210010021,"Block Group 1, Census Tract 10.02, Fulton County, Georgia",7230,537,6778,517,452,108
1500000US131210011001,131210011001,"Block Group 1, Census Tract 11, Fulton County, Georgia",1021,201,1001,197,20,27
1500000US131210011002,131210011002,"Block Group 2, Census Tract 11, Fulton County, Georgia",918,181,890,175,28,44
1500000US131210011003,131210011003,"Block Group 3, Census Tract 11, Fulton County, Georgia",2306,321,2214,333,92,61
1500000US131210012011,131210012011,"Block Group 1, Census Tract 12.01, Fulton County, Georgia",1780,287,1714,286,66,70
1500000US131210012012,131210012012,"Block Group 2, Census Tract 12.01, Fulton County, Georgia",2123,466,1898,414,225,156
1500000US131210012021,131210012021,"Block Group 1, Census Tract 12.02, Fulton County, Georgia",2456,406,2318,360,138,94
1500000US131210012022,131210012022,"Block Group 2, Census Tract 12.02, Fulton County, Georgia",1442,337,1410,343,32,38
1500000US131210013001,131210013001,"Block Group 1, Census Tract 13, Fulton County, Georgia",2299,442,2119,441,180,176
1500000US131210013002,131210013002,"Block Group 2, Census Tract 13, Fulton County, Georgia",1062,283,983,284,79,51
1500000US131210013003,131210013003,"Block Group 3, Census Tract 13, Fulton County, Georgia",1168,245,1065,252,103,88
1500000US131210014001,131210014001,"Block Group 1, Census Tract 14, Fulton County, Georgia",1411,217,1367,221,44,46
1500000US131210014002,131210014002,"Block Group 2, Census Tract 14, Fulton County, Georgia",826,220,800,222,26,21
1500000US131210015001,131210015001,"Block Group 1, Census Tract 15, Fulton County, Georgia",1384,374,1360,375,24,29
1500000US131210015002,131210015002,"Block Group 2, Census Tract 15, Fulton County, Georgia",1308,378,1088,255,220,308
1500000US131210015003,131210015003,"Block Group 3, Census Tract 15, Fulton County, Georgia",774,213,714,213,60,61
1500000US131210015004,131210015004,"Block Group 4, Census Tract 15, Fulton County, Georgia",900,270,878,265,22,27
1500000US131210016001,131210016001,"Block Group 1, Census Tract 16, Fulton County, Georgia",2090,267,2029,248,61,83
1500000US131210017001,131210017001,"Block Group 1, Census Tract 17, Fulton County, Georgia",2620,428,2492,445,128,76
1500000US131210017002,131210017002,"Block Group 2, Census Tract 17, Fulton County, Georgia",1111,249,1050,239,61,66
1500000US131210018001,131210018001,"Block Group 1, Census Tract 18, Fulton County, Georgia",2684,479,2604,471,80,53
1500000US131210018002,131210018002,"Block Group 2, Census Tract 18, Fulton County, Georgia",763,305,752,305,11,17
1500000US131210018003,131210018003,"Block Group 3, Census Tract 18, Fulton County, Georgia",1082,268,1058,271,24,28
1500000US131210019001,131210019001,"Block Group 1, Census Tract 19, Fulton County, Georgia",2837,256,2645,263,192,64
1500000US131210019002,131210019002,"Block Group 2, Census Tract 19, Fulton County, Georgia",2140,405,2063,402,77,64
1500000US131210021001,131210021001,"Block Group 1, Census Tract 21, Fulton County, Georgia",2785,505,2762,504,23,22
1500000US131210023001,131210023001,"Block Group 1, Census Tract 23, Fulton County, Georgia",335,163,335,163,0,13
1500000US131210023002,131210023002,"Block Group 2, Census Tract 23, Fulton County, Georgia",462,192,462,192,0,13
1500000US131210023003,131210023003,"Block Group 3, Census Tract 23, Fulton County, Georgia",447,142,447,142,0,13
1500000US131210024001,131210024001,"Block Group 1, Census Tract 24, Fulton County, Georgia",1432,371,1427,373,5,7
1500000US131210024002,131210024002,"Block Group 2, Census Tract 24, Fulton County, Georgia",1072,247,1072,247,0,13
1500000US131210025001,131210025001,"Block Group 1, Census Tract 25, Fulton County, Georgia",1596,272,1569,262,27,29
1500000US131210025002,131210025002,"Block Group 2, Census Tract 25, Fulton County, Georgia",609,212,592,217,17,22
1500000US131210026001,131210026001,"Block Group 1, Census Tract 26, Fulton County, Georgia",1229,179,1121,210,108,68
1500000US131210028001,131210028001,"Block Group 1, Census Tract 28, Fulton County, Georgia",4148,370,3777,366,371,92
1500000US131210028002,131210028002,"Block Group 2, Census Tract 28, Fulton County, Georgia",506,252,484,249,22,26
1500000US131210029001,131210029001,"Block Group 1, Census Tract 29, Fulton County, Georgia",2578,310,2481,304,97,59
1500000US131210030001,131210030001,"Block Group 1, Census Tract 30, Fulton County, Georgia",1472,214,1429,216,43,31
1500000US131210030002,131210030002,"Block Group 2, Census Tract 30, Fulton County, Georgia",1605,296,1425,254,180,127
1500000US131210031001,131210031001,"Block Group 1, Census Tract 31, Fulton County, Georgia",971,160,948,159,23,23
1500000US131210031002,131210031002,"Block Group 2, Census Tract 31, Fulton County, Georgia",916,203,906,202,10,15
1500000US131210032001,131210032001,"Block Group 1, Census Tract 32, Fulton County, Georgia",2150,196,1989,163,161,142
1500000US131210035001,131210035001,"Block Group 1, Census Tract 35, Fulton County, Georgia",671,166,654,166,17,22
1500000US131210035002,131210035002,"Block Group 2, Census Tract 35, Fulton County, Georgia",1436,313,1352,284,84,62
1500000US131210036001,131210036001,"Block Group 1, Census Tract 36, Fulton County, Georgia",1453,292,1408,299,45,33
1500000US131210037001,131210037001,"Block Group 1, Census Tract 37, Fulton County, Georgia",54,41,54,41,0,13
1500000US131210038001,131210038001,"Block Group 1, Census Tract 38, Fulton County, Georgia",3872,412,3630,410,242,80
1500000US131210039001,131210039001,"Block Group 1, Census Tract 39, Fulton County, Georgia",1172,296,1172,296,0,13
1500000US131210039002,131210039002,"Block Group 2, Census Tract 39, Fulton County, Georgia",768,331,768,331,0,13
1500000US131210040001,131210040001,"Block Group 1, Census Tract 40, Fulton County, Georgia",1148,303,1148,303,0,13
1500000US131210040002,131210040002,"Block Group 2, Census Tract 40, Fulton County, Georgia",635,222,635,222,0,13
1500000US131210040003,131210040003,"Block Group 3, Census Tract 40, Fulton County, Georgia",625,197,625,197,0,13
1500000US131210041001,131210041001,"Block Group 1, Census Tract 41, Fulton County, Georgia",503,262,503,262,0,13
1500000US131210041002,131210041002,"Block Group 2, Census Tract 41, Fulton County, Georgia",904,408,904,408,0,13
1500000US131210041003,131210041003,"Block Group 3, Census Tract 41, Fulton County, Georgia",499,167,477,165,22,24
1500000US131210042001,131210042001,"Block Group 1, Census Tract 42, Fulton County, Georgia",414,99,414,99,0,13
1500000US131210042002,131210042002,"Block Group 2, Census Tract 42, Fulton County, Georgia",1813,299,1795,300,18,21
1500000US131210043001,131210043001,"Block Group 1, Census Tract 43, Fulton County, Georgia",1593,190,1480,201,113,50
1500000US131210043002,131210043002,"Block Group 2, Census Tract 43, Fulton County, Georgia",1181,180,1128,174,53,42
1500000US131210044001,131210044001,"Block Group 1, Census Tract 44, Fulton County, Georgia",2509,474,2461,467,48,72
1500000US131210048001,131210048001,"Block Group 1, Census Tract 48, Fulton County, Georgia",1048,154,989,161,59,49
1500000US131210049001,131210049001,"Block Group 1, Census Tract 49, Fulton County, Georgia",1494,332,1421,343,73,82
1500000US131210049002,131210049002,"Block Group 2, Census Tract 49, Fulton County, Georgia",1397,215,1283,211,114,91
1500000US131210050001,131210050001,"Block Group 1, Census Tract 50, Fulton County, Georgia",2065,178,1946,174,119,52
1500000US131210052001,131210052001,"Block Group 1, Census Tract 52, Fulton County, Georgia",931,228,866,223,65,62
1500000US131210052002,131210052002,"Block Group 2, Census Tract 52, Fulton County, Georgia",1262,286,1105,289,157,195
1500000US131210052003,131210052003,"Block Group 3, Census Tract 52, Fulton County, Georgia",2988,453,2799,430,189,154
1500000US131210053001,131210053001,"Block Group 1, Census Tract 53, Fulton County, Georgia",1730,245,1714,249,16,26
1500000US131210053002,131210053002,"Block Group 2, Census Tract 53, Fulton County, Georgia",1285,331,1255,336,30,37
1500000US131210053003,131210053003,"Block Group 3, Census Tract 53, Fulton County, Georgia",688,198,629,204,59,48
1500000US131210055011,131210055011,"Block Group 1, Census Tract 55.01, Fulton County, Georgia",1050,260,1002,251,48,53
1500000US131210055012,131210055012,"Block Group 2, Census Tract 55.01, Fulton County, Georgia",1483,289,1403,285,80,64
1500000US131210055021,131210055021,"Block Group 1, Census Tract 55.02, Fulton County, Georgia",2422,337,2393,334,29,39
1500000US131210057001,131210057001,"Block Group 1, Census Tract 57, Fulton County, Georgia",1655,239,1627,237,28,22
1500000US131210058001,131210058001,"Block Group 1, Census Tract 58, Fulton County, Georgia",2023,273,2010,276,13,16
1500000US131210060001,131210060001,"Block Group 1, Census Tract 60, Fulton County, Georgia",600,255,600,255,0,13
1500000US131210060002,131210060002,"Block Group 2, Census Tract 60, Fulton County, Georgia",1139,327,1139,327,0,13
1500000US131210060003,131210060003,"Block Group 3, Census Tract 60, Fulton County, Georgia",785,285,614,157,171,260
1500000US131210060004,131210060004,"Block Group 4, Census Tract 60, Fulton County, Georgia",736,244,712,237,24,41
1500000US131210061001,131210061001,"Block Group 1, Census Tract 61, Fulton County, Georgia",580,219,580,219,0,13
1500000US131210061002,131210061002,"Block Group 2, Census Tract 61, Fulton County, Georgia",1295,329,1244,308,51,80
1500000US131210061003,131210061003,"Block Group 3, Census Tract 61, Fulton County, Georgia",730,205,722,205,8,12
1500000US131210061004,131210061004,"Block Group 4, Census Tract 61, Fulton County, Georgia",1067,329,1067,329,0,13
1500000US131210062001,131210062001,"Block Group 1, Census Tract 62, Fulton County, Georgia",943,194,927,193,16,24
1500000US131210062002,131210062002,"Block Group 2, Census Tract 62, Fulton County, Georgia",532,162,532,162,0,13
1500000US131210063001,131210063001,"Block Group 1, Census Tract 63, Fulton County, Georgia",1079,232,1079,232,0,13
1500000US131210063002,131210063002,"Block Group 2, Census Tract 63, Fulton County, Georgia",571,231,571,231,0,13
1500000US131210064001,131210064001,"Block Group 1, Census Tract 64, Fulton County, Georgia",1175,164,797,157,378,158
1500000US131210065001,131210065001,"Block Group 1, Census Tract 65, Fulton County, Georgia",683,233,683,233,0,13
1500000US131210065002,131210065002,"Block Group 2, Census Tract 65, Fulton County, Georgia",1683,432,1579,420,104,124
1500000US131210065003,131210065003,"Block Group 3, Census Tract 65, Fulton County, Georgia",605,241,576,247,29,45
1500000US131210065004,131210065004,"Block Group 4, Census Tract 65, Fulton County, Georgia",1312,601,1289,602,23,35
1500000US131210066011,131210066011,"Block Group 1, Census Tract 66.01, Fulton County, Georgia",853,238,852,238,1,3
1500000US131210066012,131210066012,"Block Group 2, Census Tract 66.01, Fulton County, Georgia",1364,333,1321,344,43,34
1500000US131210066021,131210066021,"Block Group 1, Census Tract 66.02, Fulton County, Georgia",1369,212,1349,214,20,29
1500000US131210067001,131210067001,"Block Group 1, Census Tract 67, Fulton County, Georgia",833,438,833,438,0,13
1500000US131210067002,131210067002,"Block Group 2, Census Tract 67, Fulton County, Georgia",1560,419,1507,421,53,64
1500000US131210067003,131210067003,"Block Group 3, Census Tract 67, Fulton County, Georgia",1348,377,1335,378,13,19
1500000US131210068011,131210068011,"Block Group 1, Census Tract 68.01, Fulton County, Georgia",2382,298,1943,261,439,130
1500000US131210068021,131210068021,"Block Group 1, Census Tract 68.02, Fulton County, Georgia",1992,284,1992,284,0,13
1500000US131210069001,131210069001,"Block Group 1, Census Tract 69, Fulton County, Georgia",974,264,952,267,22,23
1500000US131210069002,131210069002,"Block Group 2, Census Tract 69, Fulton County, Georgia",1335,352,1065,359,270,205
1500000US131210069003,131210069003,"Block Group 3, Census Tract 69, Fulton County, Georgia",1242,238,911,187,331,136
1500000US131210070011,131210070011,"Block Group 1, Census Tract 70.01, Fulton County, Georgia",2406,596,2406,596,0,13
1500000US131210070012,131210070012,"Block Group 2, Census Tract 70.01, Fulton County, Georgia",1168,444,1132,425,36,51
1500000US131210070013,131210070013,"Block Group 3, Census Tract 70.01, Fulton County, Georgia",1190,393,1190,393,0,13
1500000US131210070021,131210070021,"Block Group 1, Census Tract 70.02, Fulton County, Georgia",860,297,845,298,15,23
1500000US131210070022,131210070022,"Block Group 2, Census Tract 70.02, Fulton County, Georgia",429,241,288,178,141,153
1500000US131210070023,131210070023,"Block Group 3, Census Tract 70.02, Fulton County, Georgia",297,131,297,131,0,13
1500000US131210070024,131210070024,"Block Group 4, Census Tract 70.02, Fulton County, Georgia",302,214,289,199,13,21
1500000US131210071001,131210071001,"Block Group 1, Census Tract 71, Fulton County, Georgia",868,224,858,221,10,15
1500000US131210071002,131210071002,"Block Group 2, Census Tract 71, Fulton County, Georgia",1151,294,1143,293,8,14
1500000US131210072001,131210072001,"Block Group 1, Census Tract 72, Fulton County, Georgia",1687,322,1672,325,15,21
1500000US131210072002,131210072002,"Block Group 2, Census Tract 72, Fulton County, Georgia",342,144,342,144,0,13
1500000US131210073001,131210073001,"Block Group 1, Census Tract 73, Fulton County, Georgia",2642,724,2589,714,53,75
1500000US131210073002,131210073002,"Block Group 2, Census Tract 73, Fulton County, Georgia",3397,737,3397,737,0,13
1500000US131210073003,131210073003,"Block Group 3, Census Tract 73, Fulton County, Georgia",1913,590,1913,590,0,13
1500000US131210074001,131210074001,"Block Group 1, Census Tract 74, Fulton County, Georgia",1409,435,1050,312,359,344
1500000US131210074002,131210074002,"Block Group 2, Census Tract 74, Fulton County, Georgia",1616,377,1487,367,129,120
1500000US131210075001,131210075001,"Block Group 1, Census Tract 75, Fulton County, Georgia",1087,279,1049,271,38,41
1500000US131210075002,131210075002,"Block Group 2, Census Tract 75, Fulton County, Georgia",511,232,511,232,0,13
1500000US131210075003,131210075003,"Block Group 3, Census Tract 75, Fulton County, Georgia",846,164,809,161,37,57
1500000US131210075004,131210075004,"Block Group 4, Census Tract 75, Fulton County, Georgia",815,248,805,242,10,16
1500000US131210076021,131210076021,"Block Group 1, Census Tract 76.02, Fulton County, Georgia",612,172,612,172,0,13
1500000US131210076022,131210076022,"Block Group 2, Census Tract 76.02, Fulton County, Georgia",903,225,891,225,12,19
1500000US131210076023,131210076023,"Block Group 3, Census Tract 76.02, Fulton County, Georgia",1055,255,1005,240,50,80
1500000US131210076031,131210076031,"Block Group 1, Census Tract 76.03, Fulton County, Georgia",1553,474,1553,474,0,13
1500000US131210076032,131210076032,"Block Group 2, Census Tract 76.03, Fulton County, Georgia",1630,409,1630,409,0,13
1500000US131210076033,131210076033,"Block Group 3, Census Tract 76.03, Fulton County, Georgia",1332,402,1287,396,45,58
1500000US131210076041,131210076041,"Block Group 1, Census Tract 76.04, Fulton County, Georgia",2331,490,2331,490,0,13
1500000US131210077031,131210077031,"Block Group 1, Census Tract 77.03, Fulton County, Georgia",1071,376,1071,376,0,13
1500000US131210077032,131210077032,"Block Group 2, Census Tract 77.03, Fulton County, Georgia",1740,458,1740,458,0,13
1500000US131210077033,131210077033,"Block Group 3, Census Tract 77.03, Fulton County, Georgia",1341,345,1341,345,0,13
1500000US131210077041,131210077041,"Block Group 1, Census Tract 77.04, Fulton County, Georgia",817,310,817,310,0,13
1500000US131210077042,131210077042,"Block Group 2, Census Tract 77.04, Fulton County, Georgia",2156,434,1830,416,326,224
1500000US131210077043,131210077043,"Block Group 3, Census Tract 77.04, Fulton County, Georgia",2344,422,2337,423,7,11
1500000US131210077051,131210077051,"Block Group 1, Census Tract 77.05, Fulton County, Georgia",2517,696,2487,698,30,40
1500000US131210077052,131210077052,"Block Group 2, Census Tract 77.05, Fulton County, Georgia",2504,539,2473,542,31,37
1500000US131210077061,131210077061,"Block Group 1, Census Tract 77.06, Fulton County, Georgia",2820,946,2820,946,0,13
1500000US131210077062,131210077062,"Block Group 2, Census Tract 77.06, Fulton County, Georgia",2248,561,2240,562,8,13
1500000US131210077063,131210077063,"Block Group 3, Census Tract 77.06, Fulton County, Georgia",4422,970,4305,964,117,155
1500000US131210078021,131210078021,"Block Group 1, Census Tract 78.02, Fulton County, Georgia",4140,877,4051,898,89,144
1500000US131210078022,131210078022,"Block Group 2, Census Tract 78.02, Fulton County, Georgia",2852,734,2852,734,0,13
1500000US131210078023,131210078023,"Block Group 3, Census Tract 78.02, Fulton County, Georgia",1207,595,1207,595,0,13
1500000US131210078024,131210078024,"Block Group 4, Census Tract 78.02, Fulton County, Georgia",1815,618,1797,626,18,27
1500000US131210078051,131210078051,"Block Group 1, Census Tract 78.05, Fulton County, Georgia",1381,617,1366,615,15,15
1500000US131210078052,131210078052,"Block Group 2, Census Tract 78.05, Fulton County, Georgia",1763,379,1757,379,6,10
1500000US131210078061,131210078061,"Block Group 1, Census Tract 78.06, Fulton County, Georgia",1676,535,1549,556,127,188
1500000US131210078062,131210078062,"Block Group 2, Census Tract 78.06, Fulton County, Georgia",3863,799,3863,799,0,13
1500000US131210078063,131210078063,"Block Group 3, Census Tract 78.06, Fulton County, Georgia",1055,388,917,351,138,159
1500000US131210078071,131210078071,"Block Group 1, Census Tract 78.07, Fulton County, Georgia",2537,694,2075,677,462,385
1500000US131210078072,131210078072,"Block Group 2, Census Tract 78.07, Fulton County, Georgia",666,210,666,210,0,13
1500000US131210078081,131210078081,"Block Group 1, Census Tract 78.08, Fulton County, Georgia",1900,392,1768,397,132,163
1500000US131210078082,131210078082,"Block Group 2, Census Tract 78.08, Fulton County, Georgia",2587,481,2380,426,207,220
1500000US131210079001,131210079001,"Block Group 1, Census Tract 79, Fulton County, Georgia",1819,538,1819,538,0,13
1500000US131210079002,131210079002,"Block Group 2, Census Tract 79, Fulton County, Georgia",1231,379,1231,379,0,13
1500000US131210079003,131210079003,"Block Group 3, Census Tract 79, Fulton County, Georgia",2751,685,2751,685,0,13
1500000US131210080001,131210080001,"Block Group 1, Census Tract 80, Fulton County, Georgia",1064,395,1064,395,0,13
1500000US131210080002,131210080002,"Block Group 2, Census Tract 80, Fulton County, Georgia",1205,354,1205,354,0,13
1500000US131210080003,131210080003,"Block Group 3, Census Tract 80, Fulton County, Georgia",496,178,496,178,0,13
1500000US131210080004,131210080004,"Block Group 4, Census Tract 80, Fulton County, Georgia",1255,406,1246,408,9,14
1500000US131210080005,131210080005,"Block Group 5, Census Tract 80, Fulton County, Georgia",1402,315,1350,307,52,67
1500000US131210081011,131210081011,"Block Group 1, Census Tract 81.01, Fulton County, Georgia",1138,148,1138,148,0,13
1500000US131210081021,131210081021,"Block Group 1, Census Tract 81.02, Fulton County, Georgia",1278,508,1278,508,0,13
1500000US131210081022,131210081022,"Block Group 2, Census Tract 81.02, Fulton County, Georgia",940,516,930,516,10,16
1500000US131210081023,131210081023,"Block Group 3, Census Tract 81.02, Fulton County, Georgia",2160,885,1671,745,489,520
1500000US131210081024,131210081024,"Block Group 4, Census Tract 81.02, Fulton County, Georgia",2653,800,2346,693,307,485
1500000US131210082011,131210082011,"Block Group 1, Census Tract 82.01, Fulton County, Georgia",1951,499,1900,488,51,65
1500000US131210082012,131210082012,"Block Group 2, Census Tract 82.01, Fulton County, Georgia",3083,741,3046,742,37,135
1500000US131210082013,131210082013,"Block Group 3, Census Tract 82.01, Fulton County, Georgia",965,457,965,457,0,13
1500000US131210082021,131210082021,"Block Group 1, Census Tract 82.02, Fulton County, Georgia",948,223,933,214,15,25
1500000US131210082022,131210082022,"Block Group 2, Census Tract 82.02, Fulton County, Georgia",836,188,830,188,6,9
1500000US131210082023,131210082023,"Block Group 3, Census Tract 82.02, Fulton County, Georgia",264,113,264,113,0,13
1500000US131210082024,131210082024,"Block Group 4, Census Tract 82.02, Fulton County, Georgia",0,13,0,13,0,13
1500000US131210083011,131210083011,"Block Group 1, Census Tract 83.01, Fulton County, Georgia",1691,364,1688,364,3,6
1500000US131210083012,131210083012,"Block Group 2, Census Tract 83.01, Fulton County, Georgia",604,271,604,271,0,13
1500000US131210083021,131210083021,"Block Group 1, Census Tract 83.02, Fulton County, Georgia",793,181,786,181,7,10
1500000US131210083022,131210083022,"Block Group 2, Census Tract 83.02, Fulton County, Georgia",1148,200,1148,200,0,13
1500000US131210084001,131210084001,"Block Group 1, Census Tract 84, Fulton County, Georgia",1472,491,1462,487,10,17
1500000US131210084002,131210084002,"Block Group 2, Census Tract 84, Fulton County, Georgia",883,298,883,298,0,13
1500000US131210084003,131210084003,"Block Group 3, Census Tract 84, Fulton County, Georgia",963,288,934,274,29,33
1500000US131210085001,131210085001,"Block Group 1, Census Tract 85, Fulton County, Georgia",565,257,565,257,0,13
1500000US131210085002,131210085002,"Block Group 2, Census Tract 85, Fulton County, Georgia",1248,540,1248,540,0,13
1500000US131210085003,131210085003,"Block Group 3, Census Tract 85, Fulton County, Georgia",1222,345,1222,345,0,13
1500000US131210086011,131210086011,"Block Group 1, Census Tract 86.01, Fulton County, Georgia",1663,389,1663,389,0,13
1500000US131210086012,131210086012,"Block Group 2, Census Tract 86.01, Fulton County, Georgia",1001,344,1001,344,0,13
1500000US131210086013,131210086013,"Block Group 3, Census Tract 86.01, Fulton County, Georgia",1414,339,1379,336,35,52
1500000US131210086014,131210086014,"Block Group 4, Census Tract 86.01, Fulton County, Georgia",348,109,348,109,0,13
1500000US131210086021,131210086021,"Block Group 1, Census Tract 86.02, Fulton County, Georgia",803,204,792,205,11,18
1500000US131210086022,131210086022,"Block Group 2, Census Tract 86.02, Fulton County, Georgia",260,122,260,122,0,13
1500000US131210087001,131210087001,"Block Group 1, Census Tract 87, Fulton County, Georgia",1009,337,1000,336,9,13
1500000US131210087002,131210087002,"Block Group 2, Census Tract 87, Fulton County, Georgia",818,310,818,310,0,13
1500000US131210087003,131210087003,"Block Group 3, Census Tract 87, Fulton County, Georgia",969,246,969,246,0,13
1500000US131210087004,131210087004,"Block Group 4, Census Tract 87, Fulton County, Georgia",1568,339,1551,336,17,22
1500000US131210088001,131210088001,"Block Group 1, Census Tract 88, Fulton County, Georgia",2944,388,2413,410,531,431
1500000US131210088002,131210088002,"Block Group 2, Census Tract 88, Fulton County, Georgia",1625,420,1602,420,23,29
1500000US131210089021,131210089021,"Block Group 1, Census Tract 89.02, Fulton County, Georgia",1876,445,1876,445,0,13
1500000US131210089022,131210089022,"Block Group 2, Census Tract 89.02, Fulton County, Georgia",659,228,613,218,46,54
1500000US131210089023,131210089023,"Block Group 3, Census Tract 89.02, Fulton County, Georgia",1280,352,1177,340,103,106
1500000US131210089024,131210089024,"Block Group 4, Census Tract 89.02, Fulton County, Georgia",2722,504,2423,518,299,156
1500000US131210089031,131210089031,"Block Group 1, Census Tract 89.03, Fulton County, Georgia",1684,401,964,211,720,390
1500000US131210089041,131210089041,"Block Group 1, Census Tract 89.04, Fulton County, Georgia",1323,222,1237,207,86,89
1500000US131210089042,131210089042,"Block Group 2, Census Tract 89.04, Fulton County, Georgia",1638,389,1497,341,141,183
1500000US131210089043,131210089043,"Block Group 3, Census Tract 89.04, Fulton County, Georgia",1611,298,1561,287,50,79
1500000US131210090001,131210090001,"Block Group 1, Census Tract 90, Fulton County, Georgia",1350,219,1320,215,30,40
1500000US131210090002,131210090002,"Block Group 2, Census Tract 90, Fulton County, Georgia",1769,263,1700,271,69,49
1500000US131210090003,131210090003,"Block Group 3, Census Tract 90, Fulton County, Georgia",1829,262,1660,248,169,150
1500000US131210091011,131210091011,"Block Group 1, Census Tract 91.01, Fulton County, Georgia",1369,300,1369,300,0,13
1500000US131210091012,131210091012,"Block Group 2, Census Tract 91.01, Fulton County, Georgia",1565,367,1565,367,0,13
1500000US131210091013,131210091013,"Block Group 3, Census Tract 91.01, Fulton County, Georgia",627,369,627,369,0,13
1500000US131210091014,131210091014,"Block Group 4, Census Tract 91.01, Fulton County, Georgia",1001,221,982,223,19,31
1500000US131210091021,131210091021,"Block Group 1, Census Tract 91.02, Fulton County, Georgia",443,171,443,171,0,13
1500000US131210091022,131210091022,"Block Group 2, Census Tract 91.02, Fulton County, Georgia",963,274,861,260,102,98
1500000US131210091023,131210091023,"Block Group 3, Census Tract 91.02, Fulton County, Georgia",1840,277,1787,280,53,66
1500000US131210092001,131210092001,"Block Group 1, Census Tract 92, Fulton County, Georgia",2404,338,2380,331,24,28
1500000US131210092002,131210092002,"Block Group 2, Census Tract 92, Fulton County, Georgia",2976,748,1360,447,1616,622
1500000US131210092003,131210092003,"Block Group 3, Census Tract 92, Fulton County, Georgia",1703,332,1601,319,102,93
1500000US131210093001,131210093001,"Block Group 1, Census Tract 93, Fulton County, Georgia",1079,298,1079,298,0,13
1500000US131210093002,131210093002,"Block Group 2, Census Tract 93, Fulton County, Georgia",1319,371,1145,271,174,277
1500000US131210093003,131210093003,"Block Group 3, Census Tract 93, Fulton County, Georgia",1510,300,1348,275,162,169
1500000US131210093004,131210093004,"Block Group 4, Census Tract 93, Fulton County, Georgia",750,214,717,215,33,52
1500000US131210094021,131210094021,"Block Group 1, Census Tract 94.02, Fulton County, Georgia",2795,305,2562,297,233,114
1500000US131210094022,131210094022,"Block Group 2, Census Tract 94.02, Fulton County, Georgia",2227,461,1102,219,1125,471
1500000US131210094031,131210094031,"Block Group 1, Census Tract 94.03, Fulton County, Georgia",2448,610,2031,604,417,285
1500000US131210094032,131210094032,"Block Group 2, Census Tract 94.03, Fulton County, Georgia",1245,363,1208,365,37,47
1500000US131210094033,131210094033,"Block Group 3, Census Tract 94.03, Fulton County, Georgia",1279,400,973,350,306,311
1500000US131210094041,131210094041,"Block Group 1, Census Tract 94.04, Fulton County, Georgia",2515,439,2227,435,288,229
1500000US131210094042,131210094042,"Block Group 2, Census Tract 94.04, Fulton County, Georgia",1995,430,1906,449,89,95
1500000US131210094043,131210094043,"Block Group 3, Census Tract 94.04, Fulton County, Georgia",311,191,227,123,84,134
1500000US131210095011,131210095011,"Block Group 1, Census Tract 95.01, Fulton County, Georgia",470,204,470,204,0,13
1500000US131210095012,131210095012,"Block Group 2, Census Tract 95.01, Fulton County, Georgia",1736,301,1721,300,15,22
1500000US131210095013,131210095013,"Block Group 3, Census Tract 95.01, Fulton County, Georgia",1588,269,1588,269,0,13
1500000US131210095021,131210095021,"Block Group 1, Census Tract 95.02, Fulton County, Georgia",490,219,490,219,0,13
1500000US131210095022,131210095022,"Block Group 2, Census Tract 95.02, Fulton County, Georgia",297,167,265,158,32,38
1500000US131210095023,131210095023,"Block Group 3, Census Tract 95.02, Fulton County, Georgia",960,390,934,386,26,41
1500000US131210095024,131210095024,"Block Group 4, Census Tract 95.02, Fulton County, Georgia",1317,359,1277,358,40,41
1500000US131210096011,131210096011,"Block Group 1, Census Tract 96.01, Fulton County, Georgia",1003,318,993,322,10,16
1500000US131210096012,131210096012,"Block Group 2, Census Tract 96.01, Fulton County, Georgia",1414,294,1335,286,79,76
1500000US131210096021,131210096021,"Block Group 1, Census Tract 96.02, Fulton County, Georgia",1249,244,1249,244,0,13
1500000US131210096022,131210096022,"Block Group 2, Census Tract 96.02, Fulton County, Georgia",2131,321,2088,317,43,48
1500000US131210096023,131210096023,"Block Group 3, Census Tract 96.02, Fulton County, Georgia",1245,282,1245,282,0,13
1500000US131210096031,131210096031,"Block Group 1, Census Tract 96.03, Fulton County, Georgia",1086,236,1086,236,0,13
1500000US131210096032,131210096032,"Block Group 2, Census Tract 96.03, Fulton County, Georgia",1374,358,1290,348,84,113
1500000US131210096033,131210096033,"Block Group 3, Census Tract 96.03, Fulton County, Georgia",1734,447,1410,398,324,216
1500000US131210097001,131210097001,"Block Group 1, Census Tract 97, Fulton County, Georgia",995,296,962,295,33,43
1500000US131210097002,131210097002,"Block Group 2, Census Tract 97, Fulton County, Georgia",1032,202,1032,202,0,13
1500000US131210097003,131210097003,"Block Group 3, Census Tract 97, Fulton County, Georgia",1896,308,1831,304,65,54
1500000US131210098011,131210098011,"Block Group 1, Census Tract 98.01, Fulton County, Georgia",1826,230,1826,230,0,13
1500000US131210098012,131210098012,"Block Group 2, Census Tract 98.01, Fulton County, Georgia",1692,259,1681,261,11,17
1500000US131210098013,131210098013,"Block Group 3, Census Tract 98.01, Fulton County, Georgia",1375,362,1345,332,30,48
1500000US131210098021,131210098021,"Block Group 1, Census Tract 98.02, Fulton County, Georgia",1774,306,1718,314,56,87
1500000US131210098022,131210098022,"Block Group 2, Census Tract 98.02, Fulton County, Georgia",2710,364,2638,359,72,72
1500000US131210099001,131210099001,"Block Group 1, Census Tract 99, Fulton County, Georgia",1579,278,1509,264,70,71
1500000US131210099002,131210099002,"Block Group 2, Census Tract 99, Fulton County, Georgia",1190,366,1190,366,0,13
1500000US131210099003,131210099003,"Block Group 3, Census Tract 99, Fulton County, Georgia",1330,495,1330,495,0,13
1500000US131210099004,131210099004,"Block Group 4, Census Tract 99, Fulton County, Georgia",669,247,669,247,0,13
1500000US131210100011,131210100011,"Block Group 1, Census Tract 100.01, Fulton County, Georgia",1482,412,1468,411,14,24
1500000US131210100012,131210100012,"Block Group 2, Census Tract 100.01, Fulton County, Georgia",1076,466,1032,459,44,46
1500000US131210100013,131210100013,"Block Group 3, Census Tract 100.01, Fulton County, Georgia",718,250,718,250,0,13
1500000US131210100014,131210100014,"Block Group 4, Census Tract 100.01, Fulton County, Georgia",1228,390,1204,397,24,37
1500000US131210100021,131210100021,"Block Group 1, Census Tract 100.02, Fulton County, Georgia",1474,274,1474,274,0,13
1500000US131210100022,131210100022,"Block Group 2, Census Tract 100.02, Fulton County, Georgia",2041,462,2041,462,0,13
1500000US131210100023,131210100023,"Block Group 3, Census Tract 100.02, Fulton County, Georgia",3894,675,3581,659,313,223
1500000US131210101061,131210101061,"Block Group 1, Census Tract 101.06, Fulton County, Georgia",2099,356,1989,358,110,84
1500000US131210101062,131210101062,"Block Group 2, Census Tract 101.06, Fulton County, Georgia",881,281,842,285,39,38
1500000US131210101063,131210101063,"Block Group 3, Census Tract 101.06, Fulton County, Georgia",1087,291,1073,288,14,22
1500000US131210101071,131210101071,"Block Group 1, Census Tract 101.07, Fulton County, Georgia",912,123,908,125,4,7
1500000US131210101072,131210101072,"Block Group 2, Census Tract 101.07, Fulton County, Georgia",1035,165,1004,154,31,40
1500000US131210101081,131210101081,"Block Group 1, Census Tract 101.08, Fulton County, Georgia",1266,215,1253,216,13,20
1500000US131210101082,131210101082,"Block Group 2, Census Tract 101.08, Fulton County, Georgia",2333,225,2188,227,145,118
1500000US131210101101,131210101101,"Block Group 1, Census Tract 101.10, Fulton County, Georgia",2609,430,2597,427,12,20
1500000US131210101102,131210101102,"Block Group 2, Census Tract 101.10, Fulton County, Georgia",1118,420,994,406,124,125
1500000US131210101103,131210101103,"Block Group 3, Census Tract 101.10, Fulton County, Georgia",1756,445,1479,391,277,231
1500000US131210101131,131210101131,"Block Group 1, Census Tract 101.13, Fulton County, Georgia",1749,369,1617,365,132,129
1500000US131210101132,131210101132,"Block Group 2, Census Tract 101.13, Fulton County, Georgia",3024,772,945,442,2079,944
1500000US131210101133,131210101133,"Block Group 3, Census Tract 101.13, Fulton County, Georgia",1975,701,1340,454,635,565
1500000US131210101141,131210101141,"Block Group 1, Census Tract 101.14, Fulton County, Georgia",1953,780,1924,784,29,35
1500000US131210101142,131210101142,"Block Group 2, Census Tract 101.14, Fulton County, Georgia",2988,853,1609,497,1379,688
1500000US131210101143,131210101143,"Block Group 3, Census Tract 101.14, Fulton County, Georgia",2408,588,1971,527,437,338
1500000US131210101151,131210101151,"Block Group 1, Census Tract 101.15, Fulton County, Georgia",2342,338,2306,340,36,29
1500000US131210101171,131210101171,"Block Group 1, Census Tract 101.17, Fulton County, Georgia",2494,344,2121,348,373,263
1500000US131210101172,131210101172,"Block Group 2, Census Tract 101.17, Fulton County, Georgia",838,204,771,202,67,79
1500000US131210101181,131210101181,"Block Group 1, Census Tract 101.18, Fulton County, Georgia",3083,794,2389,602,694,569
1500000US131210101182,131210101182,"Block Group 2, Census Tract 101.18, Fulton County, Georgia",974,400,767,364,207,248
1500000US131210101183,131210101183,"Block Group 3, Census Tract 101.18, Fulton County, Georgia",1377,366,1090,305,287,305
1500000US131210101191,131210101191,"Block Group 1, Census Tract 101.19, Fulton County, Georgia",1407,410,1287,390,120,119
1500000US131210101192,131210101192,"Block Group 2, Census Tract 101.19, Fulton County, Georgia",1999,678,1603,647,396,336
1500000US131210101193,131210101193,"Block Group 3, Census Tract 101.19, Fulton County, Georgia",1678,533,1431,459,247,367
1500000US131210101201,131210101201,"Block Group 1, Census Tract 101.20, Fulton County, Georgia",2302,229,2003,267,299,160
1500000US131210101211,131210101211,"Block Group 1, Census Tract 101.21, Fulton County, Georgia",2199,191,2159,181,40,33
1500000US131210101221,131210101221,"Block Group 1, Census Tract 101.22, Fulton County, Georgia",2320,508,2270,507,50,49
1500000US131210101222,131210101222,"Block Group 2, Census Tract 101.22, Fulton County, Georgia",1853,518,1776,502,77,123
1500000US131210101223,131210101223,"Block Group 3, Census Tract 101.22, Fulton County, Georgia",2096,365,2036,371,60,70
1500000US131210101231,131210101231,"Block Group 1, Census Tract 101.23, Fulton County, Georgia",2793,640,1703,388,1090,682
1500000US131210101232,131210101232,"Block Group 2, Census Tract 101.23, Fulton County, Georgia",1401,480,1068,291,333,431
1500000US131210101233,131210101233,"Block Group 3, Census Tract 101.23, Fulton County, Georgia",1704,786,1634,784,70,76
1500000US131210102041,131210102041,"Block Group 1, Census Tract 102.04, Fulton County, Georgia",1056,273,982,253,74,85
1500000US131210102042,131210102042,"Block Group 2, Census Tract 102.04, Fulton County, Georgia",1991,254,1972,251,19,20
1500000US131210102043,131210102043,"Block Group 3, Census Tract 102.04, Fulton County, Georgia",1242,230,1224,232,18,23
1500000US131210102044,131210102044,"Block Group 4, Census Tract 102.04, Fulton County, Georgia",607,131,607,131,0,13
1500000US131210102051,131210102051,"Block Group 1, Census Tract 102.05, Fulton County, Georgia",938,243,897,240,41,75
1500000US131210102052,131210102052,"Block Group 2, Census Tract 102.05, Fulton County, Georgia",1057,288,1057,288,0,13
1500000US131210102053,131210102053,"Block Group 3, Census Tract 102.05, Fulton County, Georgia",1933,362,1933,362,0,13
1500000US131210102054,131210102054,"Block Group 4, Census Tract 102.05, Fulton County, Georgia",1050,274,1050,274,0,13
1500000US131210102061,131210102061,"Block Group 1, Census Tract 102.06, Fulton County, Georgia",2365,396,2170,341,195,180
1500000US131210102062,131210102062,"Block Group 2, Census Tract 102.06, Fulton County, Georgia",1552,211,1531,209,21,33
1500000US131210102063,131210102063,"Block Group 3, Census Tract 102.06, Fulton County, Georgia",1343,259,1322,250,21,35
1500000US131210102081,131210102081,"Block Group 1, Census Tract 102.08, Fulton County, Georgia",1799,336,1722,376,77,100
1500000US131210102082,131210102082,"Block Group 2, Census Tract 102.08, Fulton County, Georgia",336,160,336,160,0,13
1500000US131210102083,131210102083,"Block Group 3, Census Tract 102.08, Fulton County, Georgia",2058,465,2033,473,25,31
1500000US131210102091,131210102091,"Block Group 1, Census Tract 102.09, Fulton County, Georgia",1206,333,1022,308,184,176
1500000US131210102092,131210102092,"Block Group 2, Census Tract 102.09, Fulton County, Georgia",969,293,872,285,97,126
1500000US131210102093,131210102093,"Block Group 3, Census Tract 102.09, Fulton County, Georgia",3600,689,3159,685,441,322
1500000US131210102101,131210102101,"Block Group 1, Census Tract 102.10, Fulton County, Georgia",1534,408,1446,418,88,65
1500000US131210102102,131210102102,"Block Group 2, Census Tract 102.10, Fulton County, Georgia",2304,447,2216,450,88,96
1500000US131210102103,131210102103,"Block Group 3, Census Tract 102.10, Fulton County, Georgia",1950,411,1913,408,37,45
1500000US131210102111,131210102111,"Block Group 1, Census Tract 102.11, Fulton County, Georgia",1227,260,1204,250,23,36
1500000US131210102112,131210102112,"Block Group 2, Census Tract 102.11, Fulton County, Georgia",2030,418,1778,389,252,198
1500000US131210102121,131210102121,"Block Group 1, Census Tract 102.12, Fulton County, Georgia",1999,549,715,305,1284,487
1500000US131210102122,131210102122,"Block Group 2, Census Tract 102.12, Fulton County, Georgia",773,265,664,222,109,124
1500000US131210102123,131210102123,"Block Group 3, Census Tract 102.12, Fulton County, Georgia",2256,525,1861,343,395,395
1500000US131210103011,131210103011,"Block Group 1, Census Tract 103.01, Fulton County, Georgia",9800,1600,9512,1611,288,332
1500000US131210103012,131210103012,"Block Group 2, Census Tract 103.01, Fulton County, Georgia",6419,1362,6419,1362,0,18
1500000US131210103031,131210103031,"Block Group 1, Census Tract 103.03, Fulton County, Georgia",3107,656,3107,656,0,13
1500000US131210103032,131210103032,"Block Group 2, Census Tract 103.03, Fulton County, Georgia",6387,884,6340,897,47,67
1500000US131210103041,131210103041,"Block Group 1, Census Tract 103.04, Fulton County, Georgia",4897,1192,4801,1174,96,158
1500000US131210103042,131210103042,"Block Group 2, Census Tract 103.04, Fulton County, Georgia",10491,1553,10270,1584,221,260
1500000US131210104001,131210104001,"Block Group 1, Census Tract 104, Fulton County, Georgia",1756,403,1614,368,142,126
1500000US131210104002,131210104002,"Block Group 2, Census Tract 104, Fulton County, Georgia",1514,287,1284,264,230,135
1500000US131210104003,131210104003,"Block Group 3, Census Tract 104, Fulton County, Georgia",3896,760,3291,814,605,458
1500000US131210104004,131210104004,"Block Group 4, Census Tract 104, Fulton County, Georgia",1297,405,990,401,307,221
1500000US131210105071,131210105071,"Block Group 1, Census Tract 105.07, Fulton County, Georgia",3164,873,3164,873,0,13
1500000US131210105072,131210105072,"Block Group 2, Census Tract 105.07, Fulton County, Georgia",1068,535,842,436,226,339
1500000US131210105073,131210105073,"Block Group 3, Census Tract 105.07, Fulton County, Georgia",2146,708,2108,715,38,63
1500000US131210105074,131210105074,"Block Group 4, Census Tract 105.07, Fulton County, Georgia",2021,574,2021,574,0,13
1500000US131210105081,131210105081,"Block Group 1, Census Tract 105.08, Fulton County, Georgia",4009,596,3755,546,254,243
1500000US131210105101,131210105101,"Block Group 1, Census Tract 105.10, Fulton County, Georgia",3040,951,3040,951,0,13
1500000US131210105102,131210105102,"Block Group 2, Census Tract 105.10, Fulton County, Georgia",1265,786,1265,786,0,13
1500000US131210105103,131210105103,"Block Group 3, Census Tract 105.10, Fulton County, Georgia",9378,1507,7538,1347,1840,1468
1500000US131210105104,131210105104,"Block Group 4, Census Tract 105.10, Fulton County, Georgia",2152,919,2152,919,0,13
1500000US131210105111,131210105111,"Block Group 1, Census Tract 105.11, Fulton County, Georgia",1883,459,1883,459,0,13
1500000US131210105112,131210105112,"Block Group 2, Census Tract 105.11, Fulton County, Georgia",5839,957,5823,957,16,29
1500000US131210105113,131210105113,"Block Group 3, Census Tract 105.11, Fulton County, Georgia",611,243,589,240,22,37
1500000US131210105121,131210105121,"Block Group 1, Census Tract 105.12, Fulton County, Georgia",3387,763,3353,779,34,52
1500000US131210105122,131210105122,"Block Group 2, Census Tract 105.12, Fulton County, Georgia",1042,360,1042,360,0,13
1500000US131210105123,131210105123,"Block Group 3, Census Tract 105.12, Fulton County, Georgia",2220,564,2220,564,0,13
1500000US131210105131,131210105131,"Block Group 1, Census Tract 105.13, Fulton County, Georgia",4628,1014,4245,1068,383,378
1500000US131210105132,131210105132,"Block Group 2, Census Tract 105.13, Fulton County, Georgia",3191,982,3086,982,105,134
1500000US131210105133,131210105133,"Block Group 3, Census Tract 105.13, Fulton County, Georgia",5218,888,4114,984,1104,510
1500000US131210105141,131210105141,"Block Group 1, Census Tract 105.14, Fulton County, Georgia",4227,786,3956,816,271,225
1500000US131210105142,131210105142,"Block Group 2, Census Tract 105.14, Fulton County, Georgia",4389,832,4321,833,68,118
1500000US131210105143,131210105143,"Block Group 3, Census Tract 105.14, Fulton County, Georgia",3189,983,2641,839,548,628
1500000US131210105151,131210105151,"Block Group 1, Census Tract 105.15, Fulton County, Georgia",4809,670,4692,691,117,85
1500000US131210105161,131210105161,"Block Group 1, Census Tract 105.16, Fulton County, Georgia",2719,832,2519,802,200,266
1500000US131210105162,131210105162,"Block Group 2, Census Tract 105.16, Fulton County, Georgia",3837,1040,3573,896,264,326
1500000US131210105163,131210105163,"Block Group 3, Census Tract 105.16, Fulton County, Georgia",2377,1093,2377,1093,0,13
1500000US131210106011,131210106011,"Block Group 1, Census Tract 106.01, Fulton County, Georgia",1242,332,1048,303,194,218
1500000US131210106012,131210106012,"Block Group 2, Census Tract 106.01, Fulton County, Georgia",1078,300,1078,300,0,13
1500000US131210106013,131210106013,"Block Group 3, Census Tract 106.01, Fulton County, Georgia",486,173,486,173,0,13
1500000US131210106014,131210106014,"Block Group 4, Census Tract 106.01, Fulton County, Georgia",781,246,773,245,8,14
1500000US131210106031,131210106031,"Block Group 1, Census Tract 106.03, Fulton County, Georgia",833,367,833,367,0,13
1500000US131210106032,131210106032,"Block Group 2, Census Tract 106.03, Fulton County, Georgia",2224,451,2224,451,0,13
1500000US131210106033,131210106033,"Block Group 3, Census Tract 106.03, Fulton County, Georgia",752,376,725,359,27,40
1500000US131210106041,131210106041,"Block Group 1, Census Tract 106.04, Fulton County, Georgia",639,186,639,186,0,13
1500000US131210106042,131210106042,"Block Group 2, Census Tract 106.04, Fulton County, Georgia",223,128,144,91,79,106
1500000US131210106043,131210106043,"Block Group 3, Census Tract 106.04, Fulton County, Georgia",1901,425,1400,320,501,337
1500000US131210108001,131210108001,"Block Group 1, Census Tract 108, Fulton County, Georgia",537,366,313,170,224,352
1500000US131210108002,131210108002,"Block Group 2, Census Tract 108, Fulton County, Georgia",1007,472,986,461,21,35
1500000US131210108003,131210108003,"Block Group 3, Census Tract 108, Fulton County, Georgia",2013,572,1201,463,812,411
1500000US131210108004,131210108004,"Block Group 4, Census Tract 108, Fulton County, Georgia",1428,580,1236,561,192,330
1500000US131210108005,131210108005,"Block Group 5, Census Tract 108, Fulton County, Georgia",355,183,355,183,0,13
1500000US131210108006,131210108006,"Block Group 6, Census Tract 108, Fulton County, Georgia",1309,548,949,423,360,397
1500000US131210110001,131210110001,"Block Group 1, Census Tract 110, Fulton County, Georgia",682,260,357,153,325,206
1500000US131210110002,131210110002,"Block Group 2, Census Tract 110, Fulton County, Georgia",1076,282,935,237,141,166
1500000US131210110003,131210110003,"Block Group 3, Census Tract 110, Fulton County, Georgia",931,218,931,218,0,13
1500000US131210110004,131210110004,"Block Group 4, Census Tract 110, Fulton County, Georgia",408,214,241,138,167,182
1500000US131210111001,131210111001,"Block Group 1, Census Tract 111, Fulton County, Georgia",658,189,642,183,16,31
1500000US131210111002,131210111002,"Block Group 2, Census Tract 111, Fulton County, Georgia",1100,284,1087,282,13,14
1500000US131210111003,131210111003,"Block Group 3, Census Tract 111, Fulton County, Georgia",551,165,437,162,114,97
1500000US131210112011,131210112011,"Block Group 1, Census Tract 112.01, Fulton County, Georgia",1422,366,1394,361,28,33
1500000US131210112012,131210112012,"Block Group 2, Census Tract 112.01, Fulton County, Georgia",1286,422,1247,416,39,68
1500000US131210112013,131210112013,"Block Group 3, Census Tract 112.01, Fulton County, Georgia",1458,397,1398,393,60,86
1500000US131210112021,131210112021,"Block Group 1, Census Tract 112.02, Fulton County, Georgia",388,144,363,137,25,41
1500000US131210112022,131210112022,"Block Group 2, Census Tract 112.02, Fulton County, Georgia",568,263,568,263,0,13
1500000US131210112023,131210112023,"Block Group 3, Census Tract 112.02, Fulton County, Georgia",1052,412,558,323,494,277
1500000US131210112024,131210112024,"Block Group 4, Census Tract 112.02, Fulton County, Georgia",698,235,636,225,62,89
1500000US131210112025,131210112025,"Block Group 5, Census Tract 112.02, Fulton County, Georgia",1465,458,1200,381,265,301
1500000US131210112026,131210112026,"Block Group 6, Census Tract 112.02, Fulton County, Georgia",699,300,655,283,44,69
1500000US131210113011,131210113011,"Block Group 1, Census Tract 113.01, Fulton County, Georgia",733,241,666,198,67,144
1500000US131210113012,131210113012,"Block Group 2, Census Tract 113.01, Fulton County, Georgia",512,301,323,187,189,220
1500000US131210113013,131210113013,"Block Group 3, Census Tract 113.01, Fulton County, Georgia",296,152,296,152,0,13
1500000US131210113014,131210113014,"Block Group 4, Census Tract 113.01, Fulton County, Georgia",1242,362,1238,362,4,8
1500000US131210113015,131210113015,"Block Group 5, Census Tract 113.01, Fulton County, Georgia",701,280,547,192,154,210
1500000US131210113016,131210113016,"Block Group 6, Census Tract 113.01, Fulton County, Georgia",985,537,745,291,240,293
1500000US131210113031,131210113031,"Block Group 1, Census Tract 113.03, Fulton County, Georgia",3749,698,3579,687,170,166
1500000US131210113032,131210113032,"Block Group 2, Census Tract 113.03, Fulton County, Georgia",1139,362,1139,362,0,13
1500000US131210113033,131210113033,"Block Group 3, Census Tract 113.03, Fulton County, Georgia",500,243,500,243,0,13
1500000US131210113034,131210113034,"Block Group 4, Census Tract 113.03, Fulton County, Georgia",613,457,156,123,457,453
1500000US131210113035,131210113035,"Block Group 5, Census Tract 113.03, Fulton County, Georgia",3109,754,2428,691,681,430
1500000US131210113051,131210113051,"Block Group 1, Census Tract 113.05, Fulton County, Georgia",1129,296,1129,296,0,13
1500000US131210113052,131210113052,"Block Group 2, Census Tract 113.05, Fulton County, Georgia",2369,456,2334,451,35,39
1500000US131210113053,131210113053,"Block Group 3, Census Tract 113.05, Fulton County, Georgia",1645,368,1637,367,8,13
1500000US131210113061,131210113061,"Block Group 1, Census Tract 113.06, Fulton County, Georgia",1307,411,1281,407,26,41
1500000US131210113062,131210113062,"Block Group 2, Census Tract 113.06, Fulton County, Georgia",1129,276,1057,255,72,106
1500000US131210114051,131210114051,"Block Group 1, Census Tract 114.05, Fulton County, Georgia",1771,415,1749,416,22,26
1500000US131210114052,131210114052,"Block Group 2, Census Tract 114.05, Fulton County, Georgia",1036,400,795,305,241,311
1500000US131210114053,131210114053,"Block Group 3, Census Tract 114.05, Fulton County, Georgia",2344,888,880,182,1464,904
1500000US131210114054,131210114054,"Block Group 4, Census Tract 114.05, Fulton County, Georgia",2735,702,2171,663,564,444
1500000US131210114101,131210114101,"Block Group 1, Census Tract 114.10, Fulton County, Georgia",2514,486,2434,471,80,126
1500000US131210114102,131210114102,"Block Group 2, Census Tract 114.10, Fulton County, Georgia",2106,348,2082,346,24,42
1500000US131210114103,131210114103,"Block Group 3, Census Tract 114.10, Fulton County, Georgia",2076,394,2021,407,55,70
1500000US131210114111,131210114111,"Block Group 1, Census Tract 114.11, Fulton County, Georgia",2605,595,2429,535,176,299
1500000US131210114112,131210114112,"Block Group 2, Census Tract 114.11, Fulton County, Georgia",765,273,765,273,0,13
1500000US131210114113,131210114113,"Block Group 3, Census Tract 114.11, Fulton County, Georgia",2666,772,1849,598,817,625
1500000US131210114114,131210114114,"Block Group 4, Census Tract 114.11, Fulton County, Georgia",1001,321,1001,321,0,13
1500000US131210114115,131210114115,"Block Group 5, Census Tract 114.11, Fulton County, Georgia",1359,564,1174,551,185,283
1500000US131210114121,131210114121,"Block Group 1, Census Tract 114.12, Fulton County, Georgia",4063,532,3502,501,561,362
1500000US131210114122,131210114122,"Block Group 2, Census Tract 114.12, Fulton County, Georgia",1924,392,1672,361,252,191
1500000US131210114123,131210114123,"Block Group 3, Census Tract 114.12, Fulton County, Georgia",3327,736,3023,677,304,366
1500000US131210114141,131210114141,"Block Group 1, Census Tract 114.14, Fulton County, Georgia",2174,588,1714,579,460,248
1500000US131210114142,131210114142,"Block Group 2, Census Tract 114.14, Fulton County, Georgia",1251,475,1234,469,17,42
1500000US131210114143,131210114143,"Block Group 3, Census Tract 114.14, Fulton County, Georgia",1970,471,1889,449,81,129
1500000US131210114144,131210114144,"Block Group 4, Census Tract 114.14, Fulton County, Georgia",2148,513,2047,506,101,93
1500000US131210114161,131210114161,"Block Group 1, Census Tract 114.16, Fulton County, Georgia",1984,422,1884,387,100,128
1500000US131210114162,131210114162,"Block Group 2, Census Tract 114.16, Fulton County, Georgia",2187,357,1998,330,189,192
1500000US131210114163,131210114163,"Block Group 3, Census Tract 114.16, Fulton County, Georgia",1085,333,1054,332,31,38
1500000US131210114171,131210114171,"Block Group 1, Census Tract 114.17, Fulton County, Georgia",1021,229,919,186,102,114
1500000US131210114172,131210114172,"Block Group 2, Census Tract 114.17, Fulton County, Georgia",1527,242,1520,243,7,12
1500000US131210114173,131210114173,"Block Group 3, Census Tract 114.17, Fulton County, Georgia",1639,298,1412,235,227,203
1500000US131210114174,131210114174,"Block Group 4, Census Tract 114.17, Fulton County, Georgia",609,113,581,110,28,26
1500000US131210114181,131210114181,"Block Group 1, Census Tract 114.18, Fulton County, Georgia",854,275,854,275,0,13
1500000US131210114182,131210114182,"Block Group 2, Census Tract 114.18, Fulton County, Georgia",511,180,511,180,0,13
1500000US131210114183,131210114183,"Block Group 3, Census Tract 114.18, Fulton County, Georgia",1134,332,1134,332,0,13
1500000US131210114184,131210114184,"Block Group 4, Census Tract 114.18, Fulton County, Georgia",3810,429,3736,448,74,85
1500000US131210114191,131210114191,"Block Group 1, Census Tract 114.19, Fulton County, Georgia",1484,428,1325,411,159,204
1500000US131210114192,131210114192,"Block Group 2, Census Tract 114.19, Fulton County, Georgia",1919,421,1845,419,74,95
1500000US131210114193,131210114193,"Block Group 3, Census Tract 114.19, Fulton County, Georgia",2235,393,2205,395,30,34
1500000US131210114201,131210114201,"Block Group 1, Census Tract 114.20, Fulton County, Georgia",1576,463,1029,467,547,351
1500000US131210114202,131210114202,"Block Group 2, Census Tract 114.20, Fulton County, Georgia",3989,762,1226,451,2763,782
1500000US131210114203,131210114203,"Block Group 3, Census Tract 114.20, Fulton County, Georgia",2261,648,685,321,1576,566
1500000US131210114211,131210114211,"Block Group 1, Census Tract 114.21, Fulton County, Georgia",2274,317,1632,261,642,256
1500000US131210114212,131210114212,"Block Group 2, Census Tract 114.21, Fulton County, Georgia",1569,359,1009,394,560,290
1500000US131210114221,131210114221,"Block Group 1, Census Tract 114.22, Fulton County, Georgia",3156,484,2879,434,277,232
1500000US131210114222,131210114222,"Block Group 2, Census Tract 114.22, Fulton County, Georgia",1043,320,994,328,49,52
1500000US131210114231,131210114231,"Block Group 1, Census Tract 114.23, Fulton County, Georgia",1110,291,1110,291,0,13
1500000US131210114232,131210114232,"Block Group 2, Census Tract 114.23, Fulton County, Georgia",1495,283,1375,268,120,108
1500000US131210114233,131210114233,"Block Group 3, Census Tract 114.23, Fulton County, Georgia",1427,313,1398,318,29,44
1500000US131210114234,131210114234,"Block Group 4, Census Tract 114.23, Fulton County, Georgia",962,362,961,362,1,2
1500000US131210114241,131210114241,"Block Group 1, Census Tract 114.24, Fulton County, Georgia",3680,509,3521,508,159,181
1500000US131210114242,131210114242,"Block Group 2, Census Tract 114.24, Fulton County, Georgia",1995,404,1877,440,118,138
1500000US131210114251,131210114251,"Block Group 1, Census Tract 114.25, Fulton County, Georgia",2279,496,2261,504,18,28
1500000US131210114252,131210114252,"Block Group 2, Census Tract 114.25, Fulton County, Georgia",3037,534,2992,539,45,79
1500000US131210114253,131210114253,"Block Group 3, Census Tract 114.25, Fulton County, Georgia",1922,494,1817,465,105,138
1500000US131210114261,131210114261,"Block Group 1, Census Tract 114.26, Fulton County, Georgia",2555,246,2029,320,526,212
1500000US131210114271,131210114271,"Block Group 1, Census Tract 114.27, Fulton County, Georgia",2468,422,2312,408,156,146
1500000US131210114272,131210114272,"Block Group 2, Census Tract 114.27, Fulton County, Georgia",3025,452,2791,422,234,183
1500000US131210114273,131210114273,"Block Group 3, Census Tract 114.27, Fulton County, Georgia",2309,387,2200,374,109,123
1500000US131210115031,131210115031,"Block Group 1, Census Tract 115.03, Fulton County, Georgia",2036,454,2036,454,0,13
1500000US131210115032,131210115032,"Block Group 2, Census Tract 115.03, Fulton County, Georgia",2095,653,2095,653,0,13
1500000US131210115033,131210115033,"Block Group 3, Census Tract 115.03, Fulton County, Georgia",5914,637,5504,652,410,89
1500000US131210115041,131210115041,"Block Group 1, Census Tract 115.04, Fulton County, Georgia",3411,483,3162,405,249,263
1500000US131210115042,131210115042,"Block Group 2, Census Tract 115.04, Fulton County, Georgia",2225,447,2207,451,18,29
1500000US131210115043,131210115043,"Block Group 3, Census Tract 115.04, Fulton County, Georgia",4255,830,3711,717,544,508
1500000US131210115044,131210115044,"Block Group 4, Census Tract 115.04, Fulton County, Georgia",2930,638,2848,628,82,130
1500000US131210115051,131210115051,"Block Group 1, Census Tract 115.05, Fulton County, Georgia",2664,345,2549,340,115,107
1500000US131210115052,131210115052,"Block Group 2, Census Tract 115.05, Fulton County, Georgia",1967,391,1855,386,112,123
1500000US131210115061,131210115061,"Block Group 1, Census Tract 115.06, Fulton County, Georgia",1953,321,1953,321,0,13
1500000US131210115062,131210115062,"Block Group 2, Census Tract 115.06, Fulton County, Georgia",2790,340,2699,339,91,55
1500000US131210115063,131210115063,"Block Group 3, Census Tract 115.06, Fulton County, Georgia",1594,291,1594,291,0,13
1500000US131210116101,131210116101,"Block Group 1, Census Tract 116.10, Fulton County, Georgia",2822,480,2724,494,98,104
1500000US131210116102,131210116102,"Block Group 2, Census Tract 116.10, Fulton County, Georgia",3028,509,2827,489,201,240
1500000US131210116111,131210116111,"Block Group 1, Census Tract 116.11, Fulton County, Georgia",2665,616,2478,591,187,205
1500000US131210116112,131210116112,"Block Group 2, Census Tract 116.11, Fulton County, Georgia",1395,371,1372,366,23,39
1500000US131210116113,131210116113,"Block Group 3, Census Tract 116.11, Fulton County, Georgia",3137,708,2126,529,1011,656
1500000US131210116121,131210116121,"Block Group 1, Census Tract 116.12, Fulton County, Georgia",2534,300,2417,287,117,109
1500000US131210116122,131210116122,"Block Group 2, Census Tract 116.12, Fulton County, Georgia",847,272,847,272,0,13
1500000US131210116131,131210116131,"Block Group 1, Census Tract 116.13, Fulton County, Georgia",3677,472,3139,404,538,408
1500000US131210116132,131210116132,"Block Group 2, Census Tract 116.13, Fulton County, Georgia",3242,430,3202,423,40,65
1500000US131210116141,131210116141,"Block Group 1, Census Tract 116.14, Fulton County, Georgia",2896,762,2720,778,176,164
1500000US131210116142,131210116142,"Block Group 2, Census Tract 116.14, Fulton County, Georgia",5129,1213,4286,1028,843,926
1500000US131210116143,131210116143,"Block Group 3, Census Tract 116.14, Fulton County, Georgia",6452,1029,5474,1074,978,462
1500000US131210116151,131210116151,"Block Group 1, Census Tract 116.15, Fulton County, Georgia",3881,575,3780,595,101,179
1500000US131210116152,131210116152,"Block Group 2, Census Tract 116.15, Fulton County, Georgia",2023,410,1915,387,108,111
1500000US131210116153,131210116153,"Block Group 3, Census Tract 116.15, Fulton County, Georgia",4074,665,3711,667,363,260
1500000US131210116161,131210116161,"Block Group 1, Census Tract 116.16, Fulton County, Georgia",2068,527,1737,455,331,351
1500000US131210116162,131210116162,"Block Group 2, Census Tract 116.16, Fulton County, Georgia",1696,502,1397,413,299,257
1500000US131210116163,131210116163,"Block Group 3, Census Tract 116.16, Fulton County, Georgia",1180,413,1147,409,33,50
1500000US131210116171,131210116171,"Block Group 1, Census Tract 116.17, Fulton County, Georgia",2625,480,2513,451,112,157
1500000US131210116172,131210116172,"Block Group 2, Census Tract 116.17, Fulton County, Georgia",2447,700,2387,708,60,88
1500000US131210116173,131210116173,"Block Group 3, Census Tract 116.17, Fulton County, Georgia",2606,450,2511,451,95,169
1500000US131210116181,131210116181,"Block Group 1, Census Tract 116.18, Fulton County, Georgia",4426,305,4268,299,158,122
1500000US131210116191,131210116191,"Block Group 1, Census Tract 116.19, Fulton County, Georgia",2791,692,2523,664,268,307
1500000US131210116192,131210116192,"Block Group 2, Census Tract 116.19, Fulton County, Georgia",2382,582,2062,545,320,326
1500000US131210116193,131210116193,"Block Group 3, Census Tract 116.19, Fulton County, Georgia",3221,416,2863,369,358,274
1500000US131210116201,131210116201,"Block Group 1, Census Tract 116.20, Fulton County, Georgia",3201,638,3113,655,88,68
1500000US131210116202,131210116202,"Block Group 2, Census Tract 116.20, Fulton County, Georgia",4329,801,4271,811,58,81
1500000US131210116203,131210116203,"Block Group 3, Census Tract 116.20, Fulton County, Georgia",3104,684,2317,653,787,343
1500000US131210116211,131210116211,"Block Group 1, Census Tract 116.21, Fulton County, Georgia",828,292,768,266,60,102
1500000US131210116212,131210116212,"Block Group 2, Census Tract 116.21, Fulton County, Georgia",2359,577,1963,554,396,299
1500000US131210116213,131210116213,"Block Group 3, Census Tract 116.21, Fulton County, Georgia",4031,918,3911,885,120,186
1500000US131210116221,131210116221,"Block Group 1, Census Tract 116.22, Fulton County, Georgia",3922,627,3724,636,198,211
1500000US131210116222,131210116222,"Block Group 2, Census Tract 116.22, Fulton County, Georgia",3196,546,3056,553,140,142
1500000US131210116223,131210116223,"Block Group 3, Census Tract 116.22, Fulton County, Georgia",2896,580,2896,580,0,13
1500000US131210116231,131210116231,"Block Group 1, Census Tract 116.23, Fulton County, Georgia",3451,841,3290,792,161,140
1500000US131210116232,131210116232,"Block Group 2, Census Tract 116.23, Fulton County, Georgia",4570,873,4396,892,174,238
1500000US131210116233,131210116233,"Block Group 3, Census Tract 116.23, Fulton County, Georgia",1035,376,986,384,49,73
1500000US131210116234,131210116234,"Block Group 4, Census Tract 116.23, Fulton County, Georgia",2945,669,2945,669,0,13
1500000US131210116241,131210116241,"Block Group 1, Census Tract 116.24, Fulton County, Georgia",2535,389,2494,396,41,56
1500000US131210116242,131210116242,"Block Group 2, Census Tract 116.24, Fulton County, Georgia",1766,294,1717,291,49,54
1500000US131210116251,131210116251,"Block Group 1, Census Tract 116.25, Fulton County, Georgia",2646,601,2541,581,105,183
1500000US131210116252,131210116252,"Block Group 2, Census Tract 116.25, Fulton County, Georgia",2011,477,1895,471,116,159
1500000US131210116253,131210116253,"Block Group 3, Census Tract 116.25, Fulton County, Georgia",2937,597,2913,597,24,42
1500000US131210116261,131210116261,"Block Group 1, Census Tract 116.26, Fulton County, Georgia",5100,777,4394,798,706,390
1500000US131210116262,131210116262,"Block Group 2, Census Tract 116.26, Fulton County, Georgia",4199,864,4017,858,182,280
1500000US131210118001,131210118001,"Block Group 1, Census Tract 118, Fulton County, Georgia",290,146,290,146,0,13
1500000US131210118002,131210118002,"Block Group 2, Census Tract 118, Fulton County, Georgia",1894,454,1844,457,50,38
1500000US131210118003,131210118003,"Block Group 3, Census Tract 118, Fulton County, Georgia",708,208,583,150,125,168
1500000US131210119001,131210119001,"Block Group 1, Census Tract 119, Fulton County, Georgia",1174,245,1165,245,9,13
1500000US131210119002,131210119002,"Block Group 2, Census Tract 119, Fulton County, Georgia",1992,333,1863,320,129,62
1500000US131210120001,131210120001,"Block Group 1, Census Tract 120, Fulton County, Georgia",1383,289,1337,281,46,55
1500000US131210120002,131210120002,"Block Group 2, Census Tract 120, Fulton County, Georgia",1386,345,1380,345,6,12
1500000US131210123001,131210123001,"Block Group 1, Census Tract 123, Fulton County, Georgia",974,299,974,299,0,13
1500000US131210123002,131210123002,"Block Group 2, Census Tract 123, Fulton County, Georgia",834,248,656,163,178,174
1500000US131210123003,131210123003,"Block Group 3, Census Tract 123, Fulton County, Georgia",656,246,624,239,32,35
1500000US131219800001,131219800001,"Block Group 1, Census Tract 9800, Fulton County, Georgia",0,13,0,13,0,13
1500000US131230801001,131230801001,"Block Group 1, Census Tract 801, Gilmer County, Georgia",1762,302,1754,302,8,17
1500000US131230801002,131230801002,"Block Group 2, Census Tract 801, Gilmer County, Georgia",1427,358,1245,248,182,238
1500000US131230801003,131230801003,"Block Group 3, Census Tract 801, Gilmer County, Georgia",818,202,798,193,20,28
1500000US131230802001,131230802001,"Block Group 1, Census Tract 802, Gilmer County, Georgia",1182,298,1182,298,0,13
1500000US131230802002,131230802002,"Block Group 2, Census Tract 802, Gilmer County, Georgia",2144,463,2120,463,24,33
1500000US131230802003,131230802003,"Block Group 3, Census Tract 802, Gilmer County, Georgia",2389,548,2058,529,331,255
1500000US131230803001,131230803001,"Block Group 1, Census Tract 803, Gilmer County, Georgia",1457,427,951,254,506,379
1500000US131230803002,131230803002,"Block Group 2, Census Tract 803, Gilmer County, Georgia",1556,666,748,297,808,630
1500000US131230803003,131230803003,"Block Group 3, Census Tract 803, Gilmer County, Georgia",1545,359,1545,359,0,13
1500000US131230803004,131230803004,"Block Group 4, Census Tract 803, Gilmer County, Georgia",2157,404,1884,382,273,209
1500000US131230804001,131230804001,"Block Group 1, Census Tract 804, Gilmer County, Georgia",2943,667,2551,546,392,425
1500000US131230804002,131230804002,"Block Group 2, Census Tract 804, Gilmer County, Georgia",2972,662,2659,609,313,226
1500000US131230804003,131230804003,"Block Group 3, Census Tract 804, Gilmer County, Georgia",2446,568,2354,551,92,148
1500000US131230805001,131230805001,"Block Group 1, Census Tract 805, Gilmer County, Georgia",729,268,729,268,0,13
1500000US131230805002,131230805002,"Block Group 2, Census Tract 805, Gilmer County, Georgia",1649,327,1619,327,30,40
1500000US131230805003,131230805003,"Block Group 3, Census Tract 805, Gilmer County, Georgia",1497,321,1410,305,87,92
1500000US131250101001,131250101001,"Block Group 1, Census Tract 101, Glascock County, Georgia",1214,186,1214,186,0,13
1500000US131250101002,131250101002,"Block Group 2, Census Tract 101, Glascock County, Georgia",946,182,925,180,21,19
1500000US131250101003,131250101003,"Block Group 3, Census Tract 101, Glascock County, Georgia",927,147,900,144,27,19
1500000US131270001011,131270001011,"Block Group 1, Census Tract 1.01, Glynn County, Georgia",677,176,677,176,0,13
1500000US131270001012,131270001012,"Block Group 2, Census Tract 1.01, Glynn County, Georgia",544,192,544,192,0,13
1500000US131270001021,131270001021,"Block Group 1, Census Tract 1.02, Glynn County, Georgia",1753,319,1699,320,54,57
1500000US131270001022,131270001022,"Block Group 2, Census Tract 1.02, Glynn County, Georgia",744,192,744,192,0,13
1500000US131270001023,131270001023,"Block Group 3, Census Tract 1.02, Glynn County, Georgia",977,237,889,184,88,99
1500000US131270002001,131270002001,"Block Group 1, Census Tract 2, Glynn County, Georgia",1448,311,1413,302,35,40
1500000US131270002002,131270002002,"Block Group 2, Census Tract 2, Glynn County, Georgia",1797,389,1787,386,10,15
1500000US131270002003,131270002003,"Block Group 3, Census Tract 2, Glynn County, Georgia",1664,357,1594,356,70,71
1500000US131270003001,131270003001,"Block Group 1, Census Tract 3, Glynn County, Georgia",2477,450,2452,453,25,31
1500000US131270003002,131270003002,"Block Group 2, Census Tract 3, Glynn County, Georgia",1045,451,1022,452,23,36
1500000US131270003003,131270003003,"Block Group 3, Census Tract 3, Glynn County, Georgia",2164,429,2027,425,137,162
1500000US131270003004,131270003004,"Block Group 4, Census Tract 3, Glynn County, Georgia",630,238,609,233,21,34
1500000US131270004011,131270004011,"Block Group 1, Census Tract 4.01, Glynn County, Georgia",3757,753,3502,726,255,197
1500000US131270004012,131270004012,"Block Group 2, Census Tract 4.01, Glynn County, Georgia",1079,386,1079,386,0,13
1500000US131270004013,131270004013,"Block Group 3, Census Tract 4.01, Glynn County, Georgia",3114,548,2881,560,233,184
1500000US131270004031,131270004031,"Block Group 1, Census Tract 4.03, Glynn County, Georgia",1619,371,1515,402,104,104
1500000US131270004032,131270004032,"Block Group 2, Census Tract 4.03, Glynn County, Georgia",1521,237,1500,230,21,35
1500000US131270004041,131270004041,"Block Group 1, Census Tract 4.04, Glynn County, Georgia",948,478,948,478,0,13
1500000US131270004042,131270004042,"Block Group 2, Census Tract 4.04, Glynn County, Georgia",5291,721,4745,653,546,295
1500000US131270004043,131270004043,"Block Group 3, Census Tract 4.04, Glynn County, Georgia",5484,962,5200,939,284,248
1500000US131270005011,131270005011,"Block Group 1, Census Tract 5.01, Glynn County, Georgia",675,275,675,275,0,13
1500000US131270005012,131270005012,"Block Group 2, Census Tract 5.01, Glynn County, Georgia",2061,364,1721,326,340,261
1500000US131270005013,131270005013,"Block Group 3, Census Tract 5.01, Glynn County, Georgia",1162,255,1154,255,8,14
1500000US131270005031,131270005031,"Block Group 1, Census Tract 5.03, Glynn County, Georgia",1046,251,1002,255,44,57
1500000US131270005032,131270005032,"Block Group 2, Census Tract 5.03, Glynn County, Georgia",1129,335,1042,307,87,97
1500000US131270005033,131270005033,"Block Group 3, Census Tract 5.03, Glynn County, Georgia",1818,433,1535,353,283,290
1500000US131270005041,131270005041,"Block Group 1, Census Tract 5.04, Glynn County, Georgia",607,202,557,198,50,75
1500000US131270005042,131270005042,"Block Group 2, Census Tract 5.04, Glynn County, Georgia",983,333,813,251,170,199
1500000US131270005043,131270005043,"Block Group 3, Census Tract 5.04, Glynn County, Georgia",1863,408,1799,401,64,78
1500000US131270006001,131270006001,"Block Group 1, Census Tract 6, Glynn County, Georgia",1509,497,1495,498,14,22
1500000US131270006002,131270006002,"Block Group 2, Census Tract 6, Glynn County, Georgia",1604,662,1448,651,156,125
1500000US131270006003,131270006003,"Block Group 3, Census Tract 6, Glynn County, Georgia",1133,372,988,343,145,185
1500000US131270006004,131270006004,"Block Group 4, Census Tract 6, Glynn County, Georgia",1522,562,1522,562,0,13
1500000US131270007001,131270007001,"Block Group 1, Census Tract 7, Glynn County, Georgia",2461,509,2397,485,64,116
1500000US131270007002,131270007002,"Block Group 2, Census Tract 7, Glynn County, Georgia",992,551,992,551,0,13
1500000US131270007003,131270007003,"Block Group 3, Census Tract 7, Glynn County, Georgia",852,283,852,283,0,13
1500000US131270007004,131270007004,"Block Group 4, Census Tract 7, Glynn County, Georgia",1213,500,1213,500,0,13
1500000US131270007005,131270007005,"Block Group 5, Census Tract 7, Glynn County, Georgia",666,440,666,440,0,13
1500000US131270007006,131270007006,"Block Group 6, Census Tract 7, Glynn County, Georgia",582,366,348,204,234,304
1500000US131270007007,131270007007,"Block Group 7, Census Tract 7, Glynn County, Georgia",334,159,334,159,0,13
1500000US131270007008,131270007008,"Block Group 8, Census Tract 7, Glynn County, Georgia",690,346,690,346,0,13
1500000US131270008001,131270008001,"Block Group 1, Census Tract 8, Glynn County, Georgia",890,270,832,245,58,75
1500000US131270008002,131270008002,"Block Group 2, Census Tract 8, Glynn County, Georgia",1355,390,1355,390,0,13
1500000US131270008003,131270008003,"Block Group 3, Census Tract 8, Glynn County, Georgia",854,346,854,346,0,13
1500000US131270008004,131270008004,"Block Group 4, Census Tract 8, Glynn County, Georgia",1011,333,977,333,34,42
1500000US131270009001,131270009001,"Block Group 1, Census Tract 9, Glynn County, Georgia",597,243,591,245,6,10
1500000US131270009002,131270009002,"Block Group 2, Census Tract 9, Glynn County, Georgia",470,184,459,184,11,14
1500000US131270009003,131270009003,"Block Group 3, Census Tract 9, Glynn County, Georgia",901,439,593,275,308,368
1500000US131270009004,131270009004,"Block Group 4, Census Tract 9, Glynn County, Georgia",1388,378,731,262,657,362
1500000US131270009005,131270009005,"Block Group 5, Census Tract 9, Glynn County, Georgia",1179,338,1040,313,139,169
1500000US131270010001,131270010001,"Block Group 1, Census Tract 10, Glynn County, Georgia",588,206,571,201,17,27
1500000US131270010002,131270010002,"Block Group 2, Census Tract 10, Glynn County, Georgia",2552,444,2462,451,90,71
1500000US131270010003,131270010003,"Block Group 3, Census Tract 10, Glynn County, Georgia",2216,444,2056,448,160,173
1500000US131270010004,131270010004,"Block Group 4, Census Tract 10, Glynn County, Georgia",4107,588,3757,574,350,316
1500000US131279900000,131279900000,"Block Group 0, Census Tract 9900, Glynn County, Georgia",0,13,0,13,0,13
1500000US131299701001,131299701001,"Block Group 1, Census Tract 9701, Gordon County, Georgia",1256,370,1237,361,19,33
1500000US131299701002,131299701002,"Block Group 2, Census Tract 9701, Gordon County, Georgia",1501,459,1501,459,0,13
1500000US131299701003,131299701003,"Block Group 3, Census Tract 9701, Gordon County, Georgia",3554,669,3159,691,395,364
1500000US131299702001,131299702001,"Block Group 1, Census Tract 9702, Gordon County, Georgia",1364,365,1356,362,8,16
1500000US131299702002,131299702002,"Block Group 2, Census Tract 9702, Gordon County, Georgia",1304,404,1274,405,30,42
1500000US131299702003,131299702003,"Block Group 3, Census Tract 9702, Gordon County, Georgia",2429,463,2282,478,147,195
1500000US131299702004,131299702004,"Block Group 4, Census Tract 9702, Gordon County, Georgia",2036,661,2036,661,0,13
1500000US131299703001,131299703001,"Block Group 1, Census Tract 9703, Gordon County, Georgia",1102,396,985,333,117,196
1500000US131299703002,131299703002,"Block Group 2, Census Tract 9703, Gordon County, Georgia",2705,581,2447,571,258,231
1500000US131299703003,131299703003,"Block Group 3, Census Tract 9703, Gordon County, Georgia",4281,792,2473,640,1808,580
1500000US131299703004,131299703004,"Block Group 4, Census Tract 9703, Gordon County, Georgia",1116,398,876,328,240,236
1500000US131299704001,131299704001,"Block Group 1, Census Tract 9704, Gordon County, Georgia",2451,416,2248,373,203,165
1500000US131299704002,131299704002,"Block Group 2, Census Tract 9704, Gordon County, Georgia",1518,321,1380,307,138,163
1500000US131299704003,131299704003,"Block Group 3, Census Tract 9704, Gordon County, Georgia",1008,295,764,227,244,198
1500000US131299705001,131299705001,"Block Group 1, Census Tract 9705, Gordon County, Georgia",2031,364,1371,273,660,332
1500000US131299705002,131299705002,"Block Group 2, Census Tract 9705, Gordon County, Georgia",1326,406,960,416,366,259
1500000US131299705003,131299705003,"Block Group 3, Census Tract 9705, Gordon County, Georgia",1410,352,742,214,668,374
1500000US131299706001,131299706001,"Block Group 1, Census Tract 9706, Gordon County, Georgia",645,380,367,198,278,346
1500000US131299706002,131299706002,"Block Group 2, Census Tract 9706, Gordon County, Georgia",2211,544,1700,428,511,349
1500000US131299706003,131299706003,"Block Group 3, Census Tract 9706, Gordon County, Georgia",3642,741,2050,468,1592,609
1500000US131299707001,131299707001,"Block Group 1, Census Tract 9707, Gordon County, Georgia",1682,330,1597,342,85,103
1500000US131299707002,131299707002,"Block Group 2, Census Tract 9707, Gordon County, Georgia",902,265,902,265,0,13
1500000US131299707003,131299707003,"Block Group 3, Census Tract 9707, Gordon County, Georgia",1680,423,1673,424,7,9
1500000US131299708001,131299708001,"Block Group 1, Census Tract 9708, Gordon County, Georgia",1160,346,1099,347,61,85
1500000US131299708002,131299708002,"Block Group 2, Census Tract 9708, Gordon County, Georgia",1900,417,1676,421,224,155
1500000US131299708003,131299708003,"Block Group 3, Census Tract 9708, Gordon County, Georgia",2775,531,2731,527,44,79
1500000US131299709001,131299709001,"Block Group 1, Census Tract 9709, Gordon County, Georgia",1650,529,1647,529,3,7
1500000US131299709002,131299709002,"Block Group 2, Census Tract 9709, Gordon County, Georgia",1408,386,1331,378,77,100
1500000US131299709003,131299709003,"Block Group 3, Census Tract 9709, Gordon County, Georgia",3842,611,3738,597,104,106
1500000US131319501001,131319501001,"Block Group 1, Census Tract 9501, Grady County, Georgia",1311,263,1199,227,112,143
1500000US131319501002,131319501002,"Block Group 2, Census Tract 9501, Grady County, Georgia",823,182,823,182,0,13
1500000US131319502001,131319502001,"Block Group 1, Census Tract 9502, Grady County, Georgia",1440,288,1438,288,2,3
1500000US131319502002,131319502002,"Block Group 2, Census Tract 9502, Grady County, Georgia",1361,275,1360,275,1,3
1500000US131319503001,131319503001,"Block Group 1, Census Tract 9503, Grady County, Georgia",1729,295,1618,277,111,121
1500000US131319503002,131319503002,"Block Group 2, Census Tract 9503, Grady County, Georgia",1172,367,1097,357,75,103
1500000US131319503003,131319503003,"Block Group 3, Census Tract 9503, Grady County, Georgia",643,256,643,256,0,13
1500000US131319503004,131319503004,"Block Group 4, Census Tract 9503, Grady County, Georgia",865,320,865,320,0,13
1500000US131319504001,131319504001,"Block Group 1, Census Tract 9504, Grady County, Georgia",2412,520,2276,536,136,115
1500000US131319504002,131319504002,"Block Group 2, Census Tract 9504, Grady County, Georgia",1774,397,1774,397,0,13
1500000US131319504003,131319504003,"Block Group 3, Census Tract 9504, Grady County, Georgia",1802,427,780,284,1022,356
1500000US131319504004,131319504004,"Block Group 4, Census Tract 9504, Grady County, Georgia",673,316,392,179,281,257
1500000US131319505001,131319505001,"Block Group 1, Census Tract 9505, Grady County, Georgia",2680,496,2387,451,293,267
1500000US131319505002,131319505002,"Block Group 2, Census Tract 9505, Grady County, Georgia",1215,356,748,243,467,304
1500000US131319505003,131319505003,"Block Group 3, Census Tract 9505, Grady County, Georgia",1573,404,1573,404,0,13
1500000US131319505004,131319505004,"Block Group 4, Census Tract 9505, Grady County, Georgia",1439,426,1439,426,0,13
1500000US131319506001,131319506001,"Block Group 1, Census Tract 9506, Grady County, Georgia",2331,294,2177,288,154,119
1500000US131339501001,131339501001,"Block Group 1, Census Tract 9501, Greene County, Georgia",1154,230,1136,229,18,22
1500000US131339501002,131339501002,"Block Group 2, Census Tract 9501, Greene County, Georgia",1116,275,1116,275,0,13
1500000US131339502001,131339502001,"Block Group 1, Census Tract 9502, Greene County, Georgia",775,186,769,187,6,10
1500000US131339502002,131339502002,"Block Group 2, Census Tract 9502, Greene County, Georgia",795,150,758,139,37,49
1500000US131339502003,131339502003,"Block Group 3, Census Tract 9502, Greene County, Georgia",583,135,583,135,0,13
1500000US131339503011,131339503011,"Block Group 1, Census Tract 9503.01, Greene County, Georgia",849,161,832,163,17,26
1500000US131339503012,131339503012,"Block Group 2, Census Tract 9503.01, Greene County, Georgia",718,133,718,133,0,13
1500000US131339503013,131339503013,"Block Group 3, Census Tract 9503.01, Greene County, Georgia",472,111,442,118,30,47
1500000US131339503014,131339503014,"Block Group 4, Census Tract 9503.01, Greene County, Georgia",371,117,354,119,17,29
1500000US131339503021,131339503021,"Block Group 1, Census Tract 9503.02, Greene County, Georgia",1771,388,1764,389,7,11
1500000US131339503022,131339503022,"Block Group 2, Census Tract 9503.02, Greene County, Georgia",755,160,746,155,9,15
1500000US131339503031,131339503031,"Block Group 1, Census Tract 9503.03, Greene County, Georgia",800,313,654,260,146,222
1500000US131339503032,131339503032,"Block Group 2, Census Tract 9503.03, Greene County, Georgia",1418,422,1035,384,383,204
1500000US131339503033,131339503033,"Block Group 3, Census Tract 9503.03, Greene County, Georgia",1514,392,1189,328,325,292
1500000US131339503034,131339503034,"Block Group 4, Census Tract 9503.03, Greene County, Georgia",237,85,237,85,0,13
1500000US131339503035,131339503035,"Block Group 5, Census Tract 9503.03, Greene County, Georgia",278,138,278,138,0,13
1500000US131339504001,131339504001,"Block Group 1, Census Tract 9504, Greene County, Georgia",1325,205,1325,205,0,13
1500000US131339505001,131339505001,"Block Group 1, Census Tract 9505, Greene County, Georgia",637,117,620,115,17,28
1500000US131339505002,131339505002,"Block Group 2, Census Tract 9505, Greene County, Georgia",763,165,763,165,0,13
1500000US131350501031,131350501031,"Block Group 1, Census Tract 501.03, Gwinnett County, Georgia",4562,539,3991,536,571,274
1500000US131350501032,131350501032,"Block Group 2, Census Tract 501.03, Gwinnett County, Georgia",1565,461,1140,355,425,295
1500000US131350501033,131350501033,"Block Group 3, Census Tract 501.03, Gwinnett County, Georgia",4397,596,3104,544,1293,474
1500000US131350501051,131350501051,"Block Group 1, Census Tract 501.05, Gwinnett County, Georgia",571,258,571,258,0,13
1500000US131350501052,131350501052,"Block Group 2, Census Tract 501.05, Gwinnett County, Georgia",1320,321,730,295,590,173
1500000US131350501053,131350501053,"Block Group 3, Census Tract 501.05, Gwinnett County, Georgia",1934,443,1111,263,823,431
1500000US131350501061,131350501061,"Block Group 1, Census Tract 501.06, Gwinnett County, Georgia",5090,937,3280,581,1810,868
1500000US131350501062,131350501062,"Block Group 2, Census Tract 501.06, Gwinnett County, Georgia",1644,428,1644,428,0,13
1500000US131350501063,131350501063,"Block Group 3, Census Tract 501.06, Gwinnett County, Georgia",2149,563,1678,380,471,568
1500000US131350501064,131350501064,"Block Group 4, Census Tract 501.06, Gwinnett County, Georgia",2560,752,912,406,1648,695
1500000US131350501071,131350501071,"Block Group 1, Census Tract 501.07, Gwinnett County, Georgia",7312,599,6508,608,804,445
1500000US131350501081,131350501081,"Block Group 1, Census Tract 501.08, Gwinnett County, Georgia",6628,675,6385,634,243,208
1500000US131350501082,131350501082,"Block Group 2, Census Tract 501.08, Gwinnett County, Georgia",3007,721,2270,432,737,695
1500000US131350501091,131350501091,"Block Group 1, Census Tract 501.09, Gwinnett County, Georgia",2966,629,2534,505,432,287
1500000US131350501092,131350501092,"Block Group 2, Census Tract 501.09, Gwinnett County, Georgia",4911,1131,4378,1064,533,418
1500000US131350502051,131350502051,"Block Group 1, Census Tract 502.05, Gwinnett County, Georgia",2535,455,2169,375,366,158
1500000US131350502052,131350502052,"Block Group 2, Census Tract 502.05, Gwinnett County, Georgia",1724,369,1656,361,68,77
1500000US131350502081,131350502081,"Block Group 1, Census Tract 502.08, Gwinnett County, Georgia",3294,618,2989,575,305,323
1500000US131350502082,131350502082,"Block Group 2, Census Tract 502.08, Gwinnett County, Georgia",3277,537,2095,479,1182,419
1500000US131350502091,131350502091,"Block Group 1, Census Tract 502.09, Gwinnett County, Georgia",4434,818,3941,772,493,389
1500000US131350502092,131350502092,"Block Group 2, Census Tract 502.09, Gwinnett County, Georgia",2737,1106,2124,832,613,818
1500000US131350502093,131350502093,"Block Group 3, Census Tract 502.09, Gwinnett County, Georgia",2858,773,2358,715,500,328
1500000US131350502101,131350502101,"Block Group 1, Census Tract 502.10, Gwinnett County, Georgia",3045,644,2032,424,1013,619
1500000US131350502102,131350502102,"Block Group 2, Census Tract 502.10, Gwinnett County, Georgia",3881,611,3648,615,233,173
1500000US131350502111,131350502111,"Block Group 1, Census Tract 502.11, Gwinnett County, Georgia",1351,434,402,204,949,448
1500000US131350502112,131350502112,"Block Group 2, Census Tract 502.11, Gwinnett County, Georgia",1087,348,532,244,555,286
1500000US131350502113,131350502113,"Block Group 3, Census Tract 502.11, Gwinnett County, Georgia",2814,509,2115,358,699,384
1500000US131350502121,131350502121,"Block Group 1, Census Tract 502.12, Gwinnett County, Georgia",3116,620,3116,620,0,13
1500000US131350502122,131350502122,"Block Group 2, Census Tract 502.12, Gwinnett County, Georgia",2652,561,2409,550,243,245
1500000US131350502123,131350502123,"Block Group 3, Census Tract 502.12, Gwinnett County, Georgia",6965,777,6615,778,350,283
1500000US131350502131,131350502131,"Block Group 1, Census Tract 502.13, Gwinnett County, Georgia",5111,880,4950,871,161,231
1500000US131350502132,131350502132,"Block Group 2, Census Tract 502.13, Gwinnett County, Georgia",7897,917,6886,971,1011,560
1500000US131350502141,131350502141,"Block Group 1, Census Tract 502.14, Gwinnett County, Georgia",2210,582,2174,571,36,66
1500000US131350502142,131350502142,"Block Group 2, Census Tract 502.14, Gwinnett County, Georgia",4908,1025,4571,979,337,230
1500000US131350502143,131350502143,"Block Group 3, Census Tract 502.14, Gwinnett County, Georgia",1637,454,1488,409,149,232
1500000US131350502151,131350502151,"Block Group 1, Census Tract 502.15, Gwinnett County, Georgia",3380,326,3287,339,93,97
1500000US131350502161,131350502161,"Block Group 1, Census Tract 502.16, Gwinnett County, Georgia",2471,762,2290,793,181,302
1500000US131350502162,131350502162,"Block Group 2, Census Tract 502.16, Gwinnett County, Georgia",2795,942,2795,942,0,13
1500000US131350502163,131350502163,"Block Group 3, Census Tract 502.16, Gwinnett County, Georgia",3758,774,3527,760,231,184
1500000US131350502171,131350502171,"Block Group 1, Census Tract 502.17, Gwinnett County, Georgia",8288,700,7658,658,630,378
1500000US131350502172,131350502172,"Block Group 2, Census Tract 502.17, Gwinnett County, Georgia",1873,557,1847,546,26,44
1500000US131350502181,131350502181,"Block Group 1, Census Tract 502.18, Gwinnett County, Georgia",2463,624,1233,325,1230,644
1500000US131350502182,131350502182,"Block Group 2, Census Tract 502.18, Gwinnett County, Georgia",1493,456,1174,386,319,242
1500000US131350502191,131350502191,"Block Group 1, Census Tract 502.19, Gwinnett County, Georgia",849,269,836,276,13,22
1500000US131350502192,131350502192,"Block Group 2, Census Tract 502.19, Gwinnett County, Georgia",2918,308,2721,294,197,128
1500000US131350502201,131350502201,"Block Group 1, Census Tract 502.20, Gwinnett County, Georgia",2130,512,1717,470,413,397
1500000US131350502202,131350502202,"Block Group 2, Census Tract 502.20, Gwinnett County, Georgia",2990,506,2663,427,327,306
1500000US131350502203,131350502203,"Block Group 3, Census Tract 502.20, Gwinnett County, Georgia",1115,400,904,347,211,189
1500000US131350503041,131350503041,"Block Group 1, Census Tract 503.04, Gwinnett County, Georgia",2501,660,1208,387,1293,576
1500000US131350503042,131350503042,"Block Group 2, Census Tract 503.04, Gwinnett County, Georgia",1629,421,776,215,853,427
1500000US131350503043,131350503043,"Block Group 3, Census Tract 503.04, Gwinnett County, Georgia",889,275,727,257,162,106
1500000US131350503061,131350503061,"Block Group 1, Census Tract 503.06, Gwinnett County, Georgia",2717,464,1021,266,1696,468
1500000US131350503062,131350503062,"Block Group 2, Census Tract 503.06, Gwinnett County, Georgia",2151,522,613,303,1538,528
1500000US131350503081,131350503081,"Block Group 1, Census Tract 503.08, Gwinnett County, Georgia",2037,247,1982,255,55,52
1500000US131350503082,131350503082,"Block Group 2, Census Tract 503.08, Gwinnett County, Georgia",1890,307,1858,303,32,50
1500000US131350503091,131350503091,"Block Group 1, Census Tract 503.09, Gwinnett County, Georgia",2074,352,1974,341,100,65
1500000US131350503092,131350503092,"Block Group 2, Census Tract 503.09, Gwinnett County, Georgia",2038,368,2019,369,19,32
1500000US131350503093,131350503093,"Block Group 3, Census Tract 503.09, Gwinnett County, Georgia",1666,395,1601,417,65,84
1500000US131350503094,131350503094,"Block Group 4, Census Tract 503.09, Gwinnett County, Georgia",2338,537,2192,561,146,116
1500000US131350503101,131350503101,"Block Group 1, Census Tract 503.10, Gwinnett County, Georgia",2026,338,1901,360,125,151
1500000US131350503102,131350503102,"Block Group 2, Census Tract 503.10, Gwinnett County, Georgia",739,202,709,193,30,50
1500000US131350503103,131350503103,"Block Group 3, Census Tract 503.10, Gwinnett County, Georgia",2564,445,2298,419,266,113
1500000US131350503111,131350503111,"Block Group 1, Census Tract 503.11, Gwinnett County, Georgia",1907,214,1851,207,56,52
1500000US131350503112,131350503112,"Block Group 2, Census Tract 503.11, Gwinnett County, Georgia",825,238,656,167,169,216
1500000US131350503131,131350503131,"Block Group 1, Census Tract 503.13, Gwinnett County, Georgia",1827,1074,623,256,1204,1046
1500000US131350503132,131350503132,"Block Group 2, Census Tract 503.13, Gwinnett County, Georgia",1895,489,1383,445,512,394
1500000US131350503133,131350503133,"Block Group 3, Census Tract 503.13, Gwinnett County, Georgia",820,340,746,314,74,119
1500000US131350503134,131350503134,"Block Group 4, Census Tract 503.13, Gwinnett County, Georgia",982,356,754,302,228,283
1500000US131350503135,131350503135,"Block Group 5, Census Tract 503.13, Gwinnett County, Georgia",1044,324,957,311,87,101
1500000US131350503136,131350503136,"Block Group 6, Census Tract 503.13, Gwinnett County, Georgia",1533,701,1134,587,399,435
1500000US131350503141,131350503141,"Block Group 1, Census Tract 503.14, Gwinnett County, Georgia",2706,877,1601,524,1105,783
1500000US131350503142,131350503142,"Block Group 2, Census Tract 503.14, Gwinnett County, Georgia",4831,864,3105,667,1726,783
1500000US131350503143,131350503143,"Block Group 3, Census Tract 503.14, Gwinnett County, Georgia",1391,556,878,361,513,490
1500000US131350503144,131350503144,"Block Group 4, Census Tract 503.14, Gwinnett County, Georgia",1169,455,918,375,251,250
1500000US131350503151,131350503151,"Block Group 1, Census Tract 503.15, Gwinnett County, Georgia",1534,299,1447,291,87,70
1500000US131350503152,131350503152,"Block Group 2, Census Tract 503.15, Gwinnett County, Georgia",3476,494,2064,385,1412,495
1500000US131350503153,131350503153,"Block Group 3, Census Tract 503.15, Gwinnett County, Georgia",714,140,701,142,13,20
1500000US131350503171,131350503171,"Block Group 1, Census Tract 503.17, Gwinnett County, Georgia",390,155,355,155,35,41
1500000US131350503172,131350503172,"Block Group 2, Census Tract 503.17, Gwinnett County, Georgia",2086,523,1088,366,998,473
1500000US131350503173,131350503173,"Block Group 3, Census Tract 503.17, Gwinnett County, Georgia",1217,329,711,220,506,349
1500000US131350503181,131350503181,"Block Group 1, Census Tract 503.18, Gwinnett County, Georgia",1905,597,1799,598,106,86
1500000US131350503182,131350503182,"Block Group 2, Census Tract 503.18, Gwinnett County, Georgia",1088,507,560,335,528,480
1500000US131350503191,131350503191,"Block Group 1, Census Tract 503.19, Gwinnett County, Georgia",3564,626,1088,299,2476,654
1500000US131350503192,131350503192,"Block Group 2, Census Tract 503.19, Gwinnett County, Georgia",2861,589,1222,362,1639,559
1500000US131350503201,131350503201,"Block Group 1, Census Tract 503.20, Gwinnett County, Georgia",1801,580,972,335,829,501
1500000US131350503202,131350503202,"Block Group 2, Census Tract 503.20, Gwinnett County, Georgia",3167,611,1314,513,1853,531
1500000US131350503203,131350503203,"Block Group 3, Census Tract 503.20, Gwinnett County, Georgia",1283,511,484,248,799,538
1500000US131350503211,131350503211,"Block Group 1, Census Tract 503.21, Gwinnett County, Georgia",2079,241,2045,243,34,54
1500000US131350503212,131350503212,"Block Group 2, Census Tract 503.21, Gwinnett County, Georgia",2424,299,2289,279,135,105
1500000US131350503221,131350503221,"Block Group 1, Census Tract 503.22, Gwinnett County, Georgia",1164,180,1164,180,0,13
1500000US131350503222,131350503222,"Block Group 2, Census Tract 503.22, Gwinnett County, Georgia",2623,317,2594,316,29,44
1500000US131350503223,131350503223,"Block Group 3, Census Tract 503.22, Gwinnett County, Georgia",949,163,949,163,0,13
1500000US131350504101,131350504101,"Block Group 1, Census Tract 504.10, Gwinnett County, Georgia",1826,518,1035,326,791,445
1500000US131350504102,131350504102,"Block Group 2, Census Tract 504.10, Gwinnett County, Georgia",2675,527,1575,369,1100,431
1500000US131350504103,131350504103,"Block Group 3, Census Tract 504.10, Gwinnett County, Georgia",1271,318,1066,314,205,162
1500000US131350504151,131350504151,"Block Group 1, Census Tract 504.15, Gwinnett County, Georgia",874,259,827,254,47,77
1500000US131350504152,131350504152,"Block Group 2, Census Tract 504.15, Gwinnett County, Georgia",1135,398,1112,399,23,27
1500000US131350504153,131350504153,"Block Group 3, Census Tract 504.15, Gwinnett County, Georgia",1646,361,1631,364,15,19
1500000US131350504161,131350504161,"Block Group 1, Census Tract 504.16, Gwinnett County, Georgia",2832,486,2347,444,485,283
1500000US131350504162,131350504162,"Block Group 2, Census Tract 504.16, Gwinnett County, Georgia",693,245,693,245,0,13
1500000US131350504171,131350504171,"Block Group 1, Census Tract 504.17, Gwinnett County, Georgia",2437,520,789,240,1648,490
1500000US131350504172,131350504172,"Block Group 2, Census Tract 504.17, Gwinnett County, Georgia",1494,423,318,166,1176,392
1500000US131350504173,131350504173,"Block Group 3, Census Tract 504.17, Gwinnett County, Georgia",2095,501,1275,380,820,417
1500000US131350504181,131350504181,"Block Group 1, Census Tract 504.18, Gwinnett County, Georgia",3046,907,2012,686,1034,583
1500000US131350504182,131350504182,"Block Group 2, Census Tract 504.18, Gwinnett County, Georgia",2562,668,872,396,1690,517
1500000US131350504183,131350504183,"Block Group 3, Census Tract 504.18, Gwinnett County, Georgia",1646,544,382,219,1264,508
1500000US131350504191,131350504191,"Block Group 1, Census Tract 504.19, Gwinnett County, Georgia",2342,725,775,291,1567,634
1500000US131350504192,131350504192,"Block Group 2, Census Tract 504.19, Gwinnett County, Georgia",2654,569,2038,543,616,403
1500000US131350504193,131350504193,"Block Group 3, Census Tract 504.19, Gwinnett County, Georgia",2903,1055,1696,642,1207,753
1500000US131350504211,131350504211,"Block Group 1, Census Tract 504.21, Gwinnett County, Georgia",2909,524,1565,373,1344,489
1500000US131350504212,131350504212,"Block Group 2, Census Tract 504.21, Gwinnett County, Georgia",1218,384,699,248,519,336
1500000US131350504213,131350504213,"Block Group 3, Census Tract 504.21, Gwinnett County, Georgia",3171,768,2091,546,1080,593
1500000US131350504221,131350504221,"Block Group 1, Census Tract 504.22, Gwinnett County, Georgia",1945,543,987,379,958,539
1500000US131350504222,131350504222,"Block Group 2, Census Tract 504.22, Gwinnett County, Georgia",2418,704,1143,390,1275,611
1500000US131350504223,131350504223,"Block Group 3, Census Tract 504.22, Gwinnett County, Georgia",4135,779,1536,487,2599,756
1500000US131350504231,131350504231,"Block Group 1, Census Tract 504.23, Gwinnett County, Georgia",2621,509,1865,457,756,316
1500000US131350504232,131350504232,"Block Group 2, Census Tract 504.23, Gwinnett County, Georgia",2380,569,1483,483,897,371
1500000US131350504233,131350504233,"Block Group 3, Census Tract 504.23, Gwinnett County, Georgia",2325,757,1416,571,909,532
1500000US131350504241,131350504241,"Block Group 1, Census Tract 504.24, Gwinnett County, Georgia",2332,708,935,406,1397,675
1500000US131350504242,131350504242,"Block Group 2, Census Tract 504.24, Gwinnett County, Georgia",3930,978,1955,594,1975,803
1500000US131350504243,131350504243,"Block Group 3, Census Tract 504.24, Gwinnett County, Georgia",1649,446,788,249,861,451
1500000US131350504251,131350504251,"Block Group 1, Census Tract 504.25, Gwinnett County, Georgia",1356,334,1348,334,8,14
1500000US131350504252,131350504252,"Block Group 2, Census Tract 504.25, Gwinnett County, Georgia",1633,280,1512,272,121,120
1500000US131350504253,131350504253,"Block Group 3, Census Tract 504.25, Gwinnett County, Georgia",2459,345,2251,319,208,217
1500000US131350504261,131350504261,"Block Group 1, Census Tract 504.26, Gwinnett County, Georgia",1722,545,1486,480,236,204
1500000US131350504262,131350504262,"Block Group 2, Census Tract 504.26, Gwinnett County, Georgia",760,269,760,269,0,13
1500000US131350504263,131350504263,"Block Group 3, Census Tract 504.26, Gwinnett County, Georgia",928,373,928,373,0,13
1500000US131350504264,131350504264,"Block Group 4, Census Tract 504.26, Gwinnett County, Georgia",1599,483,1444,458,155,166
1500000US131350504265,131350504265,"Block Group 5, Census Tract 504.26, Gwinnett County, Georgia",1807,330,1807,330,0,13
1500000US131350504271,131350504271,"Block Group 1, Census Tract 504.27, Gwinnett County, Georgia",3194,434,2637,370,557,349
1500000US131350504272,131350504272,"Block Group 2, Census Tract 504.27, Gwinnett County, Georgia",2031,302,1830,266,201,220
1500000US131350504273,131350504273,"Block Group 3, Census Tract 504.27, Gwinnett County, Georgia",1073,314,1056,315,17,24
1500000US131350504281,131350504281,"Block Group 1, Census Tract 504.28, Gwinnett County, Georgia",1695,395,1551,380,144,122
1500000US131350504282,131350504282,"Block Group 2, Census Tract 504.28, Gwinnett County, Georgia",1092,391,1071,396,21,29
1500000US131350504283,131350504283,"Block Group 3, Census Tract 504.28, Gwinnett County, Georgia",2339,295,2267,272,72,92
1500000US131350504284,131350504284,"Block Group 4, Census Tract 504.28, Gwinnett County, Georgia",1645,310,1377,267,268,219
1500000US131350504291,131350504291,"Block Group 1, Census Tract 504.29, Gwinnett County, Georgia",2348,446,2237,451,111,121
1500000US131350504292,131350504292,"Block Group 2, Census Tract 504.29, Gwinnett County, Georgia",3166,594,2844,582,322,259
1500000US131350504293,131350504293,"Block Group 3, Census Tract 504.29, Gwinnett County, Georgia",1790,470,1565,498,225,151
1500000US131350504301,131350504301,"Block Group 1, Census Tract 504.30, Gwinnett County, Georgia",1452,342,1289,327,163,141
1500000US131350504302,131350504302,"Block Group 2, Census Tract 504.30, Gwinnett County, Georgia",1327,374,1000,384,327,386
1500000US131350504303,131350504303,"Block Group 3, Census Tract 504.30, Gwinnett County, Georgia",2675,372,2539,349,136,111
1500000US131350504311,131350504311,"Block Group 1, Census Tract 504.31, Gwinnett County, Georgia",1067,486,557,236,510,413
1500000US131350504312,131350504312,"Block Group 2, Census Tract 504.31, Gwinnett County, Georgia",3099,739,2280,657,819,476
1500000US131350504313,131350504313,"Block Group 3, Census Tract 504.31, Gwinnett County, Georgia",4231,572,3329,420,902,447
1500000US131350504321,131350504321,"Block Group 1, Census Tract 504.32, Gwinnett County, Georgia",1382,322,751,255,631,316
1500000US131350504322,131350504322,"Block Group 2, Census Tract 504.32, Gwinnett County, Georgia",1860,560,1535,515,325,292
1500000US131350504323,131350504323,"Block Group 3, Census Tract 504.32, Gwinnett County, Georgia",2824,429,2380,330,444,301
1500000US131350504331,131350504331,"Block Group 1, Census Tract 504.33, Gwinnett County, Georgia",2337,254,1494,211,843,218
1500000US131350504341,131350504341,"Block Group 1, Census Tract 504.34, Gwinnett County, Georgia",2005,828,939,491,1066,641
1500000US131350504342,131350504342,"Block Group 2, Census Tract 504.34, Gwinnett County, Georgia",4658,993,1561,472,3097,1072
1500000US131350504343,131350504343,"Block Group 3, Census Tract 504.34, Gwinnett County, Georgia",1251,701,599,271,652,618
1500000US131350504351,131350504351,"Block Group 1, Census Tract 504.35, Gwinnett County, Georgia",2451,684,1255,475,1196,505
1500000US131350504352,131350504352,"Block Group 2, Census Tract 504.35, Gwinnett County, Georgia",1072,398,915,360,157,112
1500000US131350504361,131350504361,"Block Group 1, Census Tract 504.36, Gwinnett County, Georgia",1351,360,1139,333,212,181
1500000US131350504362,131350504362,"Block Group 2, Census Tract 504.36, Gwinnett County, Georgia",1544,558,856,390,688,427
1500000US131350504363,131350504363,"Block Group 3, Census Tract 504.36, Gwinnett County, Georgia",1394,543,1164,460,230,348
1500000US131350504364,131350504364,"Block Group 4, Census Tract 504.36, Gwinnett County, Georgia",856,364,676,335,180,214
1500000US131350504365,131350504365,"Block Group 5, Census Tract 504.36, Gwinnett County, Georgia",1454,619,621,386,833,571
1500000US131350505111,131350505111,"Block Group 1, Census Tract 505.11, Gwinnett County, Georgia",2537,650,2223,603,314,323
1500000US131350505112,131350505112,"Block Group 2, Census Tract 505.11, Gwinnett County, Georgia",3386,680,2518,694,868,508
1500000US131350505113,131350505113,"Block Group 3, Census Tract 505.11, Gwinnett County, Georgia",5268,947,2580,689,2688,703
1500000US131350505201,131350505201,"Block Group 1, Census Tract 505.20, Gwinnett County, Georgia",1811,311,1373,262,438,150
1500000US131350505202,131350505202,"Block Group 2, Census Tract 505.20, Gwinnett County, Georgia",1315,338,1012,301,303,253
1500000US131350505203,131350505203,"Block Group 3, Census Tract 505.20, Gwinnett County, Georgia",1718,413,1571,412,147,136
1500000US131350505211,131350505211,"Block Group 1, Census Tract 505.21, Gwinnett County, Georgia",733,301,563,230,170,211
1500000US131350505212,131350505212,"Block Group 2, Census Tract 505.21, Gwinnett County, Georgia",1471,389,992,305,479,256
1500000US131350505213,131350505213,"Block Group 3, Census Tract 505.21, Gwinnett County, Georgia",1952,413,1547,352,405,278
1500000US131350505214,131350505214,"Block Group 4, Census Tract 505.21, Gwinnett County, Georgia",1382,395,979,328,403,259
1500000US131350505221,131350505221,"Block Group 1, Census Tract 505.22, Gwinnett County, Georgia",1305,464,1086,397,219,185
1500000US131350505222,131350505222,"Block Group 2, Census Tract 505.22, Gwinnett County, Georgia",4029,739,3169,570,860,527
1500000US131350505231,131350505231,"Block Group 1, Census Tract 505.23, Gwinnett County, Georgia",3229,682,2787,681,442,313
1500000US131350505232,131350505232,"Block Group 2, Census Tract 505.23, Gwinnett County, Georgia",943,553,937,553,6,22
1500000US131350505233,131350505233,"Block Group 3, Census Tract 505.23, Gwinnett County, Georgia",2844,737,1724,706,1120,746
1500000US131350505241,131350505241,"Block Group 1, Census Tract 505.24, Gwinnett County, Georgia",3168,602,1853,285,1315,553
1500000US131350505242,131350505242,"Block Group 2, Census Tract 505.24, Gwinnett County, Georgia",2994,638,1471,287,1523,573
1500000US131350505251,131350505251,"Block Group 1, Census Tract 505.25, Gwinnett County, Georgia",2435,667,1907,487,528,394
1500000US131350505252,131350505252,"Block Group 2, Census Tract 505.25, Gwinnett County, Georgia",1626,618,1375,544,251,238
1500000US131350505253,131350505253,"Block Group 3, Census Tract 505.25, Gwinnett County, Georgia",2677,589,2402,561,275,216
1500000US131350505254,131350505254,"Block Group 4, Census Tract 505.25, Gwinnett County, Georgia",1465,495,1394,481,71,109
1500000US131350505261,131350505261,"Block Group 1, Census Tract 505.26, Gwinnett County, Georgia",3045,525,1437,354,1608,517
1500000US131350505262,131350505262,"Block Group 2, Census Tract 505.26, Gwinnett County, Georgia",1796,434,1265,384,531,356
1500000US131350505271,131350505271,"Block Group 1, Census Tract 505.27, Gwinnett County, Georgia",2385,469,1893,492,492,381
1500000US131350505272,131350505272,"Block Group 2, Census Tract 505.27, Gwinnett County, Georgia",2239,487,1851,407,388,378
1500000US131350505273,131350505273,"Block Group 3, Census Tract 505.27, Gwinnett County, Georgia",1726,363,1543,297,183,197
1500000US131350505281,131350505281,"Block Group 1, Census Tract 505.28, Gwinnett County, Georgia",3367,463,3079,451,288,188
1500000US131350505282,131350505282,"Block Group 2, Census Tract 505.28, Gwinnett County, Georgia",1863,367,1625,334,238,237
1500000US131350505291,131350505291,"Block Group 1, Census Tract 505.29, Gwinnett County, Georgia",2487,392,2304,398,183,189
1500000US131350505292,131350505292,"Block Group 2, Census Tract 505.29, Gwinnett County, Georgia",1528,401,1159,295,369,234
1500000US131350505301,131350505301,"Block Group 1, Census Tract 505.30, Gwinnett County, Georgia",4082,438,3790,436,292,168
1500000US131350505302,131350505302,"Block Group 2, Census Tract 505.30, Gwinnett County, Georgia",1296,314,1207,322,89,116
1500000US131350505303,131350505303,"Block Group 3, Census Tract 505.30, Gwinnett County, Georgia",682,223,672,224,10,16
1500000US131350505311,131350505311,"Block Group 1, Census Tract 505.31, Gwinnett County, Georgia",2928,1007,2127,699,801,709
1500000US131350505312,131350505312,"Block Group 2, Census Tract 505.31, Gwinnett County, Georgia",2252,1020,1121,432,1131,965
1500000US131350505313,131350505313,"Block Group 3, Census Tract 505.31, Gwinnett County, Georgia",3492,878,2015,529,1477,700
1500000US131350505321,131350505321,"Block Group 1, Census Tract 505.32, Gwinnett County, Georgia",3842,846,3274,825,568,402
1500000US131350505322,131350505322,"Block Group 2, Census Tract 505.32, Gwinnett County, Georgia",4096,645,3423,485,673,392
1500000US131350505331,131350505331,"Block Group 1, Census Tract 505.33, Gwinnett County, Georgia",1837,566,1554,538,283,255
1500000US131350505332,131350505332,"Block Group 2, Census Tract 505.33, Gwinnett County, Georgia",4290,865,2660,704,1630,734
1500000US131350505333,131350505333,"Block Group 3, Census Tract 505.33, Gwinnett County, Georgia",1839,536,887,355,952,544
1500000US131350505341,131350505341,"Block Group 1, Census Tract 505.34, Gwinnett County, Georgia",3977,732,2297,518,1680,569
1500000US131350505342,131350505342,"Block Group 2, Census Tract 505.34, Gwinnett County, Georgia",2076,565,1398,456,678,554
1500000US131350505343,131350505343,"Block Group 3, Census Tract 505.34, Gwinnett County, Georgia",2322,552,1651,439,671,373
1500000US131350505351,131350505351,"Block Group 1, Census Tract 505.35, Gwinnett County, Georgia",3055,777,2257,541,798,595
1500000US131350505352,131350505352,"Block Group 2, Census Tract 505.35, Gwinnett County, Georgia",4083,730,2683,503,1400,609
1500000US131350505361,131350505361,"Block Group 1, Census Tract 505.36, Gwinnett County, Georgia",1522,305,1233,252,289,210
1500000US131350505362,131350505362,"Block Group 2, Census Tract 505.36, Gwinnett County, Georgia",1129,407,804,328,325,229
1500000US131350505363,131350505363,"Block Group 3, Census Tract 505.36, Gwinnett County, Georgia",2397,610,1670,513,727,411
1500000US131350505371,131350505371,"Block Group 1, Census Tract 505.37, Gwinnett County, Georgia",1827,486,1141,303,686,434
1500000US131350505372,131350505372,"Block Group 2, Census Tract 505.37, Gwinnett County, Georgia",3008,621,2154,469,854,433
1500000US131350505381,131350505381,"Block Group 1, Census Tract 505.38, Gwinnett County, Georgia",2198,560,2152,565,46,55
1500000US131350505382,131350505382,"Block Group 2, Census Tract 505.38, Gwinnett County, Georgia",3659,886,2554,658,1105,782
1500000US131350505383,131350505383,"Block Group 3, Census Tract 505.38, Gwinnett County, Georgia",1983,724,1851,724,132,123
1500000US131350505391,131350505391,"Block Group 1, Census Tract 505.39, Gwinnett County, Georgia",3114,637,1672,407,1442,700
1500000US131350505392,131350505392,"Block Group 2, Census Tract 505.39, Gwinnett County, Georgia",1919,408,994,281,925,352
1500000US131350505401,131350505401,"Block Group 1, Census Tract 505.40, Gwinnett County, Georgia",2901,646,2214,513,687,505
1500000US131350505402,131350505402,"Block Group 2, Census Tract 505.40, Gwinnett County, Georgia",1984,632,1731,556,253,302
1500000US131350505403,131350505403,"Block Group 3, Census Tract 505.40, Gwinnett County, Georgia",2159,711,2159,711,0,13
1500000US131350505411,131350505411,"Block Group 1, Census Tract 505.41, Gwinnett County, Georgia",2176,795,1277,370,899,783
1500000US131350505412,131350505412,"Block Group 2, Census Tract 505.41, Gwinnett County, Georgia",1547,366,616,269,931,368
1500000US131350505413,131350505413,"Block Group 3, Census Tract 505.41, Gwinnett County, Georgia",2270,557,1164,406,1106,341
1500000US131350505421,131350505421,"Block Group 1, Census Tract 505.42, Gwinnett County, Georgia",4798,776,3690,571,1108,688
1500000US131350505431,131350505431,"Block Group 1, Census Tract 505.43, Gwinnett County, Georgia",3795,651,3418,493,377,343
1500000US131350505432,131350505432,"Block Group 2, Census Tract 505.43, Gwinnett County, Georgia",3337,609,2669,460,668,426
1500000US131350505441,131350505441,"Block Group 1, Census Tract 505.44, Gwinnett County, Georgia",4078,746,3723,728,355,278
1500000US131350505442,131350505442,"Block Group 2, Census Tract 505.44, Gwinnett County, Georgia",3506,832,3059,846,447,352
1500000US131350505443,131350505443,"Block Group 3, Census Tract 505.44, Gwinnett County, Georgia",4308,1020,3835,988,473,314
1500000US131350505451,131350505451,"Block Group 1, Census Tract 505.45, Gwinnett County, Georgia",2692,1019,2240,882,452,373
1500000US131350505452,131350505452,"Block Group 2, Census Tract 505.45, Gwinnett County, Georgia",4147,1372,2137,718,2010,1248
1500000US131350505453,131350505453,"Block Group 3, Census Tract 505.45, Gwinnett County, Georgia",4558,991,4102,957,456,266
1500000US131350505461,131350505461,"Block Group 1, Census Tract 505.46, Gwinnett County, Georgia",10230,1422,9024,1405,1206,802
1500000US131350505462,131350505462,"Block Group 2, Census Tract 505.46, Gwinnett County, Georgia",2949,1120,1145,653,1804,1010
1500000US131350505463,131350505463,"Block Group 3, Census Tract 505.46, Gwinnett County, Georgia",3678,1382,2976,1065,702,672
1500000US131350505471,131350505471,"Block Group 1, Census Tract 505.47, Gwinnett County, Georgia",5168,861,4629,828,539,527
1500000US131350505472,131350505472,"Block Group 2, Census Tract 505.47, Gwinnett County, Georgia",2995,686,2718,668,277,172
1500000US131350505481,131350505481,"Block Group 1, Census Tract 505.48, Gwinnett County, Georgia",4460,640,3634,623,826,364
1500000US131350505482,131350505482,"Block Group 2, Census Tract 505.48, Gwinnett County, Georgia",2627,479,2254,482,373,236
1500000US131350505483,131350505483,"Block Group 3, Census Tract 505.48, Gwinnett County, Georgia",3933,686,3685,633,248,220
1500000US131350505491,131350505491,"Block Group 1, Census Tract 505.49, Gwinnett County, Georgia",3726,563,2999,371,727,482
1500000US131350505492,131350505492,"Block Group 2, Census Tract 505.49, Gwinnett County, Georgia",1470,374,1376,374,94,73
1500000US131350506051,131350506051,"Block Group 1, Census Tract 506.05, Gwinnett County, Georgia",7977,1387,6153,976,1824,1126
1500000US131350506052,131350506052,"Block Group 2, Census Tract 506.05, Gwinnett County, Georgia",2050,712,2014,722,36,56
1500000US131350506053,131350506053,"Block Group 3, Census Tract 506.05, Gwinnett County, Georgia",4473,1251,3321,1063,1152,869
1500000US131350506061,131350506061,"Block Group 1, Census Tract 506.06, Gwinnett County, Georgia",6434,1490,5800,1286,634,764
1500000US131350506062,131350506062,"Block Group 2, Census Tract 506.06, Gwinnett County, Georgia",7353,1630,6350,1501,1003,963
1500000US131350506063,131350506063,"Block Group 3, Census Tract 506.06, Gwinnett County, Georgia",9639,1838,9167,1925,472,576
1500000US131350506071,131350506071,"Block Group 1, Census Tract 506.07, Gwinnett County, Georgia",10219,1547,9335,1360,884,504
1500000US131350506072,131350506072,"Block Group 2, Census Tract 506.07, Gwinnett County, Georgia",6940,1299,5514,1334,1426,750
1500000US131350506081,131350506081,"Block Group 1, Census Tract 506.08, Gwinnett County, Georgia",8285,1428,5886,1112,2399,1334
1500000US131350506082,131350506082,"Block Group 2, Census Tract 506.08, Gwinnett County, Georgia",6437,1372,5163,1255,1274,869
1500000US131350506083,131350506083,"Block Group 3, Census Tract 506.08, Gwinnett County, Georgia",2633,836,1594,667,1039,900
1500000US131350506091,131350506091,"Block Group 1, Census Tract 506.09, Gwinnett County, Georgia",2052,646,1640,595,412,332
1500000US131350506092,131350506092,"Block Group 2, Census Tract 506.09, Gwinnett County, Georgia",6445,651,6079,597,366,285
1500000US131350506093,131350506093,"Block Group 3, Census Tract 506.09, Gwinnett County, Georgia",3035,908,2887,878,148,159
1500000US131350506101,131350506101,"Block Group 1, Census Tract 506.10, Gwinnett County, Georgia",5186,972,4772,941,414,312
1500000US131350506102,131350506102,"Block Group 2, Census Tract 506.10, Gwinnett County, Georgia",4387,1201,3552,649,835,912
1500000US131350506103,131350506103,"Block Group 3, Census Tract 506.10, Gwinnett County, Georgia",3456,850,3456,850,0,13
1500000US131350506104,131350506104,"Block Group 4, Census Tract 506.10, Gwinnett County, Georgia",3796,705,3451,710,345,388
1500000US131350507091,131350507091,"Block Group 1, Census Tract 507.09, Gwinnett County, Georgia",5528,843,4982,862,546,350
1500000US131350507092,131350507092,"Block Group 2, Census Tract 507.09, Gwinnett County, Georgia",2693,657,1792,545,901,552
1500000US131350507093,131350507093,"Block Group 3, Census Tract 507.09, Gwinnett County, Georgia",4377,749,4239,763,138,200
1500000US131350507121,131350507121,"Block Group 1, Census Tract 507.12, Gwinnett County, Georgia",1708,340,1671,344,37,43
1500000US131350507122,131350507122,"Block Group 2, Census Tract 507.12, Gwinnett County, Georgia",1666,423,1615,423,51,62
1500000US131350507123,131350507123,"Block Group 3, Census Tract 507.12, Gwinnett County, Georgia",2054,533,1366,379,688,550
1500000US131350507124,131350507124,"Block Group 4, Census Tract 507.12, Gwinnett County, Georgia",1351,328,1321,341,30,46
1500000US131350507131,131350507131,"Block Group 1, Census Tract 507.13, Gwinnett County, Georgia",4348,568,3931,597,417,116
1500000US131350507132,131350507132,"Block Group 2, Census Tract 507.13, Gwinnett County, Georgia",659,183,644,179,15,26
1500000US131350507133,131350507133,"Block Group 3, Census Tract 507.13, Gwinnett County, Georgia",1553,316,1531,312,22,45
1500000US131350507134,131350507134,"Block Group 4, Census Tract 507.13, Gwinnett County, Georgia",1092,319,1092,319,0,13
1500000US131350507141,131350507141,"Block Group 1, Census Tract 507.14, Gwinnett County, Georgia",2476,381,2224,344,252,191
1500000US131350507142,131350507142,"Block Group 2, Census Tract 507.14, Gwinnett County, Georgia",2988,354,2818,363,170,120
1500000US131350507151,131350507151,"Block Group 1, Census Tract 507.15, Gwinnett County, Georgia",2844,420,2213,316,631,344
1500000US131350507152,131350507152,"Block Group 2, Census Tract 507.15, Gwinnett County, Georgia",1529,428,1141,231,388,428
1500000US131350507153,131350507153,"Block Group 3, Census Tract 507.15, Gwinnett County, Georgia",1437,259,1437,259,0,13
1500000US131350507181,131350507181,"Block Group 1, Census Tract 507.18, Gwinnett County, Georgia",2338,593,2338,593,0,13
1500000US131350507182,131350507182,"Block Group 2, Census Tract 507.18, Gwinnett County, Georgia",2426,524,2106,485,320,157
1500000US131350507183,131350507183,"Block Group 3, Census Tract 507.18, Gwinnett County, Georgia",530,172,530,172,0,13
1500000US131350507184,131350507184,"Block Group 4, Census Tract 507.18, Gwinnett County, Georgia",3087,583,2923,560,164,158
1500000US131350507191,131350507191,"Block Group 1, Census Tract 507.19, Gwinnett County, Georgia",3276,436,2803,442,473,174
1500000US131350507192,131350507192,"Block Group 2, Census Tract 507.19, Gwinnett County, Georgia",2172,509,1894,479,278,289
1500000US131350507201,131350507201,"Block Group 1, Census Tract 507.20, Gwinnett County, Georgia",2014,614,1925,600,89,133
1500000US131350507202,131350507202,"Block Group 2, Census Tract 507.20, Gwinnett County, Georgia",2700,904,2620,900,80,124
1500000US131350507203,131350507203,"Block Group 3, Census Tract 507.20, Gwinnett County, Georgia",1689,441,1639,457,50,88
1500000US131350507204,131350507204,"Block Group 4, Census Tract 507.20, Gwinnett County, Georgia",1531,407,1443,409,88,99
1500000US131350507211,131350507211,"Block Group 1, Census Tract 507.21, Gwinnett County, Georgia",3164,674,2570,609,594,386
1500000US131350507212,131350507212,"Block Group 2, Census Tract 507.21, Gwinnett County, Georgia",813,432,726,386,87,188
1500000US131350507213,131350507213,"Block Group 3, Census Tract 507.21, Gwinnett County, Georgia",2637,584,2478,551,159,259
1500000US131350507214,131350507214,"Block Group 4, Census Tract 507.21, Gwinnett County, Georgia",3104,684,2879,658,225,276
1500000US131350507221,131350507221,"Block Group 1, Census Tract 507.22, Gwinnett County, Georgia",3694,526,2566,326,1128,636
1500000US131350507231,131350507231,"Block Group 1, Census Tract 507.23, Gwinnett County, Georgia",1127,280,1026,262,101,121
1500000US131350507232,131350507232,"Block Group 2, Census Tract 507.23, Gwinnett County, Georgia",3271,544,2990,525,281,168
1500000US131350507233,131350507233,"Block Group 3, Census Tract 507.23, Gwinnett County, Georgia",3035,426,2920,428,115,108
1500000US131350507241,131350507241,"Block Group 1, Census Tract 507.24, Gwinnett County, Georgia",4711,1566,4619,1576,92,140
1500000US131350507242,131350507242,"Block Group 2, Census Tract 507.24, Gwinnett County, Georgia",5461,1115,5205,1125,256,228
1500000US131350507243,131350507243,"Block Group 3, Census Tract 507.24, Gwinnett County, Georgia",5693,951,5175,953,518,502
1500000US131350507251,131350507251,"Block Group 1, Census Tract 507.25, Gwinnett County, Georgia",2460,495,1951,491,509,203
1500000US131350507252,131350507252,"Block Group 2, Census Tract 507.25, Gwinnett County, Georgia",2469,603,2329,600,140,131
1500000US131350507253,131350507253,"Block Group 3, Census Tract 507.25, Gwinnett County, Georgia",997,278,989,280,8,12
1500000US131350507261,131350507261,"Block Group 1, Census Tract 507.26, Gwinnett County, Georgia",4070,888,3416,772,654,587
1500000US131350507262,131350507262,"Block Group 2, Census Tract 507.26, Gwinnett County, Georgia",5288,1006,4940,950,348,305
1500000US131350507271,131350507271,"Block Group 1, Census Tract 507.27, Gwinnett County, Georgia",2051,894,2051,894,0,13
1500000US131350507272,131350507272,"Block Group 2, Census Tract 507.27, Gwinnett County, Georgia",4446,761,4266,751,180,166
1500000US131350507273,131350507273,"Block Group 3, Census Tract 507.27, Gwinnett County, Georgia",3993,755,3741,730,252,213
1500000US131350507281,131350507281,"Block Group 1, Census Tract 507.28, Gwinnett County, Georgia",5114,1400,4398,1184,716,640
1500000US131350507282,131350507282,"Block Group 2, Census Tract 507.28, Gwinnett County, Georgia",3721,1226,3519,1198,202,265
1500000US131350507283,131350507283,"Block Group 3, Census Tract 507.28, Gwinnett County, Georgia",3022,951,2972,953,50,78
1500000US131350507284,131350507284,"Block Group 4, Census Tract 507.28, Gwinnett County, Georgia",1879,615,1879,615,0,13
1500000US131350507291,131350507291,"Block Group 1, Census Tract 507.29, Gwinnett County, Georgia",797,301,589,238,208,223
1500000US131350507292,131350507292,"Block Group 2, Census Tract 507.29, Gwinnett County, Georgia",2495,480,2394,468,101,86
1500000US131350507301,131350507301,"Block Group 1, Census Tract 507.30, Gwinnett County, Georgia",3827,1012,3713,1042,114,152
1500000US131350507302,131350507302,"Block Group 2, Census Tract 507.30, Gwinnett County, Georgia",3239,953,2731,874,508,288
1500000US131350507311,131350507311,"Block Group 1, Census Tract 507.31, Gwinnett County, Georgia",4966,970,4528,992,438,285
1500000US131350507312,131350507312,"Block Group 2, Census Tract 507.31, Gwinnett County, Georgia",4429,756,3880,781,549,316
1500000US131370001001,131370001001,"Block Group 1, Census Tract 1, Habersham County, Georgia",1491,314,1491,314,0,13
1500000US131370001002,131370001002,"Block Group 2, Census Tract 1, Habersham County, Georgia",2338,333,2275,330,63,79
1500000US131370002011,131370002011,"Block Group 1, Census Tract 2.01, Habersham County, Georgia",1940,474,1712,314,228,312
1500000US131370002012,131370002012,"Block Group 2, Census Tract 2.01, Habersham County, Georgia",1967,372,1967,372,0,13
1500000US131370002021,131370002021,"Block Group 1, Census Tract 2.02, Habersham County, Georgia",1201,357,1201,357,0,13
1500000US131370002022,131370002022,"Block Group 2, Census Tract 2.02, Habersham County, Georgia",2130,460,2115,460,15,29
1500000US131370002023,131370002023,"Block Group 3, Census Tract 2.02, Habersham County, Georgia",1877,316,1871,317,6,12
1500000US131370003001,131370003001,"Block Group 1, Census Tract 3, Habersham County, Georgia",1351,429,939,194,412,420
1500000US131370003002,131370003002,"Block Group 2, Census Tract 3, Habersham County, Georgia",1364,278,1240,267,124,129
1500000US131370003003,131370003003,"Block Group 3, Census Tract 3, Habersham County, Georgia",1312,239,1192,216,120,114
1500000US131370004001,131370004001,"Block Group 1, Census Tract 4, Habersham County, Georgia",3348,524,2902,499,446,211
1500000US131370004002,131370004002,"Block Group 2, Census Tract 4, Habersham County, Georgia",1190,267,919,171,271,248
1500000US131370004003,131370004003,"Block Group 3, Census Tract 4, Habersham County, Georgia",980,246,972,246,8,15
1500000US131370005001,131370005001,"Block Group 1, Census Tract 5, Habersham County, Georgia",1801,480,1508,376,293,249
1500000US131370005002,131370005002,"Block Group 2, Census Tract 5, Habersham County, Georgia",1693,509,1655,514,38,43
1500000US131370005003,131370005003,"Block Group 3, Census Tract 5, Habersham County, Georgia",1671,418,1553,407,118,98
1500000US131370005004,131370005004,"Block Group 4, Census Tract 5, Habersham County, Georgia",543,232,517,237,26,41
1500000US131370005005,131370005005,"Block Group 5, Census Tract 5, Habersham County, Georgia",898,254,872,253,26,38
1500000US131370006011,131370006011,"Block Group 1, Census Tract 6.01, Habersham County, Georgia",1798,353,1224,261,574,249
1500000US131370006012,131370006012,"Block Group 2, Census Tract 6.01, Habersham County, Georgia",3656,453,3456,440,200,142
1500000US131370006013,131370006013,"Block Group 3, Census Tract 6.01, Habersham County, Georgia",606,187,606,187,0,13
1500000US131370006021,131370006021,"Block Group 1, Census Tract 6.02, Habersham County, Georgia",1235,312,1017,264,218,220
1500000US131370006022,131370006022,"Block Group 2, Census Tract 6.02, Habersham County, Georgia",1829,425,1829,425,0,13
1500000US131370006023,131370006023,"Block Group 3, Census Tract 6.02, Habersham County, Georgia",2834,527,1362,301,1472,495
1500000US131370006024,131370006024,"Block Group 4, Census Tract 6.02, Habersham County, Georgia",1521,396,932,258,589,382
1500000US131370006025,131370006025,"Block Group 5, Census Tract 6.02, Habersham County, Georgia",953,377,316,178,637,364
1500000US131390001011,131390001011,"Block Group 1, Census Tract 1.01, Hall County, Georgia",1943,259,1873,256,70,53
1500000US131390001012,131390001012,"Block Group 2, Census Tract 1.01, Hall County, Georgia",2642,325,2319,291,323,277
1500000US131390001021,131390001021,"Block Group 1, Census Tract 1.02, Hall County, Georgia",2121,315,1878,291,243,190
1500000US131390001022,131390001022,"Block Group 2, Census Tract 1.02, Hall County, Georgia",1347,348,1244,353,103,108
1500000US131390002011,131390002011,"Block Group 1, Census Tract 2.01, Hall County, Georgia",2057,571,1897,530,160,253
1500000US131390002012,131390002012,"Block Group 2, Census Tract 2.01, Hall County, Georgia",1220,395,1196,381,24,39
1500000US131390002013,131390002013,"Block Group 3, Census Tract 2.01, Hall County, Georgia",2466,639,1571,409,895,529
1500000US131390002031,131390002031,"Block Group 1, Census Tract 2.03, Hall County, Georgia",2204,295,2200,295,4,6
1500000US131390002032,131390002032,"Block Group 2, Census Tract 2.03, Hall County, Georgia",2187,233,2187,233,0,13
1500000US131390002041,131390002041,"Block Group 1, Census Tract 2.04, Hall County, Georgia",1899,292,1884,292,15,34
1500000US131390002042,131390002042,"Block Group 2, Census Tract 2.04, Hall County, Georgia",2088,371,1858,395,230,161
1500000US131390003021,131390003021,"Block Group 1, Census Tract 3.02, Hall County, Georgia",1471,333,1471,333,0,13
1500000US131390003022,131390003022,"Block Group 2, Census Tract 3.02, Hall County, Georgia",2994,801,2279,598,715,495
1500000US131390003023,131390003023,"Block Group 3, Census Tract 3.02, Hall County, Georgia",1193,332,1193,332,0,13
1500000US131390003024,131390003024,"Block Group 4, Census Tract 3.02, Hall County, Georgia",1194,349,1157,338,37,73
1500000US131390003031,131390003031,"Block Group 1, Census Tract 3.03, Hall County, Georgia",1978,348,1735,324,243,274
1500000US131390003032,131390003032,"Block Group 2, Census Tract 3.03, Hall County, Georgia",777,381,777,381,0,13
1500000US131390003041,131390003041,"Block Group 1, Census Tract 3.04, Hall County, Georgia",2009,465,1668,336,341,221
1500000US131390003042,131390003042,"Block Group 2, Census Tract 3.04, Hall County, Georgia",1519,322,1466,291,53,109
1500000US131390003051,131390003051,"Block Group 1, Census Tract 3.05, Hall County, Georgia",1171,296,1035,231,136,161
1500000US131390003052,131390003052,"Block Group 2, Census Tract 3.05, Hall County, Georgia",3116,635,2686,398,430,534
1500000US131390003053,131390003053,"Block Group 3, Census Tract 3.05, Hall County, Georgia",598,185,598,185,0,13
1500000US131390004001,131390004001,"Block Group 1, Census Tract 4, Hall County, Georgia",1884,517,1853,508,31,48
1500000US131390004002,131390004002,"Block Group 2, Census Tract 4, Hall County, Georgia",1533,595,1271,475,262,315
1500000US131390004003,131390004003,"Block Group 3, Census Tract 4, Hall County, Georgia",1484,771,1410,652,74,131
1500000US131390004004,131390004004,"Block Group 4, Census Tract 4, Hall County, Georgia",1872,578,1046,368,826,733
1500000US131390005001,131390005001,"Block Group 1, Census Tract 5, Hall County, Georgia",891,273,871,273,20,31
1500000US131390005002,131390005002,"Block Group 2, Census Tract 5, Hall County, Georgia",2067,520,1196,370,871,436
1500000US131390005003,131390005003,"Block Group 3, Census Tract 5, Hall County, Georgia",499,243,499,243,0,13
1500000US131390005004,131390005004,"Block Group 4, Census Tract 5, Hall County, Georgia",2515,456,2467,436,48,75
1500000US131390005005,131390005005,"Block Group 5, Census Tract 5, Hall County, Georgia",1111,368,1024,339,87,105
1500000US131390006001,131390006001,"Block Group 1, Census Tract 6, Hall County, Georgia",1460,602,828,237,632,594
1500000US131390006002,131390006002,"Block Group 2, Census Tract 6, Hall County, Georgia",2313,699,1813,588,500,433
1500000US131390006003,131390006003,"Block Group 3, Census Tract 6, Hall County, Georgia",2164,548,1878,461,286,292
1500000US131390007011,131390007011,"Block Group 1, Census Tract 7.01, Hall County, Georgia",2425,485,1645,354,780,331
1500000US131390007012,131390007012,"Block Group 2, Census Tract 7.01, Hall County, Georgia",4002,630,2117,509,1885,530
1500000US131390007021,131390007021,"Block Group 1, Census Tract 7.02, Hall County, Georgia",3020,534,1598,296,1422,531
1500000US131390007022,131390007022,"Block Group 2, Census Tract 7.02, Hall County, Georgia",2670,523,635,240,2035,558
1500000US131390008001,131390008001,"Block Group 1, Census Tract 8, Hall County, Georgia",915,231,486,147,429,187
1500000US131390008002,131390008002,"Block Group 2, Census Tract 8, Hall County, Georgia",754,330,434,183,320,269
1500000US131390008003,131390008003,"Block Group 3, Census Tract 8, Hall County, Georgia",1947,354,1422,311,525,294
1500000US131390009001,131390009001,"Block Group 1, Census Tract 9, Hall County, Georgia",1262,343,1240,341,22,35
1500000US131390009002,131390009002,"Block Group 2, Census Tract 9, Hall County, Georgia",1498,363,1314,317,184,282
1500000US131390009003,131390009003,"Block Group 3, Census Tract 9, Hall County, Georgia",1464,591,686,176,778,563
1500000US131390009004,131390009004,"Block Group 4, Census Tract 9, Hall County, Georgia",1059,325,892,245,167,223
1500000US131390010021,131390010021,"Block Group 1, Census Tract 10.02, Hall County, Georgia",1231,247,1125,242,106,61
1500000US131390010022,131390010022,"Block Group 2, Census Tract 10.02, Hall County, Georgia",2310,634,1295,316,1015,619
1500000US131390010023,131390010023,"Block Group 3, Census Tract 10.02, Hall County, Georgia",3327,721,1369,342,1958,701
1500000US131390010031,131390010031,"Block Group 1, Census Tract 10.03, Hall County, Georgia",2537,598,587,215,1950,602
1500000US131390010032,131390010032,"Block Group 2, Census Tract 10.03, Hall County, Georgia",3219,676,1288,370,1931,579
1500000US131390010033,131390010033,"Block Group 3, Census Tract 10.03, Hall County, Georgia",872,477,199,174,673,471
1500000US131390010041,131390010041,"Block Group 1, Census Tract 10.04, Hall County, Georgia",3205,292,2523,341,682,219
1500000US131390011011,131390011011,"Block Group 1, Census Tract 11.01, Hall County, Georgia",1684,463,386,155,1298,471
1500000US131390011012,131390011012,"Block Group 2, Census Tract 11.01, Hall County, Georgia",1675,597,128,93,1547,601
1500000US131390011013,131390011013,"Block Group 3, Census Tract 11.01, Hall County, Georgia",1448,487,82,77,1366,483
1500000US131390011021,131390011021,"Block Group 1, Census Tract 11.02, Hall County, Georgia",4460,492,1126,257,3334,529
1500000US131390012011,131390012011,"Block Group 1, Census Tract 12.01, Hall County, Georgia",1651,433,1283,271,368,362
1500000US131390012012,131390012012,"Block Group 2, Census Tract 12.01, Hall County, Georgia",2116,623,1248,504,868,513
1500000US131390012013,131390012013,"Block Group 3, Census Tract 12.01, Hall County, Georgia",3663,602,1493,426,2170,463
1500000US131390012021,131390012021,"Block Group 1, Census Tract 12.02, Hall County, Georgia",4632,905,1578,452,3054,891
1500000US131390012022,131390012022,"Block Group 2, Census Tract 12.02, Hall County, Georgia",2089,661,1153,359,936,542
1500000US131390013011,131390013011,"Block Group 1, Census Tract 13.01, Hall County, Georgia",1972,368,1747,306,225,171
1500000US131390013012,131390013012,"Block Group 2, Census Tract 13.01, Hall County, Georgia",1395,478,569,221,826,433
1500000US131390013013,131390013013,"Block Group 3, Census Tract 13.01, Hall County, Georgia",2619,387,1926,409,693,340
1500000US131390013021,131390013021,"Block Group 1, Census Tract 13.02, Hall County, Georgia",2656,453,2571,420,85,80
1500000US131390013022,131390013022,"Block Group 2, Census Tract 13.02, Hall County, Georgia",2573,383,2196,384,377,161
1500000US131390014021,131390014021,"Block Group 1, Census Tract 14.02, Hall County, Georgia",1013,298,934,270,79,135
1500000US131390014022,131390014022,"Block Group 2, Census Tract 14.02, Hall County, Georgia",2119,383,1812,340,307,201
1500000US131390014023,131390014023,"Block Group 3, Census Tract 14.02, Hall County, Georgia",2402,449,1879,375,523,350
1500000US131390014031,131390014031,"Block Group 1, Census Tract 14.03, Hall County, Georgia",1663,455,741,289,922,388
1500000US131390014032,131390014032,"Block Group 2, Census Tract 14.03, Hall County, Georgia",1990,394,1363,327,627,384
1500000US131390014041,131390014041,"Block Group 1, Census Tract 14.04, Hall County, Georgia",3635,719,2611,574,1024,387
1500000US131390014042,131390014042,"Block Group 2, Census Tract 14.04, Hall County, Georgia",742,269,686,256,56,64
1500000US131390014043,131390014043,"Block Group 3, Census Tract 14.04, Hall County, Georgia",815,227,420,158,395,222
1500000US131390015011,131390015011,"Block Group 1, Census Tract 15.01, Hall County, Georgia",3030,432,2954,428,76,81
1500000US131390015012,131390015012,"Block Group 2, Census Tract 15.01, Hall County, Georgia",1577,362,1255,326,322,315
1500000US131390015021,131390015021,"Block Group 1, Census Tract 15.02, Hall County, Georgia",2135,461,2125,462,10,17
1500000US131390015022,131390015022,"Block Group 2, Census Tract 15.02, Hall County, Georgia",2825,635,1888,448,937,822
1500000US131390016031,131390016031,"Block Group 1, Census Tract 16.03, Hall County, Georgia",3077,469,2720,420,357,239
1500000US131390016032,131390016032,"Block Group 2, Census Tract 16.03, Hall County, Georgia",2247,450,1476,341,771,424
1500000US131390016041,131390016041,"Block Group 1, Census Tract 16.04, Hall County, Georgia",3136,554,2461,459,675,477
1500000US131390016042,131390016042,"Block Group 2, Census Tract 16.04, Hall County, Georgia",3589,525,3267,393,322,308
1500000US131390016051,131390016051,"Block Group 1, Census Tract 16.05, Hall County, Georgia",1605,364,1342,323,263,208
1500000US131390016052,131390016052,"Block Group 2, Census Tract 16.05, Hall County, Georgia",3748,357,3504,381,244,127
1500000US131390016061,131390016061,"Block Group 1, Census Tract 16.06, Hall County, Georgia",1573,341,1234,321,339,185
1500000US131390016062,131390016062,"Block Group 2, Census Tract 16.06, Hall County, Georgia",2257,377,2045,358,212,154
1500000US131390016071,131390016071,"Block Group 1, Census Tract 16.07, Hall County, Georgia",1569,402,1380,370,189,170
1500000US131390016072,131390016072,"Block Group 2, Census Tract 16.07, Hall County, Georgia",1853,391,1830,396,23,38
1500000US131390016073,131390016073,"Block Group 3, Census Tract 16.07, Hall County, Georgia",1364,360,1236,315,128,154
1500000US131390016081,131390016081,"Block Group 1, Census Tract 16.08, Hall County, Georgia",5615,361,5171,290,444,370
1500000US131414803001,131414803001,"Block Group 1, Census Tract 4803, Hancock County, Georgia",1823,313,1823,313,0,13
1500000US131414803002,131414803002,"Block Group 2, Census Tract 4803, Hancock County, Georgia",472,256,472,256,0,13
1500000US131414804001,131414804001,"Block Group 1, Census Tract 4804, Hancock County, Georgia",3026,573,2859,519,167,140
1500000US131414804002,131414804002,"Block Group 2, Census Tract 4804, Hancock County, Georgia",457,132,456,132,1,2
1500000US131414804003,131414804003,"Block Group 3, Census Tract 4804, Hancock County, Georgia",962,269,962,269,0,13
1500000US131414804004,131414804004,"Block Group 4, Census Tract 4804, Hancock County, Georgia",1052,324,1052,324,0,13
1500000US131414804005,131414804005,"Block Group 5, Census Tract 4804, Hancock County, Georgia",1089,252,1084,251,5,9
1500000US131430101001,131430101001,"Block Group 1, Census Tract 101, Haralson County, Georgia",1920,340,1920,340,0,13
1500000US131430101002,131430101002,"Block Group 2, Census Tract 101, Haralson County, Georgia",1523,389,1523,389,0,13
1500000US131430102001,131430102001,"Block Group 1, Census Tract 102, Haralson County, Georgia",849,324,849,324,0,13
1500000US131430102002,131430102002,"Block Group 2, Census Tract 102, Haralson County, Georgia",1937,501,1937,501,0,13
1500000US131430102003,131430102003,"Block Group 3, Census Tract 102, Haralson County, Georgia",2641,381,2641,381,0,13
1500000US131430102004,131430102004,"Block Group 4, Census Tract 102, Haralson County, Georgia",790,269,735,275,55,87
1500000US131430103011,131430103011,"Block Group 1, Census Tract 103.01, Haralson County, Georgia",1414,303,1414,303,0,13
1500000US131430103012,131430103012,"Block Group 2, Census Tract 103.01, Haralson County, Georgia",1918,285,1918,285,0,13
1500000US131430103021,131430103021,"Block Group 1, Census Tract 103.02, Haralson County, Georgia",1501,550,1407,482,94,120
1500000US131430103022,131430103022,"Block Group 2, Census Tract 103.02, Haralson County, Georgia",1915,503,1889,503,26,24
1500000US131430103023,131430103023,"Block Group 3, Census Tract 103.02, Haralson County, Georgia",1634,389,1634,389,0,13
1500000US131430103024,131430103024,"Block Group 4, Census Tract 103.02, Haralson County, Georgia",464,232,464,232,0,13
1500000US131430103025,131430103025,"Block Group 5, Census Tract 103.02, Haralson County, Georgia",1610,460,1610,460,0,13
1500000US131430103026,131430103026,"Block Group 6, Census Tract 103.02, Haralson County, Georgia",613,229,613,229,0,13
1500000US131430104001,131430104001,"Block Group 1, Census Tract 104, Haralson County, Georgia",2971,528,2938,518,33,42
1500000US131430104002,131430104002,"Block Group 2, Census Tract 104, Haralson County, Georgia",2224,472,2159,477,65,82
1500000US131430104003,131430104003,"Block Group 3, Census Tract 104, Haralson County, Georgia",2641,493,2537,465,104,91
1500000US131451201981,131451201981,"Block Group 1, Census Tract 1201.98, Harris County, Georgia",2181,491,2132,484,49,71
1500000US131451201982,131451201982,"Block Group 2, Census Tract 1201.98, Harris County, Georgia",1391,319,1391,319,0,13
1500000US131451201983,131451201983,"Block Group 3, Census Tract 1201.98, Harris County, Georgia",575,197,558,196,17,27
1500000US131451201984,131451201984,"Block Group 4, Census Tract 1201.98, Harris County, Georgia",1033,265,1010,256,23,35
1500000US131451202001,131451202001,"Block Group 1, Census Tract 1202, Harris County, Georgia",1742,342,1726,342,16,21
1500000US131451202002,131451202002,"Block Group 2, Census Tract 1202, Harris County, Georgia",2054,428,1986,403,68,73
1500000US131451203001,131451203001,"Block Group 1, Census Tract 1203, Harris County, Georgia",1370,344,1354,341,16,23
1500000US131451203002,131451203002,"Block Group 2, Census Tract 1203, Harris County, Georgia",1776,470,1703,462,73,87
1500000US131451203003,131451203003,"Block Group 3, Census Tract 1203, Harris County, Georgia",2320,481,2159,465,161,152
1500000US131451203004,131451203004,"Block Group 4, Census Tract 1203, Harris County, Georgia",920,314,910,314,10,19
1500000US131451203005,131451203005,"Block Group 5, Census Tract 1203, Harris County, Georgia",2730,456,2730,456,0,13
1500000US131451204011,131451204011,"Block Group 1, Census Tract 1204.01, Harris County, Georgia",2781,455,2726,423,55,87
1500000US131451204012,131451204012,"Block Group 2, Census Tract 1204.01, Harris County, Georgia",3748,581,3378,526,370,176
1500000US131451204021,131451204021,"Block Group 1, Census Tract 1204.02, Harris County, Georgia",1175,404,1175,404,0,13
1500000US131451204022,131451204022,"Block Group 2, Census Tract 1204.02, Harris County, Georgia",4930,576,4787,551,143,142
1500000US131451204023,131451204023,"Block Group 3, Census Tract 1204.02, Harris County, Georgia",2050,596,2016,608,34,47
1500000US131479601001,131479601001,"Block Group 1, Census Tract 9601, Hart County, Georgia",1512,452,1488,451,24,36
1500000US131479601002,131479601002,"Block Group 2, Census Tract 9601, Hart County, Georgia",833,243,833,243,0,13
1500000US131479601003,131479601003,"Block Group 3, Census Tract 9601, Hart County, Georgia",1327,356,1309,357,18,32
1500000US131479601004,131479601004,"Block Group 4, Census Tract 9601, Hart County, Georgia",856,360,772,348,84,115
1500000US131479601005,131479601005,"Block Group 5, Census Tract 9601, Hart County, Georgia",1152,404,1152,404,0,13
1500000US131479602001,131479602001,"Block Group 1, Census Tract 9602, Hart County, Georgia",1481,288,1474,289,7,8
1500000US131479602002,131479602002,"Block Group 2, Census Tract 9602, Hart County, Georgia",1112,246,1112,246,0,13
1500000US131479602003,131479602003,"Block Group 3, Census Tract 9602, Hart County, Georgia",723,210,723,210,0,13
1500000US131479603001,131479603001,"Block Group 1, Census Tract 9603, Hart County, Georgia",1808,330,1796,333,12,20
1500000US131479603002,131479603002,"Block Group 2, Census Tract 9603, Hart County, Georgia",1456,273,1393,263,63,82
1500000US131479604001,131479604001,"Block Group 1, Census Tract 9604, Hart County, Georgia",1462,411,1462,411,0,13
1500000US131479604002,131479604002,"Block Group 2, Census Tract 9604, Hart County, Georgia",2156,438,1929,427,227,181
1500000US131479604003,131479604003,"Block Group 3, Census Tract 9604, Hart County, Georgia",713,283,548,213,165,225
1500000US131479604004,131479604004,"Block Group 4, Census Tract 9604, Hart County, Georgia",973,270,962,270,11,15
1500000US131479605001,131479605001,"Block Group 1, Census Tract 9605, Hart County, Georgia",1386,456,1386,456,0,13
1500000US131479605002,131479605002,"Block Group 2, Census Tract 9605, Hart County, Georgia",1558,425,1548,422,10,15
1500000US131479605003,131479605003,"Block Group 3, Census Tract 9605, Hart County, Georgia",892,429,855,434,37,42
1500000US131479605004,131479605004,"Block Group 4, Census Tract 9605, Hart County, Georgia",2150,343,2128,342,22,22
1500000US131479605005,131479605005,"Block Group 5, Census Tract 9605, Hart County, Georgia",1948,501,1709,450,239,244
1500000US131499701001,131499701001,"Block Group 1, Census Tract 9701, Heard County, Georgia",1462,391,1346,356,116,128
1500000US131499701002,131499701002,"Block Group 2, Census Tract 9701, Heard County, Georgia",1698,320,1564,275,134,122
1500000US131499701003,131499701003,"Block Group 3, Census Tract 9701, Heard County, Georgia",1345,240,1345,240,0,13
1500000US131499702001,131499702001,"Block Group 1, Census Tract 9702, Heard County, Georgia",1882,376,1882,376,0,13
1500000US131499702002,131499702002,"Block Group 2, Census Tract 9702, Heard County, Georgia",1259,202,1259,202,0,13
1500000US131499702003,131499702003,"Block Group 3, Census Tract 9702, Heard County, Georgia",1052,185,1031,175,21,31
1500000US131499703001,131499703001,"Block Group 1, Census Tract 9703, Heard County, Georgia",1151,214,1151,214,0,13
1500000US131499703002,131499703002,"Block Group 2, Census Tract 9703, Heard County, Georgia",1768,270,1768,270,0,13
1500000US131510701041,131510701041,"Block Group 1, Census Tract 701.04, Henry County, Georgia",5921,775,5465,763,456,233
1500000US131510701042,131510701042,"Block Group 2, Census Tract 701.04, Henry County, Georgia",2559,723,2559,723,0,13
1500000US131510701043,131510701043,"Block Group 3, Census Tract 701.04, Henry County, Georgia",3857,959,3796,963,61,84
1500000US131510701061,131510701061,"Block Group 1, Census Tract 701.06, Henry County, Georgia",3445,543,3124,519,321,262
1500000US131510701062,131510701062,"Block Group 2, Census Tract 701.06, Henry County, Georgia",3035,531,2977,522,58,64
1500000US131510701071,131510701071,"Block Group 1, Census Tract 701.07, Henry County, Georgia",2434,775,2434,775,0,13
1500000US131510701072,131510701072,"Block Group 2, Census Tract 701.07, Henry County, Georgia",2318,634,2197,612,121,118
1500000US131510701073,131510701073,"Block Group 3, Census Tract 701.07, Henry County, Georgia",2425,634,2264,593,161,195
1500000US131510701081,131510701081,"Block Group 1, Census Tract 701.08, Henry County, Georgia",3026,487,2941,489,85,120
1500000US131510701082,131510701082,"Block Group 2, Census Tract 701.08, Henry County, Georgia",2139,414,1871,379,268,236
1500000US131510701091,131510701091,"Block Group 1, Census Tract 701.09, Henry County, Georgia",2183,441,2117,428,66,88
1500000US131510701092,131510701092,"Block Group 2, Census Tract 701.09, Henry County, Georgia",1427,396,1272,353,155,129
1500000US131510701101,131510701101,"Block Group 1, Census Tract 701.10, Henry County, Georgia",1770,642,1754,642,16,24
1500000US131510701102,131510701102,"Block Group 2, Census Tract 701.10, Henry County, Georgia",3080,684,2984,678,96,115
1500000US131510701103,131510701103,"Block Group 3, Census Tract 701.10, Henry County, Georgia",2680,716,2680,716,0,13
1500000US131510701111,131510701111,"Block Group 1, Census Tract 701.11, Henry County, Georgia",3190,741,2982,718,208,193
1500000US131510701112,131510701112,"Block Group 2, Census Tract 701.11, Henry County, Georgia",3363,742,3059,712,304,221
1500000US131510701113,131510701113,"Block Group 3, Census Tract 701.11, Henry County, Georgia",2416,677,1750,521,666,427
1500000US131510701131,131510701131,"Block Group 1, Census Tract 701.13, Henry County, Georgia",1721,468,1484,346,237,257
1500000US131510701132,131510701132,"Block Group 2, Census Tract 701.13, Henry County, Georgia",2112,354,1655,324,457,194
1500000US131510701141,131510701141,"Block Group 1, Census Tract 701.14, Henry County, Georgia",2758,580,2711,573,47,79
1500000US131510701142,131510701142,"Block Group 2, Census Tract 701.14, Henry County, Georgia",2514,619,2514,619,0,13
1500000US131510702021,131510702021,"Block Group 1, Census Tract 702.02, Henry County, Georgia",3235,540,3114,524,121,178
1500000US131510702022,131510702022,"Block Group 2, Census Tract 702.02, Henry County, Georgia",4274,596,3964,561,310,239
1500000US131510702023,131510702023,"Block Group 3, Census Tract 702.02, Henry County, Georgia",3269,492,3269,492,0,13
1500000US131510702031,131510702031,"Block Group 1, Census Tract 702.03, Henry County, Georgia",4820,947,4749,954,71,118
1500000US131510702032,131510702032,"Block Group 2, Census Tract 702.03, Henry County, Georgia",4964,972,4764,964,200,229
1500000US131510702033,131510702033,"Block Group 3, Census Tract 702.03, Henry County, Georgia",4768,1098,4235,976,533,566
1500000US131510702041,131510702041,"Block Group 1, Census Tract 702.04, Henry County, Georgia",2490,442,2490,442,0,13
1500000US131510702042,131510702042,"Block Group 2, Census Tract 702.04, Henry County, Georgia",2000,368,1878,361,122,144
1500000US131510702051,131510702051,"Block Group 1, Census Tract 702.05, Henry County, Georgia",2873,775,2485,716,388,320
1500000US131510702052,131510702052,"Block Group 2, Census Tract 702.05, Henry County, Georgia",3752,861,3195,715,557,519
1500000US131510702053,131510702053,"Block Group 3, Census Tract 702.05, Henry County, Georgia",4452,874,3691,726,761,690
1500000US131510703041,131510703041,"Block Group 1, Census Tract 703.04, Henry County, Georgia",2462,802,2433,808,29,46
1500000US131510703042,131510703042,"Block Group 2, Census Tract 703.04, Henry County, Georgia",4219,906,4094,894,125,119
1500000US131510703043,131510703043,"Block Group 3, Census Tract 703.04, Henry County, Georgia",5216,910,4902,830,314,280
1500000US131510703051,131510703051,"Block Group 1, Census Tract 703.05, Henry County, Georgia",4869,736,4605,713,264,207
1500000US131510703052,131510703052,"Block Group 2, Census Tract 703.05, Henry County, Georgia",2595,621,2558,615,37,167
1500000US131510703053,131510703053,"Block Group 3, Census Tract 703.05, Henry County, Georgia",1923,488,1741,447,182,233
1500000US131510703061,131510703061,"Block Group 1, Census Tract 703.06, Henry County, Georgia",9651,649,9196,625,455,238
1500000US131510703071,131510703071,"Block Group 1, Census Tract 703.07, Henry County, Georgia",4432,578,4040,551,392,270
1500000US131510703091,131510703091,"Block Group 1, Census Tract 703.09, Henry County, Georgia",3186,806,2699,712,487,322
1500000US131510703092,131510703092,"Block Group 2, Census Tract 703.09, Henry County, Georgia",4143,765,4061,744,82,117
1500000US131510703101,131510703101,"Block Group 1, Census Tract 703.10, Henry County, Georgia",1740,364,1546,260,194,218
1500000US131510703102,131510703102,"Block Group 2, Census Tract 703.10, Henry County, Georgia",1267,435,1267,435,0,13
1500000US131510703103,131510703103,"Block Group 3, Census Tract 703.10, Henry County, Georgia",879,319,828,315,51,77
1500000US131510703111,131510703111,"Block Group 1, Census Tract 703.11, Henry County, Georgia",2918,1175,2526,912,392,457
1500000US131510703112,131510703112,"Block Group 2, Census Tract 703.11, Henry County, Georgia",4261,1057,3894,1030,367,302
1500000US131510703113,131510703113,"Block Group 3, Census Tract 703.11, Henry County, Georgia",5213,982,4749,1038,464,365
1500000US131510704021,131510704021,"Block Group 1, Census Tract 704.02, Henry County, Georgia",4985,875,4944,875,41,64
1500000US131510704022,131510704022,"Block Group 2, Census Tract 704.02, Henry County, Georgia",3877,888,3654,825,223,264
1500000US131510704023,131510704023,"Block Group 3, Census Tract 704.02, Henry County, Georgia",3111,526,3081,521,30,47
1500000US131510704031,131510704031,"Block Group 1, Census Tract 704.03, Henry County, Georgia",3825,977,3640,963,185,176
1500000US131510704032,131510704032,"Block Group 2, Census Tract 704.03, Henry County, Georgia",3634,735,3269,738,365,309
1500000US131510704033,131510704033,"Block Group 3, Census Tract 704.03, Henry County, Georgia",3203,762,2970,668,233,334
1500000US131510704041,131510704041,"Block Group 1, Census Tract 704.04, Henry County, Georgia",3264,606,3061,588,203,160
1500000US131510704042,131510704042,"Block Group 2, Census Tract 704.04, Henry County, Georgia",2854,675,2696,629,158,173
1500000US131510704043,131510704043,"Block Group 3, Census Tract 704.04, Henry County, Georgia",1078,519,1078,519,0,13
1500000US131510705011,131510705011,"Block Group 1, Census Tract 705.01, Henry County, Georgia",5738,989,5469,966,269,257
1500000US131510705012,131510705012,"Block Group 2, Census Tract 705.01, Henry County, Georgia",1653,658,1254,560,399,290
1500000US131510705021,131510705021,"Block Group 1, Census Tract 705.02, Henry County, Georgia",4194,884,4174,888,20,35
1500000US131510705022,131510705022,"Block Group 2, Census Tract 705.02, Henry County, Georgia",8726,1308,8330,1219,396,359
1500000US131510705023,131510705023,"Block Group 3, Census Tract 705.02, Henry County, Georgia",1126,443,1105,449,21,34
1500000US131530201051,131530201051,"Block Group 1, Census Tract 201.05, Houston County, Georgia",2226,623,2181,635,45,76
1500000US131530201052,131530201052,"Block Group 2, Census Tract 201.05, Houston County, Georgia",2140,608,1994,583,146,282
1500000US131530201053,131530201053,"Block Group 3, Census Tract 201.05, Houston County, Georgia",1904,544,1867,535,37,55
1500000US131530201061,131530201061,"Block Group 1, Census Tract 201.06, Houston County, Georgia",3123,356,3032,366,91,135
1500000US131530201081,131530201081,"Block Group 1, Census Tract 201.08, Houston County, Georgia",1858,530,1511,391,347,350
1500000US131530201082,131530201082,"Block Group 2, Census Tract 201.08, Houston County, Georgia",2307,577,2256,590,51,86
1500000US131530201083,131530201083,"Block Group 3, Census Tract 201.08, Houston County, Georgia",1820,431,1794,434,26,49
1500000US131530201091,131530201091,"Block Group 1, Census Tract 201.09, Houston County, Georgia",5023,726,4326,682,697,581
1500000US131530201092,131530201092,"Block Group 2, Census Tract 201.09, Houston County, Georgia",4068,739,3776,713,292,247
1500000US131530202001,131530202001,"Block Group 1, Census Tract 202, Houston County, Georgia",1538,402,1522,403,16,27
1500000US131530202002,131530202002,"Block Group 2, Census Tract 202, Houston County, Georgia",840,268,840,268,0,13
1500000US131530202003,131530202003,"Block Group 3, Census Tract 202, Houston County, Georgia",1702,415,1531,398,171,151
1500000US131530202004,131530202004,"Block Group 4, Census Tract 202, Houston County, Georgia",1194,414,1135,422,59,63
1500000US131530203001,131530203001,"Block Group 1, Census Tract 203, Houston County, Georgia",390,163,346,142,44,75
1500000US131530203002,131530203002,"Block Group 2, Census Tract 203, Houston County, Georgia",1525,536,1525,536,0,13
1500000US131530203003,131530203003,"Block Group 3, Census Tract 203, Houston County, Georgia",1372,467,1074,408,298,274
1500000US131530203004,131530203004,"Block Group 4, Census Tract 203, Houston County, Georgia",2581,481,2547,463,34,55
1500000US131530203005,131530203005,"Block Group 5, Census Tract 203, Houston County, Georgia",626,269,626,269,0,13
1500000US131530204001,131530204001,"Block Group 1, Census Tract 204, Houston County, Georgia",1102,265,1102,265,0,13
1500000US131530204002,131530204002,"Block Group 2, Census Tract 204, Houston County, Georgia",2201,453,1674,322,527,381
1500000US131530206001,131530206001,"Block Group 1, Census Tract 206, Houston County, Georgia",1171,194,1056,185,115,63
1500000US131530206002,131530206002,"Block Group 2, Census Tract 206, Houston County, Georgia",238,67,207,58,31,28
1500000US131530207001,131530207001,"Block Group 1, Census Tract 207, Houston County, Georgia",1273,443,1063,397,210,215
1500000US131530207002,131530207002,"Block Group 2, Census Tract 207, Houston County, Georgia",1144,309,1144,309,0,13
1500000US131530207003,131530207003,"Block Group 3, Census Tract 207, Houston County, Georgia",968,306,968,306,0,13
1500000US131530208001,131530208001,"Block Group 1, Census Tract 208, Houston County, Georgia",1364,288,1251,245,113,148
1500000US131530208002,131530208002,"Block Group 2, Census Tract 208, Houston County, Georgia",1048,247,925,218,123,110
1500000US131530209001,131530209001,"Block Group 1, Census Tract 209, Houston County, Georgia",995,250,985,246,10,17
1500000US131530209002,131530209002,"Block Group 2, Census Tract 209, Houston County, Georgia",1626,392,1570,380,56,90
1500000US131530209003,131530209003,"Block Group 3, Census Tract 209, Houston County, Georgia",920,278,920,278,0,13
1500000US131530209004,131530209004,"Block Group 4, Census Tract 209, Houston County, Georgia",723,241,723,241,0,13
1500000US131530210001,131530210001,"Block Group 1, Census Tract 210, Houston County, Georgia",1525,643,1463,642,62,58
1500000US131530210002,131530210002,"Block Group 2, Census Tract 210, Houston County, Georgia",1655,480,1585,483,70,86
1500000US131530210003,131530210003,"Block Group 3, Census Tract 210, Houston County, Georgia",1715,644,1615,643,100,86
1500000US131530210004,131530210004,"Block Group 4, Census Tract 210, Houston County, Georgia",2157,745,1733,522,424,565
1500000US131530211031,131530211031,"Block Group 1, Census Tract 211.03, Houston County, Georgia",2713,423,2627,416,86,133
1500000US131530211032,131530211032,"Block Group 2, Census Tract 211.03, Houston County, Georgia",2735,617,2463,531,272,160
1500000US131530211033,131530211033,"Block Group 3, Census Tract 211.03, Houston County, Georgia",5061,691,4803,655,258,204
1500000US131530211034,131530211034,"Block Group 4, Census Tract 211.03, Houston County, Georgia",552,233,552,233,0,13
1500000US131530211041,131530211041,"Block Group 1, Census Tract 211.04, Houston County, Georgia",708,299,484,201,224,230
1500000US131530211042,131530211042,"Block Group 2, Census Tract 211.04, Houston County, Georgia",3301,572,2979,523,322,222
1500000US131530211043,131530211043,"Block Group 3, Census Tract 211.04, Houston County, Georgia",1304,459,976,375,328,329
1500000US131530211044,131530211044,"Block Group 4, Census Tract 211.04, Houston County, Georgia",1415,370,1374,366,41,44
1500000US131530211045,131530211045,"Block Group 5, Census Tract 211.04, Houston County, Georgia",687,182,687,182,0,13
1500000US131530211051,131530211051,"Block Group 1, Census Tract 211.05, Houston County, Georgia",1252,443,1117,427,135,111
1500000US131530211052,131530211052,"Block Group 2, Census Tract 211.05, Houston County, Georgia",3048,658,2678,616,370,311
1500000US131530211053,131530211053,"Block Group 3, Census Tract 211.05, Houston County, Georgia",1236,493,849,390,387,330
1500000US131530211054,131530211054,"Block Group 4, Census Tract 211.05, Houston County, Georgia",1225,391,1225,391,0,13
1500000US131530211071,131530211071,"Block Group 1, Census Tract 211.07, Houston County, Georgia",1213,333,1112,331,101,124
1500000US131530211072,131530211072,"Block Group 2, Census Tract 211.07, Houston County, Georgia",3231,857,3067,864,164,163
1500000US131530211073,131530211073,"Block Group 3, Census Tract 211.07, Houston County, Georgia",1619,382,1503,392,116,98
1500000US131530211074,131530211074,"Block Group 4, Census Tract 211.07, Houston County, Georgia",2623,436,2403,456,220,169
1500000US131530211081,131530211081,"Block Group 1, Census Tract 211.08, Houston County, Georgia",4507,584,4442,570,65,108
1500000US131530211082,131530211082,"Block Group 2, Census Tract 211.08, Houston County, Georgia",1682,555,1576,492,106,170
1500000US131530211131,131530211131,"Block Group 1, Census Tract 211.13, Houston County, Georgia",4957,1338,4644,1260,313,395
1500000US131530211132,131530211132,"Block Group 2, Census Tract 211.13, Houston County, Georgia",9813,1381,9557,1356,256,281
1500000US131530211133,131530211133,"Block Group 3, Census Tract 211.13, Houston County, Georgia",2471,572,2401,564,70,105
1500000US131530212011,131530212011,"Block Group 1, Census Tract 212.01, Houston County, Georgia",7160,627,6632,592,528,398
1500000US131530212012,131530212012,"Block Group 2, Census Tract 212.01, Houston County, Georgia",990,242,990,242,0,13
1500000US131530212021,131530212021,"Block Group 1, Census Tract 212.02, Houston County, Georgia",1405,484,1371,482,34,53
1500000US131530212022,131530212022,"Block Group 2, Census Tract 212.02, Houston County, Georgia",1302,436,1302,436,0,13
1500000US131530212023,131530212023,"Block Group 3, Census Tract 212.02, Houston County, Georgia",3041,708,2833,756,208,228
1500000US131530212024,131530212024,"Block Group 4, Census Tract 212.02, Houston County, Georgia",546,291,488,290,58,86
1500000US131530213001,131530213001,"Block Group 1, Census Tract 213, Houston County, Georgia",1377,356,1316,361,61,93
1500000US131530213002,131530213002,"Block Group 2, Census Tract 213, Houston County, Georgia",650,280,650,280,0,13
1500000US131530213003,131530213003,"Block Group 3, Census Tract 213, Houston County, Georgia",1017,305,993,308,24,24
1500000US131530213004,131530213004,"Block Group 4, Census Tract 213, Houston County, Georgia",1498,450,1498,450,0,13
1500000US131530214001,131530214001,"Block Group 1, Census Tract 214, Houston County, Georgia",1774,384,1586,381,188,192
1500000US131530214002,131530214002,"Block Group 2, Census Tract 214, Houston County, Georgia",964,418,917,416,47,78
1500000US131530214003,131530214003,"Block Group 3, Census Tract 214, Houston County, Georgia",1201,444,1201,444,0,13
1500000US131530214004,131530214004,"Block Group 4, Census Tract 214, Houston County, Georgia",5032,855,4716,761,316,314
1500000US131530215001,131530215001,"Block Group 1, Census Tract 215, Houston County, Georgia",1088,326,1088,326,0,13
1500000US131530215002,131530215002,"Block Group 2, Census Tract 215, Houston County, Georgia",1773,399,1723,396,50,49
1500000US131530215003,131530215003,"Block Group 3, Census Tract 215, Houston County, Georgia",1337,331,1317,319,20,31
1500000US131559501001,131559501001,"Block Group 1, Census Tract 9501, Irwin County, Georgia",1308,261,1277,257,31,36
1500000US131559501002,131559501002,"Block Group 2, Census Tract 9501, Irwin County, Georgia",1114,248,1114,248,0,13
1500000US131559502001,131559502001,"Block Group 1, Census Tract 9502, Irwin County, Georgia",721,241,721,241,0,13
1500000US131559502002,131559502002,"Block Group 2, Census Tract 9502, Irwin County, Georgia",1279,286,1261,291,18,27
1500000US131559502003,131559502003,"Block Group 3, Census Tract 9502, Irwin County, Georgia",740,209,735,207,5,10
1500000US131559502004,131559502004,"Block Group 4, Census Tract 9502, Irwin County, Georgia",1329,318,1329,318,0,13
1500000US131559502005,131559502005,"Block Group 5, Census Tract 9502, Irwin County, Georgia",2178,431,2137,423,41,44
1500000US131559502006,131559502006,"Block Group 6, Census Tract 9502, Irwin County, Georgia",739,278,739,278,0,13
1500000US131570101011,131570101011,"Block Group 1, Census Tract 101.01, Jackson County, Georgia",2809,522,2809,522,0,13
1500000US131570101012,131570101012,"Block Group 2, Census Tract 101.01, Jackson County, Georgia",2652,503,2637,504,15,19
1500000US131570101021,131570101021,"Block Group 1, Census Tract 101.02, Jackson County, Georgia",2708,457,2512,435,196,146
1500000US131570101022,131570101022,"Block Group 2, Census Tract 101.02, Jackson County, Georgia",4241,826,4021,808,220,219
1500000US131570101031,131570101031,"Block Group 1, Census Tract 101.03, Jackson County, Georgia",3686,501,3501,489,185,113
1500000US131570101032,131570101032,"Block Group 2, Census Tract 101.03, Jackson County, Georgia",1756,349,1431,316,325,204
1500000US131570102001,131570102001,"Block Group 1, Census Tract 102, Jackson County, Georgia",2550,382,2311,374,239,192
1500000US131570102002,131570102002,"Block Group 2, Census Tract 102, Jackson County, Georgia",2438,284,2410,287,28,45
1500000US131570103001,131570103001,"Block Group 1, Census Tract 103, Jackson County, Georgia",941,267,933,267,8,14
1500000US131570103002,131570103002,"Block Group 2, Census Tract 103, Jackson County, Georgia",987,332,987,332,0,13
1500000US131570103003,131570103003,"Block Group 3, Census Tract 103, Jackson County, Georgia",2560,407,1928,330,632,293
1500000US131570104001,131570104001,"Block Group 1, Census Tract 104, Jackson County, Georgia",1340,291,1293,295,47,73
1500000US131570104002,131570104002,"Block Group 2, Census Tract 104, Jackson County, Georgia",1199,243,1199,243,0,13
1500000US131570104003,131570104003,"Block Group 3, Census Tract 104, Jackson County, Georgia",904,251,904,251,0,13
1500000US131570104004,131570104004,"Block Group 4, Census Tract 104, Jackson County, Georgia",1269,305,1179,292,90,76
1500000US131570105001,131570105001,"Block Group 1, Census Tract 105, Jackson County, Georgia",624,292,369,168,255,256
1500000US131570105002,131570105002,"Block Group 2, Census Tract 105, Jackson County, Georgia",2037,337,1741,283,296,187
1500000US131570105003,131570105003,"Block Group 3, Census Tract 105, Jackson County, Georgia",2619,348,2535,353,84,123
1500000US131570106001,131570106001,"Block Group 1, Census Tract 106, Jackson County, Georgia",1804,447,1804,447,0,13
1500000US131570106002,131570106002,"Block Group 2, Census Tract 106, Jackson County, Georgia",1623,535,1156,424,467,398
1500000US131570106003,131570106003,"Block Group 3, Census Tract 106, Jackson County, Georgia",1891,448,1828,426,63,163
1500000US131570106004,131570106004,"Block Group 4, Census Tract 106, Jackson County, Georgia",1849,383,1849,383,0,13
1500000US131570106005,131570106005,"Block Group 5, Census Tract 106, Jackson County, Georgia",1620,414,1413,416,207,143
1500000US131570107011,131570107011,"Block Group 1, Census Tract 107.01, Jackson County, Georgia",1268,178,1253,170,15,22
1500000US131570107012,131570107012,"Block Group 2, Census Tract 107.01, Jackson County, Georgia",966,303,966,303,0,13
1500000US131570107021,131570107021,"Block Group 1, Census Tract 107.02, Jackson County, Georgia",3021,641,2721,622,300,128
1500000US131570107022,131570107022,"Block Group 2, Census Tract 107.02, Jackson County, Georgia",3217,564,3188,568,29,50
1500000US131570107023,131570107023,"Block Group 3, Census Tract 107.02, Jackson County, Georgia",3499,600,3308,635,191,161
1500000US131570107031,131570107031,"Block Group 1, Census Tract 107.03, Jackson County, Georgia",3342,430,3108,423,234,247
1500000US131590101001,131590101001,"Block Group 1, Census Tract 101, Jasper County, Georgia",2374,228,2310,231,64,91
1500000US131590102001,131590102001,"Block Group 1, Census Tract 102, Jasper County, Georgia",2722,277,2701,277,21,26
1500000US131590105001,131590105001,"Block Group 1, Census Tract 105, Jasper County, Georgia",1154,293,1073,272,81,108
1500000US131590105002,131590105002,"Block Group 2, Census Tract 105, Jasper County, Georgia",869,231,869,231,0,13
1500000US131590105003,131590105003,"Block Group 3, Census Tract 105, Jasper County, Georgia",3311,453,3311,453,0,13
1500000US131590105004,131590105004,"Block Group 4, Census Tract 105, Jasper County, Georgia",1799,335,1685,339,114,120
1500000US131590105005,131590105005,"Block Group 5, Census Tract 105, Jasper County, Georgia",1364,379,1103,336,261,196
1500000US131619601001,131619601001,"Block Group 1, Census Tract 9601, Jeff Davis County, Georgia",1746,383,1698,367,48,90
1500000US131619601002,131619601002,"Block Group 2, Census Tract 9601, Jeff Davis County, Georgia",959,368,896,376,63,104
1500000US131619601003,131619601003,"Block Group 3, Census Tract 9601, Jeff Davis County, Georgia",1147,444,823,305,324,308
1500000US131619601004,131619601004,"Block Group 4, Census Tract 9601, Jeff Davis County, Georgia",1181,459,1024,387,157,185
1500000US131619601005,131619601005,"Block Group 5, Census Tract 9601, Jeff Davis County, Georgia",1478,494,1271,427,207,257
1500000US131619602001,131619602001,"Block Group 1, Census Tract 9602, Jeff Davis County, Georgia",1399,456,1399,456,0,13
1500000US131619602002,131619602002,"Block Group 2, Census Tract 9602, Jeff Davis County, Georgia",2311,474,1987,350,324,379
1500000US131619602003,131619602003,"Block Group 3, Census Tract 9602, Jeff Davis County, Georgia",954,384,954,384,0,13
1500000US131619602004,131619602004,"Block Group 4, Census Tract 9602, Jeff Davis County, Georgia",1970,457,1578,364,392,294
1500000US131619603001,131619603001,"Block Group 1, Census Tract 9603, Jeff Davis County, Georgia",1014,272,872,238,142,139
1500000US131619603002,131619603002,"Block Group 2, Census Tract 9603, Jeff Davis County, Georgia",831,178,831,178,0,13
1500000US131639601001,131639601001,"Block Group 1, Census Tract 9601, Jefferson County, Georgia",1193,274,1102,253,91,71
1500000US131639601002,131639601002,"Block Group 2, Census Tract 9601, Jefferson County, Georgia",511,174,511,174,0,13
1500000US131639601003,131639601003,"Block Group 3, Census Tract 9601, Jefferson County, Georgia",780,247,734,231,46,78
1500000US131639601004,131639601004,"Block Group 4, Census Tract 9601, Jefferson County, Georgia",1154,333,1154,333,0,13
1500000US131639601005,131639601005,"Block Group 5, Census Tract 9601, Jefferson County, Georgia",1200,356,1191,355,9,17
1500000US131639602001,131639602001,"Block Group 1, Census Tract 9602, Jefferson County, Georgia",1192,282,1168,282,24,29
1500000US131639602002,131639602002,"Block Group 2, Census Tract 9602, Jefferson County, Georgia",996,222,911,175,85,133
1500000US131639603001,131639603001,"Block Group 1, Census Tract 9603, Jefferson County, Georgia",814,266,814,266,0,13
1500000US131639603002,131639603002,"Block Group 2, Census Tract 9603, Jefferson County, Georgia",772,195,764,191,8,13
1500000US131639603003,131639603003,"Block Group 3, Census Tract 9603, Jefferson County, Georgia",1049,350,1049,350,0,13
1500000US131639603004,131639603004,"Block Group 4, Census Tract 9603, Jefferson County, Georgia",1345,426,1345,426,0,13
1500000US131639603005,131639603005,"Block Group 5, Census Tract 9603, Jefferson County, Georgia",1199,348,1162,341,37,66
1500000US131639603006,131639603006,"Block Group 6, Census Tract 9603, Jefferson County, Georgia",574,229,574,229,0,13
1500000US131639604001,131639604001,"Block Group 1, Census Tract 9604, Jefferson County, Georgia",1165,261,993,227,172,165
1500000US131639604002,131639604002,"Block Group 2, Census Tract 9604, Jefferson County, Georgia",900,243,896,242,4,7
1500000US131639604003,131639604003,"Block Group 3, Census Tract 9604, Jefferson County, Georgia",831,255,764,219,67,90
1500000US131639604004,131639604004,"Block Group 4, Census Tract 9604, Jefferson County, Georgia",699,190,699,190,0,13
1500000US131659601001,131659601001,"Block Group 1, Census Tract 9601, Jenkins County, Georgia",2029,527,1623,455,406,370
1500000US131659601002,131659601002,"Block Group 2, Census Tract 9601, Jenkins County, Georgia",1319,422,1319,422,0,13
1500000US131659601003,131659601003,"Block Group 3, Census Tract 9601, Jenkins County, Georgia",728,340,728,340,0,13
1500000US131659601004,131659601004,"Block Group 4, Census Tract 9601, Jenkins County, Georgia",449,144,406,134,43,56
1500000US131659601005,131659601005,"Block Group 5, Census Tract 9601, Jenkins County, Georgia",824,355,824,355,0,13
1500000US131659601006,131659601006,"Block Group 6, Census Tract 9601, Jenkins County, Georgia",723,387,685,368,38,58
1500000US131659602001,131659602001,"Block Group 1, Census Tract 9602, Jenkins County, Georgia",1298,255,1248,251,50,79
1500000US131659602002,131659602002,"Block Group 2, Census Tract 9602, Jenkins County, Georgia",1552,375,1395,343,157,162
1500000US131679601001,131679601001,"Block Group 1, Census Tract 9601, Johnson County, Georgia",1260,267,1234,259,26,32
1500000US131679601002,131679601002,"Block Group 2, Census Tract 9601, Johnson County, Georgia",1431,221,1426,220,5,8
1500000US131679602001,131679602001,"Block Group 1, Census Tract 9602, Johnson County, Georgia",942,284,939,282,3,6
1500000US131679602002,131679602002,"Block Group 2, Census Tract 9602, Johnson County, Georgia",1183,349,1183,349,0,13
1500000US131679602003,131679602003,"Block Group 3, Census Tract 9602, Johnson County, Georgia",1732,325,1732,325,0,13
1500000US131679602004,131679602004,"Block Group 4, Census Tract 9602, Johnson County, Georgia",1473,311,1473,311,0,13
1500000US131679603001,131679603001,"Block Group 1, Census Tract 9603, Johnson County, Georgia",962,205,962,205,0,13
1500000US131679603002,131679603002,"Block Group 2, Census Tract 9603, Johnson County, Georgia",811,231,806,230,5,8
1500000US131690301011,131690301011,"Block Group 1, Census Tract 301.01, Jones County, Georgia",2598,317,2524,325,74,59
1500000US131690301031,131690301031,"Block Group 1, Census Tract 301.03, Jones County, Georgia",2474,308,2463,305,11,17
1500000US131690301041,131690301041,"Block Group 1, Census Tract 301.04, Jones County, Georgia",4738,682,4701,682,37,44
1500000US131690301042,131690301042,"Block Group 2, Census Tract 301.04, Jones County, Georgia",2716,588,2716,588,0,13
1500000US131690302001,131690302001,"Block Group 1, Census Tract 302, Jones County, Georgia",2151,460,2151,460,0,13
1500000US131690302002,131690302002,"Block Group 2, Census Tract 302, Jones County, Georgia",1414,261,1414,261,0,13
1500000US131690303011,131690303011,"Block Group 1, Census Tract 303.01, Jones County, Georgia",2088,305,2051,307,37,47
1500000US131690303012,131690303012,"Block Group 2, Census Tract 303.01, Jones County, Georgia",4754,457,4745,457,9,15
1500000US131690303021,131690303021,"Block Group 1, Census Tract 303.02, Jones County, Georgia",938,320,938,320,0,13
1500000US131690303022,131690303022,"Block Group 2, Census Tract 303.02, Jones County, Georgia",2277,390,2277,390,0,13
1500000US131690303023,131690303023,"Block Group 3, Census Tract 303.02, Jones County, Georgia",2590,363,2590,363,0,13
1500000US131719701001,131719701001,"Block Group 1, Census Tract 9701, Lamar County, Georgia",2540,450,2290,436,250,139
1500000US131719701002,131719701002,"Block Group 2, Census Tract 9701, Lamar County, Georgia",2789,581,2731,593,58,92
1500000US131719701003,131719701003,"Block Group 3, Census Tract 9701, Lamar County, Georgia",1828,363,1826,363,2,3
1500000US131719702001,131719702001,"Block Group 1, Census Tract 9702, Lamar County, Georgia",2432,359,2379,367,53,91
1500000US131719702002,131719702002,"Block Group 2, Census Tract 9702, Lamar County, Georgia",1735,357,1713,351,22,27
1500000US131719702003,131719702003,"Block Group 3, Census Tract 9702, Lamar County, Georgia",1324,299,1324,299,0,13
1500000US131719702004,131719702004,"Block Group 4, Census Tract 9702, Lamar County, Georgia",646,255,646,255,0,13
1500000US131719702005,131719702005,"Block Group 5, Census Tract 9702, Lamar County, Georgia",701,236,701,236,0,13
1500000US131719703001,131719703001,"Block Group 1, Census Tract 9703, Lamar County, Georgia",1214,348,1214,348,0,13
1500000US131719703002,131719703002,"Block Group 2, Census Tract 9703, Lamar County, Georgia",1049,275,1046,273,3,7
1500000US131719703003,131719703003,"Block Group 3, Census Tract 9703, Lamar County, Georgia",854,283,854,283,0,13
1500000US131719703004,131719703004,"Block Group 4, Census Tract 9703, Lamar County, Georgia",1002,344,986,346,16,26
1500000US131739501001,131739501001,"Block Group 1, Census Tract 9501, Lanier County, Georgia",712,213,668,195,44,70
1500000US131739501002,131739501002,"Block Group 2, Census Tract 9501, Lanier County, Georgia",1254,264,1234,265,20,29
1500000US131739502001,131739502001,"Block Group 1, Census Tract 9502, Lanier County, Georgia",1329,360,1293,347,36,48
1500000US131739502002,131739502002,"Block Group 2, Census Tract 9502, Lanier County, Georgia",1795,357,1759,355,36,47
1500000US131739502003,131739502003,"Block Group 3, Census Tract 9502, Lanier County, Georgia",1137,318,1015,322,122,159
1500000US131739502004,131739502004,"Block Group 4, Census Tract 9502, Lanier County, Georgia",3063,444,2800,462,263,163
1500000US131739502005,131739502005,"Block Group 5, Census Tract 9502, Lanier County, Georgia",1113,397,1084,409,29,53
1500000US131759501001,131759501001,"Block Group 1, Census Tract 9501, Laurens County, Georgia",1847,317,1733,328,114,154
1500000US131759501002,131759501002,"Block Group 2, Census Tract 9501, Laurens County, Georgia",1317,309,1293,311,24,42
1500000US131759502011,131759502011,"Block Group 1, Census Tract 9502.01, Laurens County, Georgia",1921,357,1921,357,0,13
1500000US131759502012,131759502012,"Block Group 2, Census Tract 9502.01, Laurens County, Georgia",2750,354,2750,354,0,13
1500000US131759502021,131759502021,"Block Group 1, Census Tract 9502.02, Laurens County, Georgia",2023,320,1999,315,24,38
1500000US131759502022,131759502022,"Block Group 2, Census Tract 9502.02, Laurens County, Georgia",2321,355,2130,343,191,183
1500000US131759503001,131759503001,"Block Group 1, Census Tract 9503, Laurens County, Georgia",1138,270,1138,270,0,13
1500000US131759503002,131759503002,"Block Group 2, Census Tract 9503, Laurens County, Georgia",551,170,520,152,31,36
1500000US131759504001,131759504001,"Block Group 1, Census Tract 9504, Laurens County, Georgia",816,238,816,238,0,13
1500000US131759504002,131759504002,"Block Group 2, Census Tract 9504, Laurens County, Georgia",1269,356,1263,356,6,12
1500000US131759504003,131759504003,"Block Group 3, Census Tract 9504, Laurens County, Georgia",1373,344,1373,344,0,13
1500000US131759504004,131759504004,"Block Group 4, Census Tract 9504, Laurens County, Georgia",400,182,400,182,0,13
1500000US131759505001,131759505001,"Block Group 1, Census Tract 9505, Laurens County, Georgia",701,239,695,238,6,10
1500000US131759505002,131759505002,"Block Group 2, Census Tract 9505, Laurens County, Georgia",880,229,847,225,33,51
1500000US131759505003,131759505003,"Block Group 3, Census Tract 9505, Laurens County, Georgia",2394,470,2394,470,0,13
1500000US131759506001,131759506001,"Block Group 1, Census Tract 9506, Laurens County, Georgia",2146,227,2089,215,57,53
1500000US131759507001,131759507001,"Block Group 1, Census Tract 9507, Laurens County, Georgia",1737,282,1737,282,0,13
1500000US131759507002,131759507002,"Block Group 2, Census Tract 9507, Laurens County, Georgia",766,164,755,160,11,16
1500000US131759508001,131759508001,"Block Group 1, Census Tract 9508, Laurens County, Georgia",1271,280,1271,280,0,13
1500000US131759508002,131759508002,"Block Group 2, Census Tract 9508, Laurens County, Georgia",654,230,654,230,0,13
1500000US131759508003,131759508003,"Block Group 3, Census Tract 9508, Laurens County, Georgia",1252,243,1247,242,5,10
1500000US131759508004,131759508004,"Block Group 4, Census Tract 9508, Laurens County, Georgia",913,240,875,232,38,65
1500000US131759509001,131759509001,"Block Group 1, Census Tract 9509, Laurens County, Georgia",945,289,928,291,17,24
1500000US131759509002,131759509002,"Block Group 2, Census Tract 9509, Laurens County, Georgia",1024,321,1024,321,0,13
1500000US131759509003,131759509003,"Block Group 3, Census Tract 9509, Laurens County, Georgia",721,242,721,242,0,13
1500000US131759510001,131759510001,"Block Group 1, Census Tract 9510, Laurens County, Georgia",1188,425,1188,425,0,13
1500000US131759510002,131759510002,"Block Group 2, Census Tract 9510, Laurens County, Georgia",375,204,375,204,0,13
1500000US131759510003,131759510003,"Block Group 3, Census Tract 9510, Laurens County, Georgia",2250,580,1961,570,289,285
1500000US131759510004,131759510004,"Block Group 4, Census Tract 9510, Laurens County, Georgia",882,286,882,286,0,13
1500000US131759510005,131759510005,"Block Group 5, Census Tract 9510, Laurens County, Georgia",954,304,940,304,14,23
1500000US131759510006,131759510006,"Block Group 6, Census Tract 9510, Laurens County, Georgia",1871,329,1847,323,24,40
1500000US131759511001,131759511001,"Block Group 1, Census Tract 9511, Laurens County, Georgia",3326,483,3185,470,141,114
1500000US131759511002,131759511002,"Block Group 2, Census Tract 9511, Laurens County, Georgia",1313,285,1293,283,20,32
1500000US131759514001,131759514001,"Block Group 1, Census Tract 9514, Laurens County, Georgia",983,279,844,217,139,192
1500000US131759514002,131759514002,"Block Group 2, Census Tract 9514, Laurens County, Georgia",980,193,965,195,15,27
1500000US131759514003,131759514003,"Block Group 3, Census Tract 9514, Laurens County, Georgia",634,164,634,164,0,13
1500000US131770201001,131770201001,"Block Group 1, Census Tract 201, Lee County, Georgia",1540,330,1451,319,89,132
1500000US131770201002,131770201002,"Block Group 2, Census Tract 201, Lee County, Georgia",2017,483,1989,483,28,50
1500000US131770201003,131770201003,"Block Group 3, Census Tract 201, Lee County, Georgia",2866,443,2866,443,0,13
1500000US131770202001,131770202001,"Block Group 1, Census Tract 202, Lee County, Georgia",1455,216,1455,216,0,13
1500000US131770203001,131770203001,"Block Group 1, Census Tract 203, Lee County, Georgia",3521,484,3414,494,107,134
1500000US131770203002,131770203002,"Block Group 2, Census Tract 203, Lee County, Georgia",1659,359,1601,361,58,86
1500000US131770203003,131770203003,"Block Group 3, Census Tract 203, Lee County, Georgia",1686,562,1610,527,76,61
1500000US131770204021,131770204021,"Block Group 1, Census Tract 204.02, Lee County, Georgia",2499,583,2421,584,78,94
1500000US131770204022,131770204022,"Block Group 2, Census Tract 204.02, Lee County, Georgia",3401,658,3401,658,0,13
1500000US131770204023,131770204023,"Block Group 3, Census Tract 204.02, Lee County, Georgia",928,336,928,336,0,13
1500000US131770204024,131770204024,"Block Group 4, Census Tract 204.02, Lee County, Georgia",1400,285,1389,288,11,20
1500000US131770204031,131770204031,"Block Group 1, Census Tract 204.03, Lee County, Georgia",5103,568,4945,562,158,143
1500000US131770204032,131770204032,"Block Group 2, Census Tract 204.03, Lee County, Georgia",871,342,768,329,103,98
1500000US131790101011,131790101011,"Block Group 1, Census Tract 101.01, Liberty County, Georgia",5198,453,4104,461,1094,346
1500000US131790101012,131790101012,"Block Group 2, Census Tract 101.01, Liberty County, Georgia",1267,319,1078,289,189,170
1500000US131790101021,131790101021,"Block Group 1, Census Tract 101.02, Liberty County, Georgia",707,226,614,206,93,55
1500000US131790101022,131790101022,"Block Group 2, Census Tract 101.02, Liberty County, Georgia",1314,307,1170,313,144,63
1500000US131790101031,131790101031,"Block Group 1, Census Tract 101.03, Liberty County, Georgia",225,155,206,149,19,32
1500000US131790101032,131790101032,"Block Group 2, Census Tract 101.03, Liberty County, Georgia",1274,281,1091,268,183,121
1500000US131790102021,131790102021,"Block Group 1, Census Tract 102.02, Liberty County, Georgia",2749,483,2216,463,533,210
1500000US131790102022,131790102022,"Block Group 2, Census Tract 102.02, Liberty County, Georgia",1456,355,1424,350,32,35
1500000US131790102041,131790102041,"Block Group 1, Census Tract 102.04, Liberty County, Georgia",539,287,539,287,0,13
1500000US131790102042,131790102042,"Block Group 2, Census Tract 102.04, Liberty County, Georgia",2302,354,2023,344,279,156
1500000US131790102051,131790102051,"Block Group 1, Census Tract 102.05, Liberty County, Georgia",3606,530,3166,509,440,185
1500000US131790102052,131790102052,"Block Group 2, Census Tract 102.05, Liberty County, Georgia",2270,387,2029,386,241,134
1500000US131790102061,131790102061,"Block Group 1, Census Tract 102.06, Liberty County, Georgia",1059,368,894,312,165,148
1500000US131790102062,131790102062,"Block Group 2, Census Tract 102.06, Liberty County, Georgia",4170,476,3554,459,616,220
1500000US131790102071,131790102071,"Block Group 1, Census Tract 102.07, Liberty County, Georgia",2677,405,2410,378,267,139
1500000US131790102072,131790102072,"Block Group 2, Census Tract 102.07, Liberty County, Georgia",2758,409,2330,390,428,189
1500000US131790102081,131790102081,"Block Group 1, Census Tract 102.08, Liberty County, Georgia",2553,574,2384,547,169,131
1500000US131790102082,131790102082,"Block Group 2, Census Tract 102.08, Liberty County, Georgia",3591,546,2926,516,665,235
1500000US131790103001,131790103001,"Block Group 1, Census Tract 103, Liberty County, Georgia",866,312,780,315,86,93
1500000US131790103002,131790103002,"Block Group 2, Census Tract 103, Liberty County, Georgia",2629,497,2401,506,228,142
1500000US131790103003,131790103003,"Block Group 3, Census Tract 103, Liberty County, Georgia",1215,330,978,283,237,153
1500000US131790103004,131790103004,"Block Group 4, Census Tract 103, Liberty County, Georgia",2185,461,1830,434,355,251
1500000US131790104001,131790104001,"Block Group 1, Census Tract 104, Liberty County, Georgia",2306,443,2112,427,194,143
1500000US131790104002,131790104002,"Block Group 2, Census Tract 104, Liberty County, Georgia",1863,522,1670,473,193,165
1500000US131790104003,131790104003,"Block Group 3, Census Tract 104, Liberty County, Georgia",3032,488,2573,471,459,239
1500000US131790105011,131790105011,"Block Group 1, Census Tract 105.01, Liberty County, Georgia",921,229,921,229,0,13
1500000US131790105012,131790105012,"Block Group 2, Census Tract 105.01, Liberty County, Georgia",2569,308,2569,308,0,13
1500000US131790105021,131790105021,"Block Group 1, Census Tract 105.02, Liberty County, Georgia",2840,411,2701,396,139,77
1500000US131790105022,131790105022,"Block Group 2, Census Tract 105.02, Liberty County, Georgia",2384,385,2341,394,43,48
1500000US131790106001,131790106001,"Block Group 1, Census Tract 106, Liberty County, Georgia",1066,273,1047,272,19,21
1500000US131790106002,131790106002,"Block Group 2, Census Tract 106, Liberty County, Georgia",836,170,832,169,4,6
1500000US131799900000,131799900000,"Block Group 0, Census Tract 9900, Liberty County, Georgia",0,13,0,13,0,13
1500000US131819701001,131819701001,"Block Group 1, Census Tract 9701, Lincoln County, Georgia",1344,241,1344,241,0,13
1500000US131819701002,131819701002,"Block Group 2, Census Tract 9701, Lincoln County, Georgia",562,187,562,187,0,13
1500000US131819701003,131819701003,"Block Group 3, Census Tract 9701, Lincoln County, Georgia",1151,232,1147,233,4,6
1500000US131819701004,131819701004,"Block Group 4, Census Tract 9701, Lincoln County, Georgia",694,181,688,182,6,11
1500000US131819702001,131819702001,"Block Group 1, Census Tract 9702, Lincoln County, Georgia",1301,222,1301,222,0,13
1500000US131819702002,131819702002,"Block Group 2, Census Tract 9702, Lincoln County, Georgia",700,243,700,243,0,13
1500000US131819702003,131819702003,"Block Group 3, Census Tract 9702, Lincoln County, Georgia",1968,271,1923,283,45,59
1500000US131839701001,131839701001,"Block Group 1, Census Tract 9701, Long County, Georgia",1957,602,1776,570,181,134
1500000US131839701002,131839701002,"Block Group 2, Census Tract 9701, Long County, Georgia",4330,732,3153,724,1177,243
1500000US131839701003,131839701003,"Block Group 3, Census Tract 9701, Long County, Georgia",3260,581,2965,564,295,128
1500000US131839702001,131839702001,"Block Group 1, Census Tract 9702, Long County, Georgia",904,334,805,323,99,103
1500000US131839702002,131839702002,"Block Group 2, Census Tract 9702, Long County, Georgia",1659,490,1611,495,48,60
1500000US131839702003,131839702003,"Block Group 3, Census Tract 9702, Long County, Georgia",4478,765,4334,772,144,160
1500000US131839800001,131839800001,"Block Group 1, Census Tract 9800, Long County, Georgia",0,13,0,13,0,13
1500000US131850101011,131850101011,"Block Group 1, Census Tract 101.01, Lowndes County, Georgia",1149,224,1095,217,54,41
1500000US131850101012,131850101012,"Block Group 2, Census Tract 101.01, Lowndes County, Georgia",2938,461,2814,473,124,74
1500000US131850101021,131850101021,"Block Group 1, Census Tract 101.02, Lowndes County, Georgia",1574,386,1500,377,74,73
1500000US131850101022,131850101022,"Block Group 2, Census Tract 101.02, Lowndes County, Georgia",1671,326,1452,310,219,167
1500000US131850101023,131850101023,"Block Group 3, Census Tract 101.02, Lowndes County, Georgia",1183,319,1170,318,13,22
1500000US131850101024,131850101024,"Block Group 4, Census Tract 101.02, Lowndes County, Georgia",1172,303,1121,301,51,40
1500000US131850101031,131850101031,"Block Group 1, Census Tract 101.03, Lowndes County, Georgia",2158,361,1986,360,172,155
1500000US131850101032,131850101032,"Block Group 2, Census Tract 101.03, Lowndes County, Georgia",1264,305,1231,301,33,48
1500000US131850102011,131850102011,"Block Group 1, Census Tract 102.01, Lowndes County, Georgia",1159,192,1148,192,11,19
1500000US131850102012,131850102012,"Block Group 2, Census Tract 102.01, Lowndes County, Georgia",2142,313,2025,310,117,48
1500000US131850102021,131850102021,"Block Group 1, Census Tract 102.02, Lowndes County, Georgia",1362,280,1162,277,200,164
1500000US131850102022,131850102022,"Block Group 2, Census Tract 102.02, Lowndes County, Georgia",1961,250,1918,252,43,49
1500000US131850102023,131850102023,"Block Group 3, Census Tract 102.02, Lowndes County, Georgia",1927,522,1927,522,0,13
1500000US131850102024,131850102024,"Block Group 4, Census Tract 102.02, Lowndes County, Georgia",2237,590,2163,603,74,90
1500000US131850102025,131850102025,"Block Group 5, Census Tract 102.02, Lowndes County, Georgia",3193,613,3150,594,43,64
1500000US131850102026,131850102026,"Block Group 6, Census Tract 102.02, Lowndes County, Georgia",869,331,827,332,42,61
1500000US131850103011,131850103011,"Block Group 1, Census Tract 103.01, Lowndes County, Georgia",1022,259,973,264,49,57
1500000US131850103012,131850103012,"Block Group 2, Census Tract 103.01, Lowndes County, Georgia",2446,362,2366,345,80,78
1500000US131850103013,131850103013,"Block Group 3, Census Tract 103.01, Lowndes County, Georgia",1734,422,1615,435,119,86
1500000US131850103021,131850103021,"Block Group 1, Census Tract 103.02, Lowndes County, Georgia",1372,256,1337,251,35,44
1500000US131850103022,131850103022,"Block Group 2, Census Tract 103.02, Lowndes County, Georgia",1247,248,1197,244,50,77
1500000US131850104011,131850104011,"Block Group 1, Census Tract 104.01, Lowndes County, Georgia",1003,160,985,158,18,22
1500000US131850104012,131850104012,"Block Group 2, Census Tract 104.01, Lowndes County, Georgia",551,116,522,108,29,33
1500000US131850104021,131850104021,"Block Group 1, Census Tract 104.02, Lowndes County, Georgia",1072,342,1040,337,32,48
1500000US131850104022,131850104022,"Block Group 2, Census Tract 104.02, Lowndes County, Georgia",3081,689,3057,692,24,37
1500000US131850104023,131850104023,"Block Group 3, Census Tract 104.02, Lowndes County, Georgia",3141,884,3034,886,107,115
1500000US131850105001,131850105001,"Block Group 1, Census Tract 105, Lowndes County, Georgia",1309,433,1273,422,36,56
1500000US131850105002,131850105002,"Block Group 2, Census Tract 105, Lowndes County, Georgia",1592,405,1535,387,57,84
1500000US131850105003,131850105003,"Block Group 3, Census Tract 105, Lowndes County, Georgia",1915,435,1786,438,129,112
1500000US131850106011,131850106011,"Block Group 1, Census Tract 106.01, Lowndes County, Georgia",2925,620,2603,602,322,265
1500000US131850106012,131850106012,"Block Group 2, Census Tract 106.01, Lowndes County, Georgia",1161,363,959,338,202,249
1500000US131850106013,131850106013,"Block Group 3, Census Tract 106.01, Lowndes County, Georgia",1798,463,1712,441,86,128
1500000US131850106041,131850106041,"Block Group 1, Census Tract 106.04, Lowndes County, Georgia",492,182,488,180,4,7
1500000US131850106042,131850106042,"Block Group 2, Census Tract 106.04, Lowndes County, Georgia",2829,459,2556,451,273,278
1500000US131850106043,131850106043,"Block Group 3, Census Tract 106.04, Lowndes County, Georgia",1886,395,1727,345,159,146
1500000US131850107001,131850107001,"Block Group 1, Census Tract 107, Lowndes County, Georgia",720,247,696,245,24,38
1500000US131850107002,131850107002,"Block Group 2, Census Tract 107, Lowndes County, Georgia",1075,479,1019,483,56,86
1500000US131850107003,131850107003,"Block Group 3, Census Tract 107, Lowndes County, Georgia",2076,372,2007,374,69,82
1500000US131850108001,131850108001,"Block Group 1, Census Tract 108, Lowndes County, Georgia",2563,676,2563,676,0,13
1500000US131850108002,131850108002,"Block Group 2, Census Tract 108, Lowndes County, Georgia",2109,639,1973,630,136,136
1500000US131850108003,131850108003,"Block Group 3, Census Tract 108, Lowndes County, Georgia",886,291,886,291,0,13
1500000US131850109001,131850109001,"Block Group 1, Census Tract 109, Lowndes County, Georgia",730,166,730,166,0,13
1500000US131850109002,131850109002,"Block Group 2, Census Tract 109, Lowndes County, Georgia",991,241,991,241,0,13
1500000US131850110001,131850110001,"Block Group 1, Census Tract 110, Lowndes County, Georgia",2132,458,1949,454,183,144
1500000US131850110002,131850110002,"Block Group 2, Census Tract 110, Lowndes County, Georgia",1426,387,1338,389,88,114
1500000US131850111001,131850111001,"Block Group 1, Census Tract 111, Lowndes County, Georgia",879,164,838,166,41,69
1500000US131850111002,131850111002,"Block Group 2, Census Tract 111, Lowndes County, Georgia",2146,514,2076,515,70,46
1500000US131850112001,131850112001,"Block Group 1, Census Tract 112, Lowndes County, Georgia",745,218,634,208,111,89
1500000US131850112002,131850112002,"Block Group 2, Census Tract 112, Lowndes County, Georgia",1556,467,1221,377,335,282
1500000US131850112003,131850112003,"Block Group 3, Census Tract 112, Lowndes County, Georgia",1242,325,1188,316,54,51
1500000US131850112004,131850112004,"Block Group 4, Census Tract 112, Lowndes County, Georgia",1610,485,1519,483,91,89
1500000US131850113011,131850113011,"Block Group 1, Census Tract 113.01, Lowndes County, Georgia",2074,528,1895,528,179,187
1500000US131850113012,131850113012,"Block Group 2, Census Tract 113.01, Lowndes County, Georgia",1393,275,1298,276,95,81
1500000US131850113013,131850113013,"Block Group 3, Census Tract 113.01, Lowndes County, Georgia",1825,416,1817,418,8,12
1500000US131850113021,131850113021,"Block Group 1, Census Tract 113.02, Lowndes County, Georgia",1381,330,1279,308,102,107
1500000US131850113022,131850113022,"Block Group 2, Census Tract 113.02, Lowndes County, Georgia",1260,268,1260,268,0,13
1500000US131850114011,131850114011,"Block Group 1, Census Tract 114.01, Lowndes County, Georgia",1723,184,1668,184,55,59
1500000US131850114012,131850114012,"Block Group 2, Census Tract 114.01, Lowndes County, Georgia",692,187,685,186,7,10
1500000US131850114021,131850114021,"Block Group 1, Census Tract 114.02, Lowndes County, Georgia",953,219,771,202,182,116
1500000US131850114022,131850114022,"Block Group 2, Census Tract 114.02, Lowndes County, Georgia",1684,369,1507,326,177,149
1500000US131850114031,131850114031,"Block Group 1, Census Tract 114.03, Lowndes County, Georgia",2392,748,2392,748,0,13
1500000US131850114032,131850114032,"Block Group 2, Census Tract 114.03, Lowndes County, Georgia",2201,498,1800,474,401,251
1500000US131850114033,131850114033,"Block Group 3, Census Tract 114.03, Lowndes County, Georgia",2150,744,2124,740,26,42
1500000US131850114034,131850114034,"Block Group 4, Census Tract 114.03, Lowndes County, Georgia",1724,548,1685,551,39,44
1500000US131850115001,131850115001,"Block Group 1, Census Tract 115, Lowndes County, Georgia",1200,343,1179,353,21,35
1500000US131850115002,131850115002,"Block Group 2, Census Tract 115, Lowndes County, Georgia",2119,428,1968,421,151,94
1500000US131850115003,131850115003,"Block Group 3, Census Tract 115, Lowndes County, Georgia",833,228,816,231,17,32
1500000US131850116001,131850116001,"Block Group 1, Census Tract 116, Lowndes County, Georgia",2493,403,2447,401,46,76
1500000US131850116002,131850116002,"Block Group 2, Census Tract 116, Lowndes County, Georgia",1685,224,1469,229,216,133
1500000US131879601011,131879601011,"Block Group 1, Census Tract 9601.01, Lumpkin County, Georgia",4636,686,4508,660,128,131
1500000US131879601012,131879601012,"Block Group 2, Census Tract 9601.01, Lumpkin County, Georgia",2520,627,2336,593,184,165
1500000US131879601021,131879601021,"Block Group 1, Census Tract 9601.02, Lumpkin County, Georgia",780,413,780,413,0,13
1500000US131879601022,131879601022,"Block Group 2, Census Tract 9601.02, Lumpkin County, Georgia",2766,667,2681,653,85,117
1500000US131879601023,131879601023,"Block Group 3, Census Tract 9601.02, Lumpkin County, Georgia",2166,607,2058,583,108,172
1500000US131879602011,131879602011,"Block Group 1, Census Tract 9602.01, Lumpkin County, Georgia",5211,764,5132,768,79,115
1500000US131879602012,131879602012,"Block Group 2, Census Tract 9602.01, Lumpkin County, Georgia",2569,585,2446,568,123,124
1500000US131879602013,131879602013,"Block Group 3, Census Tract 9602.01, Lumpkin County, Georgia",2545,504,2473,492,72,69
1500000US131879602021,131879602021,"Block Group 1, Census Tract 9602.02, Lumpkin County, Georgia",2127,439,2119,435,8,15
1500000US131879602022,131879602022,"Block Group 2, Census Tract 9602.02, Lumpkin County, Georgia",2122,601,1899,497,223,279
1500000US131879602023,131879602023,"Block Group 3, Census Tract 9602.02, Lumpkin County, Georgia",1356,443,938,370,418,353
1500000US131879602024,131879602024,"Block Group 4, Census Tract 9602.02, Lumpkin County, Georgia",2123,556,2123,556,0,13
1500000US131899501001,131899501001,"Block Group 1, Census Tract 9501, McDuffie County, Georgia",1452,275,1452,275,0,13
1500000US131899501002,131899501002,"Block Group 2, Census Tract 9501, McDuffie County, Georgia",981,211,981,211,0,13
1500000US131899502001,131899502001,"Block Group 1, Census Tract 9502, McDuffie County, Georgia",1580,459,1463,456,117,160
1500000US131899502002,131899502002,"Block Group 2, Census Tract 9502, McDuffie County, Georgia",1485,305,1445,300,40,54
1500000US131899502003,131899502003,"Block Group 3, Census Tract 9502, McDuffie County, Georgia",1418,430,1418,430,0,13
1500000US131899502004,131899502004,"Block Group 4, Census Tract 9502, McDuffie County, Georgia",837,210,837,210,0,13
1500000US131899503001,131899503001,"Block Group 1, Census Tract 9503, McDuffie County, Georgia",1370,325,1370,325,0,13
1500000US131899503002,131899503002,"Block Group 2, Census Tract 9503, McDuffie County, Georgia",1043,333,972,334,71,85
1500000US131899503003,131899503003,"Block Group 3, Census Tract 9503, McDuffie County, Georgia",755,201,755,201,0,13
1500000US131899504001,131899504001,"Block Group 1, Census Tract 9504, McDuffie County, Georgia",1146,386,1146,386,0,13
1500000US131899504002,131899504002,"Block Group 2, Census Tract 9504, McDuffie County, Georgia",825,287,825,287,0,13
1500000US131899504003,131899504003,"Block Group 3, Census Tract 9504, McDuffie County, Georgia",924,377,924,377,0,13
1500000US131899504004,131899504004,"Block Group 4, Census Tract 9504, McDuffie County, Georgia",1152,345,1064,350,88,128
1500000US131899504005,131899504005,"Block Group 5, Census Tract 9504, McDuffie County, Georgia",1128,333,1128,333,0,13
1500000US131899505001,131899505001,"Block Group 1, Census Tract 9505, McDuffie County, Georgia",1060,267,1060,267,0,13
1500000US131899505002,131899505002,"Block Group 2, Census Tract 9505, McDuffie County, Georgia",1341,326,1314,324,27,40
1500000US131899505003,131899505003,"Block Group 3, Census Tract 9505, McDuffie County, Georgia",2084,399,1862,379,222,173
1500000US131899505004,131899505004,"Block Group 4, Census Tract 9505, McDuffie County, Georgia",1001,221,1001,221,0,13
1500000US131911101001,131911101001,"Block Group 1, Census Tract 1101, McIntosh County, Georgia",1576,517,1576,517,0,13
1500000US131911101002,131911101002,"Block Group 2, Census Tract 1101, McIntosh County, Georgia",1425,379,1399,373,26,44
1500000US131911101003,131911101003,"Block Group 3, Census Tract 1101, McIntosh County, Georgia",899,274,899,274,0,13
1500000US131911102001,131911102001,"Block Group 1, Census Tract 1102, McIntosh County, Georgia",2486,638,2486,638,0,13
1500000US131911102002,131911102002,"Block Group 2, Census Tract 1102, McIntosh County, Georgia",1046,457,1046,457,0,13
1500000US131911102003,131911102003,"Block Group 3, Census Tract 1102, McIntosh County, Georgia",1209,527,1180,537,29,50
1500000US131911103001,131911103001,"Block Group 1, Census Tract 1103, McIntosh County, Georgia",1384,400,1382,399,2,6
1500000US131911103002,131911103002,"Block Group 2, Census Tract 1103, McIntosh County, Georgia",1855,457,1833,455,22,22
1500000US131911103003,131911103003,"Block Group 3, Census Tract 1103, McIntosh County, Georgia",2127,426,1967,445,160,183
1500000US131919800001,131919800001,"Block Group 1, Census Tract 9800, McIntosh County, Georgia",0,13,0,13,0,13
1500000US131919900000,131919900000,"Block Group 0, Census Tract 9900, McIntosh County, Georgia",0,13,0,13,0,13
1500000US131930001001,131930001001,"Block Group 1, Census Tract 1, Macon County, Georgia",1215,244,1184,233,31,51
1500000US131930001002,131930001002,"Block Group 2, Census Tract 1, Macon County, Georgia",743,179,743,179,0,13
1500000US131930002001,131930002001,"Block Group 1, Census Tract 2, Macon County, Georgia",1086,267,1068,266,18,30
1500000US131930002002,131930002002,"Block Group 2, Census Tract 2, Macon County, Georgia",872,208,868,208,4,5
1500000US131930003001,131930003001,"Block Group 1, Census Tract 3, Macon County, Georgia",2919,301,2641,247,278,169
1500000US131930003002,131930003002,"Block Group 2, Census Tract 3, Macon County, Georgia",1153,319,1150,319,3,7
1500000US131930003003,131930003003,"Block Group 3, Census Tract 3, Macon County, Georgia",880,252,880,252,0,13
1500000US131930004001,131930004001,"Block Group 1, Census Tract 4, Macon County, Georgia",1258,372,1089,313,169,216
1500000US131930004002,131930004002,"Block Group 2, Census Tract 4, Macon County, Georgia",592,279,592,279,0,13
1500000US131930004003,131930004003,"Block Group 3, Census Tract 4, Macon County, Georgia",605,235,567,230,38,72
1500000US131930004004,131930004004,"Block Group 4, Census Tract 4, Macon County, Georgia",1058,300,1038,305,20,35
1500000US131930004005,131930004005,"Block Group 5, Census Tract 4, Macon County, Georgia",1082,331,1082,331,0,13
1500000US131930004006,131930004006,"Block Group 6, Census Tract 4, Macon County, Georgia",582,297,582,297,0,13
1500000US131950201001,131950201001,"Block Group 1, Census Tract 201, Madison County, Georgia",2201,424,2201,424,0,13
1500000US131950201002,131950201002,"Block Group 2, Census Tract 201, Madison County, Georgia",1510,400,1273,386,237,242
1500000US131950201003,131950201003,"Block Group 3, Census Tract 201, Madison County, Georgia",1497,441,1483,440,14,23
1500000US131950202001,131950202001,"Block Group 1, Census Tract 202, Madison County, Georgia",2271,421,2227,423,44,45
1500000US131950202002,131950202002,"Block Group 2, Census Tract 202, Madison County, Georgia",2683,401,2648,411,35,46
1500000US131950203001,131950203001,"Block Group 1, Census Tract 203, Madison County, Georgia",2396,412,2382,414,14,14
1500000US131950203002,131950203002,"Block Group 2, Census Tract 203, Madison County, Georgia",1206,282,1198,280,8,12
1500000US131950203003,131950203003,"Block Group 3, Census Tract 203, Madison County, Georgia",816,216,811,215,5,8
1500000US131950204001,131950204001,"Block Group 1, Census Tract 204, Madison County, Georgia",2418,466,2068,492,350,246
1500000US131950204002,131950204002,"Block Group 2, Census Tract 204, Madison County, Georgia",1477,401,1270,331,207,261
1500000US131950204003,131950204003,"Block Group 3, Census Tract 204, Madison County, Georgia",1584,436,1576,435,8,15
1500000US131950205001,131950205001,"Block Group 1, Census Tract 205, Madison County, Georgia",2697,549,2540,522,157,181
1500000US131950205002,131950205002,"Block Group 2, Census Tract 205, Madison County, Georgia",2201,366,2141,351,60,90
1500000US131950205003,131950205003,"Block Group 3, Census Tract 205, Madison County, Georgia",1114,300,981,292,133,146
1500000US131950206001,131950206001,"Block Group 1, Census Tract 206, Madison County, Georgia",1029,200,1029,200,0,13
1500000US131950206002,131950206002,"Block Group 2, Census Tract 206, Madison County, Georgia",1132,172,1132,172,0,13
1500000US131979201001,131979201001,"Block Group 1, Census Tract 9201, Marion County, Georgia",2014,421,2014,421,0,13
1500000US131979201002,131979201002,"Block Group 2, Census Tract 9201, Marion County, Georgia",2140,428,1972,363,168,223
1500000US131979202001,131979202001,"Block Group 1, Census Tract 9202, Marion County, Georgia",2153,459,1957,373,196,235
1500000US131979202002,131979202002,"Block Group 2, Census Tract 9202, Marion County, Georgia",1226,345,1226,345,0,13
1500000US131979202003,131979202003,"Block Group 3, Census Tract 9202, Marion County, Georgia",1206,319,937,223,269,244
1500000US131999705001,131999705001,"Block Group 1, Census Tract 9705, Meriwether County, Georgia",871,431,871,431,0,13
1500000US131999705002,131999705002,"Block Group 2, Census Tract 9705, Meriwether County, Georgia",1259,409,1259,409,0,13
1500000US131999705003,131999705003,"Block Group 3, Census Tract 9705, Meriwether County, Georgia",872,318,872,318,0,13
1500000US131999705004,131999705004,"Block Group 4, Census Tract 9705, Meriwether County, Georgia",803,355,803,355,0,13
1500000US131999705005,131999705005,"Block Group 5, Census Tract 9705, Meriwether County, Georgia",775,406,775,406,0,13
1500000US131999705006,131999705006,"Block Group 6, Census Tract 9705, Meriwether County, Georgia",958,378,958,378,0,13
1500000US131999706001,131999706001,"Block Group 1, Census Tract 9706, Meriwether County, Georgia",924,252,911,254,13,16
1500000US131999706002,131999706002,"Block Group 2, Census Tract 9706, Meriwether County, Georgia",1571,307,1486,311,85,91
1500000US131999706003,131999706003,"Block Group 3, Census Tract 9706, Meriwether County, Georgia",1044,290,1044,290,0,13
1500000US131999707001,131999707001,"Block Group 1, Census Tract 9707, Meriwether County, Georgia",2311,505,2277,493,34,62
1500000US131999707002,131999707002,"Block Group 2, Census Tract 9707, Meriwether County, Georgia",1384,366,1269,338,115,120
1500000US131999707003,131999707003,"Block Group 3, Census Tract 9707, Meriwether County, Georgia",1347,438,1319,441,28,43
1500000US131999707004,131999707004,"Block Group 4, Census Tract 9707, Meriwether County, Georgia",1538,380,1476,360,62,106
1500000US131999707005,131999707005,"Block Group 5, Census Tract 9707, Meriwether County, Georgia",684,272,684,272,0,13
1500000US131999708001,131999708001,"Block Group 1, Census Tract 9708, Meriwether County, Georgia",1201,238,1201,238,0,13
1500000US131999708002,131999708002,"Block Group 2, Census Tract 9708, Meriwether County, Georgia",593,167,524,159,69,53
1500000US131999708003,131999708003,"Block Group 3, Census Tract 9708, Meriwether County, Georgia",1012,353,1012,353,0,13
1500000US131999708004,131999708004,"Block Group 4, Census Tract 9708, Meriwether County, Georgia",449,166,449,166,0,13
1500000US131999708005,131999708005,"Block Group 5, Census Tract 9708, Meriwether County, Georgia",1267,312,1241,315,26,37
1500000US131999708006,131999708006,"Block Group 6, Census Tract 9708, Meriwether County, Georgia",434,150,434,150,0,13
1500000US132019501001,132019501001,"Block Group 1, Census Tract 9501, Miller County, Georgia",1616,166,1616,166,0,13
1500000US132019502001,132019502001,"Block Group 1, Census Tract 9502, Miller County, Georgia",797,166,791,166,6,11
1500000US132019502002,132019502002,"Block Group 2, Census Tract 9502, Miller County, Georgia",1133,197,1133,197,0,13
1500000US132019503001,132019503001,"Block Group 1, Census Tract 9503, Miller County, Georgia",753,179,753,179,0,13
1500000US132019503002,132019503002,"Block Group 2, Census Tract 9503, Miller County, Georgia",1637,231,1637,231,0,13
1500000US132050901001,132050901001,"Block Group 1, Census Tract 901, Mitchell County, Georgia",1258,318,1258,318,0,13
1500000US132050901002,132050901002,"Block Group 2, Census Tract 901, Mitchell County, Georgia",2221,312,2035,349,186,213
1500000US132050902001,132050902001,"Block Group 1, Census Tract 902, Mitchell County, Georgia",968,250,959,250,9,15
1500000US132050902002,132050902002,"Block Group 2, Census Tract 902, Mitchell County, Georgia",1320,265,1201,247,119,123
1500000US132050902003,132050902003,"Block Group 3, Census Tract 902, Mitchell County, Georgia",1082,298,932,299,150,143
1500000US132050903001,132050903001,"Block Group 1, Census Tract 903, Mitchell County, Georgia",582,132,582,132,0,13
1500000US132050903002,132050903002,"Block Group 2, Census Tract 903, Mitchell County, Georgia",1435,323,1170,289,265,260
1500000US132050903003,132050903003,"Block Group 3, Census Tract 903, Mitchell County, Georgia",465,208,451,207,14,22
1500000US132050904001,132050904001,"Block Group 1, Census Tract 904, Mitchell County, Georgia",1635,418,1543,433,92,103
1500000US132050904002,132050904002,"Block Group 2, Census Tract 904, Mitchell County, Georgia",3651,803,3558,805,93,44
1500000US132050904003,132050904003,"Block Group 3, Census Tract 904, Mitchell County, Georgia",939,253,927,248,12,22
1500000US132050904004,132050904004,"Block Group 4, Census Tract 904, Mitchell County, Georgia",1791,364,1769,363,22,33
1500000US132050905001,132050905001,"Block Group 1, Census Tract 905, Mitchell County, Georgia",762,219,762,219,0,13
1500000US132050905002,132050905002,"Block Group 2, Census Tract 905, Mitchell County, Georgia",1038,337,1038,337,0,13
1500000US132050905003,132050905003,"Block Group 3, Census Tract 905, Mitchell County, Georgia",983,311,983,311,0,13
1500000US132050905004,132050905004,"Block Group 4, Census Tract 905, Mitchell County, Georgia",1211,298,1179,296,32,50
1500000US132050905005,132050905005,"Block Group 5, Census Tract 905, Mitchell County, Georgia",1641,444,1634,444,7,11
1500000US132070501011,132070501011,"Block Group 1, Census Tract 501.01, Monroe County, Georgia",2044,481,1965,475,79,99
1500000US132070501012,132070501012,"Block Group 2, Census Tract 501.01, Monroe County, Georgia",3332,526,3210,524,122,127
1500000US132070501013,132070501013,"Block Group 3, Census Tract 501.01, Monroe County, Georgia",600,307,600,307,0,13
1500000US132070501021,132070501021,"Block Group 1, Census Tract 501.02, Monroe County, Georgia",2502,393,2410,401,92,119
1500000US132070501022,132070501022,"Block Group 2, Census Tract 501.02, Monroe County, Georgia",1572,402,1567,401,5,10
1500000US132070502001,132070502001,"Block Group 1, Census Tract 502, Monroe County, Georgia",1360,321,1286,310,74,68
1500000US132070502002,132070502002,"Block Group 2, Census Tract 502, Monroe County, Georgia",1730,414,1690,398,40,46
1500000US132070502003,132070502003,"Block Group 3, Census Tract 502, Monroe County, Georgia",2721,457,2721,457,0,13
1500000US132070503011,132070503011,"Block Group 1, Census Tract 503.01, Monroe County, Georgia",1976,441,1953,436,23,25
1500000US132070503012,132070503012,"Block Group 2, Census Tract 503.01, Monroe County, Georgia",1278,370,1274,371,4,9
1500000US132070503013,132070503013,"Block Group 3, Census Tract 503.01, Monroe County, Georgia",1464,397,1446,398,18,19
1500000US132070503021,132070503021,"Block Group 1, Census Tract 503.02, Monroe County, Georgia",1853,571,1840,570,13,18
1500000US132070503022,132070503022,"Block Group 2, Census Tract 503.02, Monroe County, Georgia",2393,393,2288,374,105,127
1500000US132070503023,132070503023,"Block Group 3, Census Tract 503.02, Monroe County, Georgia",2090,526,2060,522,30,35
1500000US132099501001,132099501001,"Block Group 1, Census Tract 9501, Montgomery County, Georgia",1346,155,1346,155,0,13
1500000US132099501002,132099501002,"Block Group 2, Census Tract 9501, Montgomery County, Georgia",722,144,670,132,52,62
1500000US132099502001,132099502001,"Block Group 1, Census Tract 9502, Montgomery County, Georgia",1307,256,1156,242,151,114
1500000US132099502002,132099502002,"Block Group 2, Census Tract 9502, Montgomery County, Georgia",1823,245,1627,252,196,115
1500000US132099502003,132099502003,"Block Group 3, Census Tract 9502, Montgomery County, Georgia",1701,271,1678,272,23,31
1500000US132099503001,132099503001,"Block Group 1, Census Tract 9503, Montgomery County, Georgia",1146,177,1112,174,34,42
1500000US132099503002,132099503002,"Block Group 2, Census Tract 9503, Montgomery County, Georgia",923,183,841,168,82,78
1500000US132110101001,132110101001,"Block Group 1, Census Tract 101, Morgan County, Georgia",2817,251,2641,272,176,85
1500000US132110102001,132110102001,"Block Group 1, Census Tract 102, Morgan County, Georgia",2684,280,2684,280,0,13
1500000US132110102002,132110102002,"Block Group 2, Census Tract 102, Morgan County, Georgia",1160,243,1157,242,3,5
1500000US132110103001,132110103001,"Block Group 1, Census Tract 103, Morgan County, Georgia",2310,380,2213,383,97,102
1500000US132110103002,132110103002,"Block Group 2, Census Tract 103, Morgan County, Georgia",1154,291,1154,291,0,13
1500000US132110103003,132110103003,"Block Group 3, Census Tract 103, Morgan County, Georgia",2398,539,2392,541,6,12
1500000US132110103004,132110103004,"Block Group 4, Census Tract 103, Morgan County, Georgia",954,399,941,395,13,24
1500000US132110104001,132110104001,"Block Group 1, Census Tract 104, Morgan County, Georgia",3004,294,2859,291,145,108
1500000US132110105001,132110105001,"Block Group 1, Census Tract 105, Morgan County, Georgia",1419,168,1335,151,84,101
1500000US132130101001,132130101001,"Block Group 1, Census Tract 101, Murray County, Georgia",841,193,841,193,0,13
1500000US132130101002,132130101002,"Block Group 2, Census Tract 101, Murray County, Georgia",539,176,539,176,0,13
1500000US132130101003,132130101003,"Block Group 3, Census Tract 101, Murray County, Georgia",956,268,786,259,170,162
1500000US132130101004,132130101004,"Block Group 4, Census Tract 101, Murray County, Georgia",930,237,923,238,7,12
1500000US132130102011,132130102011,"Block Group 1, Census Tract 102.01, Murray County, Georgia",1994,272,1921,275,73,59
1500000US132130102021,132130102021,"Block Group 1, Census Tract 102.02, Murray County, Georgia",3785,718,3166,566,619,382
1500000US132130102022,132130102022,"Block Group 2, Census Tract 102.02, Murray County, Georgia",1635,547,1561,543,74,79
1500000US132130102023,132130102023,"Block Group 3, Census Tract 102.02, Murray County, Georgia",2658,723,1640,356,1018,587
1500000US132130102024,132130102024,"Block Group 4, Census Tract 102.02, Murray County, Georgia",973,408,642,280,331,295
1500000US132130103001,132130103001,"Block Group 1, Census Tract 103, Murray County, Georgia",553,236,553,236,0,13
1500000US132130103002,132130103002,"Block Group 2, Census Tract 103, Murray County, Georgia",1607,285,1580,287,27,26
1500000US132130103003,132130103003,"Block Group 3, Census Tract 103, Murray County, Georgia",1722,376,1657,354,65,67
1500000US132130104001,132130104001,"Block Group 1, Census Tract 104, Murray County, Georgia",1490,330,1422,356,68,85
1500000US132130104002,132130104002,"Block Group 2, Census Tract 104, Murray County, Georgia",790,322,790,322,0,13
1500000US132130104003,132130104003,"Block Group 3, Census Tract 104, Murray County, Georgia",2607,650,2046,698,561,282
1500000US132130104004,132130104004,"Block Group 4, Census Tract 104, Murray County, Georgia",1198,384,1143,393,55,101
1500000US132130105001,132130105001,"Block Group 1, Census Tract 105, Murray County, Georgia",640,299,623,298,17,28
1500000US132130105002,132130105002,"Block Group 2, Census Tract 105, Murray County, Georgia",2147,372,1544,282,603,314
1500000US132130105003,132130105003,"Block Group 3, Census Tract 105, Murray County, Georgia",2527,378,1824,340,703,282
1500000US132130106001,132130106001,"Block Group 1, Census Tract 106, Murray County, Georgia",1454,392,1325,350,129,149
1500000US132130106002,132130106002,"Block Group 2, Census Tract 106, Murray County, Georgia",1527,369,1383,373,144,131
1500000US132130106003,132130106003,"Block Group 3, Census Tract 106, Murray County, Georgia",1161,304,1161,304,0,13
1500000US132130107001,132130107001,"Block Group 1, Census Tract 107, Murray County, Georgia",1905,331,1731,317,174,155
1500000US132130107002,132130107002,"Block Group 2, Census Tract 107, Murray County, Georgia",1754,439,1149,308,605,417
1500000US132130107003,132130107003,"Block Group 3, Census Tract 107, Murray County, Georgia",436,128,436,128,0,13
1500000US132130107004,132130107004,"Block Group 4, Census Tract 107, Murray County, Georgia",1572,473,1522,471,50,84
1500000US132150002001,132150002001,"Block Group 1, Census Tract 2, Muscogee County, Georgia",1646,239,1447,234,199,177
1500000US132150002002,132150002002,"Block Group 2, Census Tract 2, Muscogee County, Georgia",1187,282,1129,287,58,64
1500000US132150003001,132150003001,"Block Group 1, Census Tract 3, Muscogee County, Georgia",774,161,574,150,200,145
1500000US132150003002,132150003002,"Block Group 2, Census Tract 3, Muscogee County, Georgia",605,160,369,86,236,123
1500000US132150004001,132150004001,"Block Group 1, Census Tract 4, Muscogee County, Georgia",911,232,911,232,0,13
1500000US132150004002,132150004002,"Block Group 2, Census Tract 4, Muscogee County, Georgia",1114,223,1087,223,27,31
1500000US132150004003,132150004003,"Block Group 3, Census Tract 4, Muscogee County, Georgia",736,230,705,208,31,49
1500000US132150008001,132150008001,"Block Group 1, Census Tract 8, Muscogee County, Georgia",1040,209,973,201,67,63
1500000US132150008002,132150008002,"Block Group 2, Census Tract 8, Muscogee County, Georgia",1349,263,1237,257,112,123
1500000US132150009001,132150009001,"Block Group 1, Census Tract 9, Muscogee County, Georgia",1104,301,1003,257,101,136
1500000US132150009002,132150009002,"Block Group 2, Census Tract 9, Muscogee County, Georgia",1537,283,1453,276,84,75
1500000US132150010001,132150010001,"Block Group 1, Census Tract 10, Muscogee County, Georgia",1752,624,1660,618,92,92
1500000US132150010002,132150010002,"Block Group 2, Census Tract 10, Muscogee County, Georgia",1971,382,1804,367,167,134
1500000US132150010003,132150010003,"Block Group 3, Census Tract 10, Muscogee County, Georgia",700,215,676,212,24,21
1500000US132150011001,132150011001,"Block Group 1, Census Tract 11, Muscogee County, Georgia",1700,178,1636,180,64,72
1500000US132150011002,132150011002,"Block Group 2, Census Tract 11, Muscogee County, Georgia",938,182,938,182,0,13
1500000US132150012001,132150012001,"Block Group 1, Census Tract 12, Muscogee County, Georgia",1184,236,1111,238,73,61
1500000US132150012002,132150012002,"Block Group 2, Census Tract 12, Muscogee County, Georgia",1071,253,1049,251,22,20
1500000US132150012003,132150012003,"Block Group 3, Census Tract 12, Muscogee County, Georgia",1153,305,1143,304,10,15
1500000US132150014001,132150014001,"Block Group 1, Census Tract 14, Muscogee County, Georgia",1004,244,956,236,48,44
1500000US132150014002,132150014002,"Block Group 2, Census Tract 14, Muscogee County, Georgia",814,196,768,207,46,56
1500000US132150016001,132150016001,"Block Group 1, Census Tract 16, Muscogee County, Georgia",1395,288,1319,262,76,61
1500000US132150016002,132150016002,"Block Group 2, Census Tract 16, Muscogee County, Georgia",971,241,962,239,9,16
1500000US132150018001,132150018001,"Block Group 1, Census Tract 18, Muscogee County, Georgia",1202,190,1114,189,88,76
1500000US132150020001,132150020001,"Block Group 1, Census Tract 20, Muscogee County, Georgia",2587,470,2478,478,109,147
1500000US132150020002,132150020002,"Block Group 2, Census Tract 20, Muscogee County, Georgia",988,253,980,258,8,15
1500000US132150021001,132150021001,"Block Group 1, Census Tract 21, Muscogee County, Georgia",807,253,749,248,58,71
1500000US132150021002,132150021002,"Block Group 2, Census Tract 21, Muscogee County, Georgia",1740,322,1650,320,90,66
1500000US132150022001,132150022001,"Block Group 1, Census Tract 22, Muscogee County, Georgia",990,502,990,502,0,13
1500000US132150022002,132150022002,"Block Group 2, Census Tract 22, Muscogee County, Georgia",835,258,835,258,0,13
1500000US132150022003,132150022003,"Block Group 3, Census Tract 22, Muscogee County, Georgia",342,142,342,142,0,13
1500000US132150022004,132150022004,"Block Group 4, Census Tract 22, Muscogee County, Georgia",1185,448,1153,431,32,52
1500000US132150023001,132150023001,"Block Group 1, Census Tract 23, Muscogee County, Georgia",1461,200,1374,185,87,76
1500000US132150024001,132150024001,"Block Group 1, Census Tract 24, Muscogee County, Georgia",1515,209,1477,222,38,66
1500000US132150025001,132150025001,"Block Group 1, Census Tract 25, Muscogee County, Georgia",1299,475,1258,432,41,54
1500000US132150025002,132150025002,"Block Group 2, Census Tract 25, Muscogee County, Georgia",582,179,529,162,53,84
1500000US132150027001,132150027001,"Block Group 1, Census Tract 27, Muscogee County, Georgia",2187,383,2187,383,0,13
1500000US132150028001,132150028001,"Block Group 1, Census Tract 28, Muscogee County, Georgia",840,213,763,195,77,98
1500000US132150028002,132150028002,"Block Group 2, Census Tract 28, Muscogee County, Georgia",1017,205,1003,210,14,23
1500000US132150029011,132150029011,"Block Group 1, Census Tract 29.01, Muscogee County, Georgia",803,258,803,258,0,13
1500000US132150029012,132150029012,"Block Group 2, Census Tract 29.01, Muscogee County, Georgia",2069,385,1864,329,205,211
1500000US132150029021,132150029021,"Block Group 1, Census Tract 29.02, Muscogee County, Georgia",1409,341,1343,320,66,79
1500000US132150029022,132150029022,"Block Group 2, Census Tract 29.02, Muscogee County, Georgia",955,233,940,232,15,15
1500000US132150030001,132150030001,"Block Group 1, Census Tract 30, Muscogee County, Georgia",444,274,287,143,157,237
1500000US132150030002,132150030002,"Block Group 2, Census Tract 30, Muscogee County, Georgia",1469,351,1445,354,24,39
1500000US132150030003,132150030003,"Block Group 3, Census Tract 30, Muscogee County, Georgia",687,262,687,262,0,13
1500000US132150032001,132150032001,"Block Group 1, Census Tract 32, Muscogee County, Georgia",340,92,340,92,0,13
1500000US132150032002,132150032002,"Block Group 2, Census Tract 32, Muscogee County, Georgia",732,249,732,249,0,13
1500000US132150032003,132150032003,"Block Group 3, Census Tract 32, Muscogee County, Georgia",699,268,525,223,174,137
1500000US132150033011,132150033011,"Block Group 1, Census Tract 33.01, Muscogee County, Georgia",1428,281,1405,280,23,36
1500000US132150033021,132150033021,"Block Group 1, Census Tract 33.02, Muscogee County, Georgia",825,230,756,237,69,58
1500000US132150033022,132150033022,"Block Group 2, Census Tract 33.02, Muscogee County, Georgia",962,257,924,253,38,58
1500000US132150033023,132150033023,"Block Group 3, Census Tract 33.02, Muscogee County, Georgia",887,274,887,274,0,13
1500000US132150034001,132150034001,"Block Group 1, Census Tract 34, Muscogee County, Georgia",716,189,706,187,10,16
1500000US132150034002,132150034002,"Block Group 2, Census Tract 34, Muscogee County, Georgia",1609,298,1343,262,266,191
1500000US132150101041,132150101041,"Block Group 1, Census Tract 101.04, Muscogee County, Georgia",1655,421,1531,398,124,107
1500000US132150101042,132150101042,"Block Group 2, Census Tract 101.04, Muscogee County, Georgia",3004,486,2613,435,391,256
1500000US132150101043,132150101043,"Block Group 3, Census Tract 101.04, Muscogee County, Georgia",1918,467,1807,433,111,147
1500000US132150101061,132150101061,"Block Group 1, Census Tract 101.06, Muscogee County, Georgia",698,247,686,237,12,50
1500000US132150101062,132150101062,"Block Group 2, Census Tract 101.06, Muscogee County, Georgia",1875,436,1763,432,112,115
1500000US132150101063,132150101063,"Block Group 3, Census Tract 101.06, Muscogee County, Georgia",2937,714,2508,626,429,305
1500000US132150101071,132150101071,"Block Group 1, Census Tract 101.07, Muscogee County, Georgia",3299,541,3224,543,75,81
1500000US132150101072,132150101072,"Block Group 2, Census Tract 101.07, Muscogee County, Georgia",4456,567,3968,555,488,242
1500000US132150102011,132150102011,"Block Group 1, Census Tract 102.01, Muscogee County, Georgia",4448,700,3998,613,450,353
1500000US132150102012,132150102012,"Block Group 2, Census Tract 102.01, Muscogee County, Georgia",2314,419,2284,417,30,34
1500000US132150102031,132150102031,"Block Group 1, Census Tract 102.03, Muscogee County, Georgia",3742,610,3459,619,283,220
1500000US132150102032,132150102032,"Block Group 2, Census Tract 102.03, Muscogee County, Georgia",5076,611,4679,596,397,251
1500000US132150102041,132150102041,"Block Group 1, Census Tract 102.04, Muscogee County, Georgia",2241,469,2051,468,190,179
1500000US132150102042,132150102042,"Block Group 2, Census Tract 102.04, Muscogee County, Georgia",1536,334,1431,328,105,82
1500000US132150102043,132150102043,"Block Group 3, Census Tract 102.04, Muscogee County, Georgia",2891,540,2657,520,234,139
1500000US132150102051,132150102051,"Block Group 1, Census Tract 102.05, Muscogee County, Georgia",1523,350,1388,331,135,137
1500000US132150102052,132150102052,"Block Group 2, Census Tract 102.05, Muscogee County, Georgia",1981,245,1914,247,67,66
1500000US132150103011,132150103011,"Block Group 1, Census Tract 103.01, Muscogee County, Georgia",2529,176,2491,182,38,36
1500000US132150103021,132150103021,"Block Group 1, Census Tract 103.02, Muscogee County, Georgia",1702,446,1702,446,0,13
1500000US132150103022,132150103022,"Block Group 2, Census Tract 103.02, Muscogee County, Georgia",2733,579,2523,597,210,176
1500000US132150103023,132150103023,"Block Group 3, Census Tract 103.02, Muscogee County, Georgia",2521,409,2385,400,136,99
1500000US132150104011,132150104011,"Block Group 1, Census Tract 104.01, Muscogee County, Georgia",2165,527,2072,518,93,123
1500000US132150104012,132150104012,"Block Group 2, Census Tract 104.01, Muscogee County, Georgia",2936,724,2371,542,565,504
1500000US132150104013,132150104013,"Block Group 3, Census Tract 104.01, Muscogee County, Georgia",1545,336,1462,355,83,92
1500000US132150104021,132150104021,"Block Group 1, Census Tract 104.02, Muscogee County, Georgia",1097,338,894,258,203,230
1500000US132150104022,132150104022,"Block Group 2, Census Tract 104.02, Muscogee County, Georgia",1430,377,1350,332,80,82
1500000US132150104023,132150104023,"Block Group 3, Census Tract 104.02, Muscogee County, Georgia",1699,276,1581,301,118,152
1500000US132150105011,132150105011,"Block Group 1, Census Tract 105.01, Muscogee County, Georgia",1128,343,1088,340,40,47
1500000US132150105012,132150105012,"Block Group 2, Census Tract 105.01, Muscogee County, Georgia",1772,465,1624,466,148,130
1500000US132150105013,132150105013,"Block Group 3, Census Tract 105.01, Muscogee County, Georgia",1598,372,1576,362,22,36
1500000US132150105014,132150105014,"Block Group 4, Census Tract 105.01, Muscogee County, Georgia",1533,444,1500,441,33,42
1500000US132150105021,132150105021,"Block Group 1, Census Tract 105.02, Muscogee County, Georgia",1598,180,1444,170,154,95
1500000US132150106021,132150106021,"Block Group 1, Census Tract 106.02, Muscogee County, Georgia",2280,460,2088,425,192,206
1500000US132150106022,132150106022,"Block Group 2, Census Tract 106.02, Muscogee County, Georgia",493,165,456,149,37,55
1500000US132150106023,132150106023,"Block Group 3, Census Tract 106.02, Muscogee County, Georgia",2615,511,2485,520,130,91
1500000US132150106051,132150106051,"Block Group 1, Census Tract 106.05, Muscogee County, Georgia",2190,504,1990,406,200,267
1500000US132150106052,132150106052,"Block Group 2, Census Tract 106.05, Muscogee County, Georgia",2307,493,2254,491,53,67
1500000US132150106061,132150106061,"Block Group 1, Census Tract 106.06, Muscogee County, Georgia",2406,320,2268,294,138,61
1500000US132150106071,132150106071,"Block Group 1, Census Tract 106.07, Muscogee County, Georgia",1292,373,1292,373,0,13
1500000US132150106072,132150106072,"Block Group 2, Census Tract 106.07, Muscogee County, Georgia",2002,495,1956,502,46,49
1500000US132150106073,132150106073,"Block Group 3, Census Tract 106.07, Muscogee County, Georgia",2674,478,2663,480,11,17
1500000US132150106081,132150106081,"Block Group 1, Census Tract 106.08, Muscogee County, Georgia",2373,470,2314,474,59,87
1500000US132150106082,132150106082,"Block Group 2, Census Tract 106.08, Muscogee County, Georgia",2211,517,2161,502,50,90
1500000US132150107011,132150107011,"Block Group 1, Census Tract 107.01, Muscogee County, Georgia",2091,654,2044,658,47,50
1500000US132150107012,132150107012,"Block Group 2, Census Tract 107.01, Muscogee County, Georgia",2170,504,1903,481,267,271
1500000US132150107013,132150107013,"Block Group 3, Census Tract 107.01, Muscogee County, Georgia",1876,571,1817,570,59,70
1500000US132150107021,132150107021,"Block Group 1, Census Tract 107.02, Muscogee County, Georgia",769,235,702,209,67,91
1500000US132150107022,132150107022,"Block Group 2, Census Tract 107.02, Muscogee County, Georgia",2328,444,2276,431,52,48
1500000US132150107023,132150107023,"Block Group 3, Census Tract 107.02, Muscogee County, Georgia",1828,341,1783,346,45,48
1500000US132150107031,132150107031,"Block Group 1, Census Tract 107.03, Muscogee County, Georgia",1782,417,1710,428,72,114
1500000US132150107032,132150107032,"Block Group 2, Census Tract 107.03, Muscogee County, Georgia",2271,626,2271,626,0,13
1500000US132150107033,132150107033,"Block Group 3, Census Tract 107.03, Muscogee County, Georgia",1151,297,1151,297,0,13
1500000US132150107034,132150107034,"Block Group 4, Census Tract 107.03, Muscogee County, Georgia",945,301,925,297,20,30
1500000US132150108011,132150108011,"Block Group 1, Census Tract 108.01, Muscogee County, Georgia",308,99,296,100,12,19
1500000US132150108012,132150108012,"Block Group 2, Census Tract 108.01, Muscogee County, Georgia",1288,292,1057,290,231,100
1500000US132150108021,132150108021,"Block Group 1, Census Tract 108.02, Muscogee County, Georgia",2390,439,2012,370,378,251
1500000US132150108022,132150108022,"Block Group 2, Census Tract 108.02, Muscogee County, Georgia",6767,1100,5290,1015,1477,381
1500000US132150108023,132150108023,"Block Group 3, Census Tract 108.02, Muscogee County, Georgia",1017,264,813,250,204,144
1500000US132150111001,132150111001,"Block Group 1, Census Tract 111, Muscogee County, Georgia",1470,211,1405,202,65,48
1500000US132150111002,132150111002,"Block Group 2, Census Tract 111, Muscogee County, Georgia",567,229,567,229,0,13
1500000US132150112001,132150112001,"Block Group 1, Census Tract 112, Muscogee County, Georgia",1191,206,1137,201,54,51
1500000US132150112002,132150112002,"Block Group 2, Census Tract 112, Muscogee County, Georgia",1041,309,983,302,58,93
1500000US132150114001,132150114001,"Block Group 1, Census Tract 114, Muscogee County, Georgia",1535,242,1414,224,121,126
1500000US132150114002,132150114002,"Block Group 2, Census Tract 114, Muscogee County, Georgia",732,202,633,193,99,85
1500000US132150115001,132150115001,"Block Group 1, Census Tract 115, Muscogee County, Georgia",1027,351,694,232,333,262
1500000US132150115002,132150115002,"Block Group 2, Census Tract 115, Muscogee County, Georgia",488,199,488,199,0,13
1500000US132150115003,132150115003,"Block Group 3, Census Tract 115, Muscogee County, Georgia",1657,417,1385,383,272,296
1500000US132150115004,132150115004,"Block Group 4, Census Tract 115, Muscogee County, Georgia",1241,284,1078,267,163,131
1500000US132150115005,132150115005,"Block Group 5, Census Tract 115, Muscogee County, Georgia",1127,504,677,397,450,349
1500000US132150115006,132150115006,"Block Group 6, Census Tract 115, Muscogee County, Georgia",538,163,492,160,46,61
1500000US132171001001,132171001001,"Block Group 1, Census Tract 1001, Newton County, Georgia",2455,559,2435,551,20,31
1500000US132171001002,132171001002,"Block Group 2, Census Tract 1001, Newton County, Georgia",3098,905,3053,895,45,58
1500000US132171001003,132171001003,"Block Group 3, Census Tract 1001, Newton County, Georgia",2795,639,2795,639,0,13
1500000US132171001004,132171001004,"Block Group 4, Census Tract 1001, Newton County, Georgia",3070,618,2958,606,112,70
1500000US132171002011,132171002011,"Block Group 1, Census Tract 1002.01, Newton County, Georgia",1971,436,1971,436,0,13
1500000US132171002012,132171002012,"Block Group 2, Census Tract 1002.01, Newton County, Georgia",1269,283,1201,276,68,55
1500000US132171002013,132171002013,"Block Group 3, Census Tract 1002.01, Newton County, Georgia",2814,483,2791,482,23,37
1500000US132171002021,132171002021,"Block Group 1, Census Tract 1002.02, Newton County, Georgia",2888,354,2862,351,26,31
1500000US132171002022,132171002022,"Block Group 2, Census Tract 1002.02, Newton County, Georgia",2158,377,2081,375,77,102
1500000US132171003001,132171003001,"Block Group 1, Census Tract 1003, Newton County, Georgia",2498,627,2110,469,388,417
1500000US132171003002,132171003002,"Block Group 2, Census Tract 1003, Newton County, Georgia",3125,659,2846,564,279,226
1500000US132171003003,132171003003,"Block Group 3, Census Tract 1003, Newton County, Georgia",2442,607,2310,448,132,357
1500000US132171003004,132171003004,"Block Group 4, Census Tract 1003, Newton County, Georgia",1103,266,1103,266,0,13
1500000US132171004001,132171004001,"Block Group 1, Census Tract 1004, Newton County, Georgia",2406,464,2207,453,199,210
1500000US132171004002,132171004002,"Block Group 2, Census Tract 1004, Newton County, Georgia",1171,245,1157,247,14,22
1500000US132171005011,132171005011,"Block Group 1, Census Tract 1005.01, Newton County, Georgia",5602,1316,4918,1308,684,323
1500000US132171005012,132171005012,"Block Group 2, Census Tract 1005.01, Newton County, Georgia",8924,1200,8794,1189,130,151
1500000US132171005013,132171005013,"Block Group 3, Census Tract 1005.01, Newton County, Georgia",978,452,836,323,142,253
1500000US132171005021,132171005021,"Block Group 1, Census Tract 1005.02, Newton County, Georgia",5362,918,5108,900,254,214
1500000US132171005022,132171005022,"Block Group 2, Census Tract 1005.02, Newton County, Georgia",3012,933,2634,856,378,367
1500000US132171006001,132171006001,"Block Group 1, Census Tract 1006, Newton County, Georgia",3640,536,3551,526,89,104
1500000US132171006002,132171006002,"Block Group 2, Census Tract 1006, Newton County, Georgia",1944,434,1781,413,163,156
1500000US132171007001,132171007001,"Block Group 1, Census Tract 1007, Newton County, Georgia",980,279,980,279,0,13
1500000US132171007002,132171007002,"Block Group 2, Census Tract 1007, Newton County, Georgia",2435,633,2206,635,229,210
1500000US132171007003,132171007003,"Block Group 3, Census Tract 1007, Newton County, Georgia",2724,687,2636,675,88,134
1500000US132171008001,132171008001,"Block Group 1, Census Tract 1008, Newton County, Georgia",3847,686,3663,681,184,241
1500000US132171008002,132171008002,"Block Group 2, Census Tract 1008, Newton County, Georgia",5899,824,5899,824,0,18
1500000US132171009011,132171009011,"Block Group 1, Census Tract 1009.01, Newton County, Georgia",4170,792,3943,757,227,267
1500000US132171009012,132171009012,"Block Group 2, Census Tract 1009.01, Newton County, Georgia",3445,896,3445,896,0,13
1500000US132171009013,132171009013,"Block Group 3, Census Tract 1009.01, Newton County, Georgia",2419,537,2419,537,0,13
1500000US132171009021,132171009021,"Block Group 1, Census Tract 1009.02, Newton County, Georgia",2960,824,2899,812,61,55
1500000US132171009022,132171009022,"Block Group 2, Census Tract 1009.02, Newton County, Georgia",2906,717,2384,587,522,435
1500000US132171009031,132171009031,"Block Group 1, Census Tract 1009.03, Newton County, Georgia",4924,619,4465,597,459,328
1500000US132171009032,132171009032,"Block Group 2, Census Tract 1009.03, Newton County, Georgia",1211,556,1181,553,30,53
1500000US132190301001,132190301001,"Block Group 1, Census Tract 301, Oconee County, Georgia",3854,561,3769,552,85,82
1500000US132190301002,132190301002,"Block Group 2, Census Tract 301, Oconee County, Georgia",4170,607,3866,640,304,196
1500000US132190301003,132190301003,"Block Group 3, Census Tract 301, Oconee County, Georgia",2061,291,1806,294,255,138
1500000US132190301004,132190301004,"Block Group 4, Census Tract 301, Oconee County, Georgia",1496,462,1485,465,11,17
1500000US132190302001,132190302001,"Block Group 1, Census Tract 302, Oconee County, Georgia",2637,397,2343,374,294,230
1500000US132190302002,132190302002,"Block Group 2, Census Tract 302, Oconee County, Georgia",2876,366,2783,353,93,82
1500000US132190303001,132190303001,"Block Group 1, Census Tract 303, Oconee County, Georgia",3031,340,2866,336,165,124
1500000US132190303002,132190303002,"Block Group 2, Census Tract 303, Oconee County, Georgia",2141,306,2104,309,37,44
1500000US132190304001,132190304001,"Block Group 1, Census Tract 304, Oconee County, Georgia",1855,363,1792,352,63,78
1500000US132190304002,132190304002,"Block Group 2, Census Tract 304, Oconee County, Georgia",2160,339,2160,339,0,13
1500000US132190304003,132190304003,"Block Group 3, Census Tract 304, Oconee County, Georgia",3227,358,3122,364,105,102
1500000US132190305001,132190305001,"Block Group 1, Census Tract 305, Oconee County, Georgia",2118,241,2080,237,38,53
1500000US132190306001,132190306001,"Block Group 1, Census Tract 306, Oconee County, Georgia",1923,258,1768,208,155,120
1500000US132190306002,132190306002,"Block Group 2, Census Tract 306, Oconee County, Georgia",851,178,851,178,0,13
1500000US132219601001,132219601001,"Block Group 1, Census Tract 9601, Oglethorpe County, Georgia",816,175,775,161,41,70
1500000US132219601002,132219601002,"Block Group 2, Census Tract 9601, Oglethorpe County, Georgia",927,166,927,166,0,13
1500000US132219602011,132219602011,"Block Group 1, Census Tract 9602.01, Oglethorpe County, Georgia",1879,351,1763,365,116,104
1500000US132219602012,132219602012,"Block Group 2, Census Tract 9602.01, Oglethorpe County, Georgia",1359,294,1352,294,7,15
1500000US132219602013,132219602013,"Block Group 3, Census Tract 9602.01, Oglethorpe County, Georgia",3459,468,3259,456,200,173
1500000US132219602021,132219602021,"Block Group 1, Census Tract 9602.02, Oglethorpe County, Georgia",1635,305,1542,298,93,83
1500000US132219602022,132219602022,"Block Group 2, Census Tract 9602.02, Oglethorpe County, Georgia",1051,234,1036,226,15,25
1500000US132219602023,132219602023,"Block Group 3, Census Tract 9602.02, Oglethorpe County, Georgia",1879,386,1850,388,29,45
1500000US132219603001,132219603001,"Block Group 1, Census Tract 9603, Oglethorpe County, Georgia",1683,197,1606,169,77,99
1500000US132231201011,132231201011,"Block Group 1, Census Tract 1201.01, Paulding County, Georgia",5869,769,5869,769,0,18
1500000US132231201012,132231201012,"Block Group 2, Census Tract 1201.01, Paulding County, Georgia",4608,967,4359,1026,249,187
1500000US132231201013,132231201013,"Block Group 3, Census Tract 1201.01, Paulding County, Georgia",1419,542,1389,528,30,52
1500000US132231201021,132231201021,"Block Group 1, Census Tract 1201.02, Paulding County, Georgia",5931,1087,5227,955,704,611
1500000US132231201022,132231201022,"Block Group 2, Census Tract 1201.02, Paulding County, Georgia",5993,930,5697,908,296,241
1500000US132231201031,132231201031,"Block Group 1, Census Tract 1201.03, Paulding County, Georgia",2665,578,2391,599,274,115
1500000US132231201032,132231201032,"Block Group 2, Census Tract 1201.03, Paulding County, Georgia",6987,749,6844,722,143,149
1500000US132231201041,132231201041,"Block Group 1, Census Tract 1201.04, Paulding County, Georgia",2367,231,2349,227,18,18
1500000US132231202021,132231202021,"Block Group 1, Census Tract 1202.02, Paulding County, Georgia",5187,795,5105,771,82,90
1500000US132231202022,132231202022,"Block Group 2, Census Tract 1202.02, Paulding County, Georgia",2557,507,2272,496,285,194
1500000US132231202031,132231202031,"Block Group 1, Census Tract 1202.03, Paulding County, Georgia",2437,448,2356,417,81,72
1500000US132231202032,132231202032,"Block Group 2, Census Tract 1202.03, Paulding County, Georgia",2621,575,2576,571,45,54
1500000US132231202041,132231202041,"Block Group 1, Census Tract 1202.04, Paulding County, Georgia",3950,540,3837,545,113,109
1500000US132231202042,132231202042,"Block Group 2, Census Tract 1202.04, Paulding County, Georgia",2711,706,2623,703,88,95
1500000US132231203011,132231203011,"Block Group 1, Census Tract 1203.01, Paulding County, Georgia",3743,606,3592,609,151,155
1500000US132231203012,132231203012,"Block Group 2, Census Tract 1203.01, Paulding County, Georgia",1546,418,1383,370,163,175
1500000US132231203021,132231203021,"Block Group 1, Census Tract 1203.02, Paulding County, Georgia",2286,1245,2137,1078,149,199
1500000US132231203022,132231203022,"Block Group 2, Census Tract 1203.02, Paulding County, Georgia",3949,913,3860,912,89,123
1500000US132231203023,132231203023,"Block Group 3, Census Tract 1203.02, Paulding County, Georgia",4031,1321,3445,1127,586,538
1500000US132231203024,132231203024,"Block Group 4, Census Tract 1203.02, Paulding County, Georgia",3747,988,2576,802,1171,828
1500000US132231203031,132231203031,"Block Group 1, Census Tract 1203.03, Paulding County, Georgia",1833,243,1797,233,36,47
1500000US132231204001,132231204001,"Block Group 1, Census Tract 1204, Paulding County, Georgia",7050,1762,6897,1731,153,236
1500000US132231204002,132231204002,"Block Group 2, Census Tract 1204, Paulding County, Georgia",5743,786,5654,794,89,96
1500000US132231204003,132231204003,"Block Group 3, Census Tract 1204, Paulding County, Georgia",1775,545,1696,498,79,131
1500000US132231204004,132231204004,"Block Group 4, Census Tract 1204, Paulding County, Georgia",3735,1058,3735,1058,0,13
1500000US132231205011,132231205011,"Block Group 1, Census Tract 1205.01, Paulding County, Georgia",3706,802,3109,636,597,503
1500000US132231205012,132231205012,"Block Group 2, Census Tract 1205.01, Paulding County, Georgia",2506,447,2460,447,46,99
1500000US132231205021,132231205021,"Block Group 1, Census Tract 1205.02, Paulding County, Georgia",1589,566,1589,566,0,13
1500000US132231205022,132231205022,"Block Group 2, Census Tract 1205.02, Paulding County, Georgia",1459,465,1373,413,86,156
1500000US132231205023,132231205023,"Block Group 3, Census Tract 1205.02, Paulding County, Georgia",2899,691,2704,681,195,192
1500000US132231205024,132231205024,"Block Group 4, Census Tract 1205.02, Paulding County, Georgia",1675,600,1675,600,0,13
1500000US132231205025,132231205025,"Block Group 5, Census Tract 1205.02, Paulding County, Georgia",1401,401,1167,343,234,269
1500000US132231205031,132231205031,"Block Group 1, Census Tract 1205.03, Paulding County, Georgia",3938,480,3851,473,87,115
1500000US132231205032,132231205032,"Block Group 2, Census Tract 1205.03, Paulding County, Georgia",1318,373,1292,369,26,41
1500000US132231206011,132231206011,"Block Group 1, Census Tract 1206.01, Paulding County, Georgia",2504,568,2089,493,415,260
1500000US132231206012,132231206012,"Block Group 2, Census Tract 1206.01, Paulding County, Georgia",1888,418,1814,429,74,87
1500000US132231206021,132231206021,"Block Group 1, Census Tract 1206.02, Paulding County, Georgia",1035,461,949,445,86,121
1500000US132231206022,132231206022,"Block Group 2, Census Tract 1206.02, Paulding County, Georgia",3506,740,3427,746,79,131
1500000US132231206023,132231206023,"Block Group 3, Census Tract 1206.02, Paulding County, Georgia",1904,591,1880,593,24,34
1500000US132231206024,132231206024,"Block Group 4, Census Tract 1206.02, Paulding County, Georgia",3272,663,3051,649,221,142
1500000US132231206031,132231206031,"Block Group 1, Census Tract 1206.03, Paulding County, Georgia",3578,687,3321,656,257,141
1500000US132231206032,132231206032,"Block Group 2, Census Tract 1206.03, Paulding County, Georgia",2622,771,2458,728,164,216
1500000US132231206041,132231206041,"Block Group 1, Census Tract 1206.04, Paulding County, Georgia",2501,427,2476,433,25,25
1500000US132231206042,132231206042,"Block Group 2, Census Tract 1206.04, Paulding County, Georgia",3142,415,2893,414,249,266
1500000US132231206051,132231206051,"Block Group 1, Census Tract 1206.05, Paulding County, Georgia",4715,616,4625,618,90,103
1500000US132231206052,132231206052,"Block Group 2, Census Tract 1206.05, Paulding County, Georgia",1502,452,1448,457,54,67
1500000US132250401011,132250401011,"Block Group 1, Census Tract 401.01, Peach County, Georgia",1695,258,1695,258,0,13
1500000US132250401021,132250401021,"Block Group 1, Census Tract 401.02, Peach County, Georgia",3609,589,3452,579,157,152
1500000US132250401022,132250401022,"Block Group 2, Census Tract 401.02, Peach County, Georgia",1682,434,1682,434,0,13
1500000US132250401023,132250401023,"Block Group 3, Census Tract 401.02, Peach County, Georgia",3420,632,3420,632,0,13
1500000US132250401024,132250401024,"Block Group 4, Census Tract 401.02, Peach County, Georgia",1303,496,1303,496,0,13
1500000US132250402001,132250402001,"Block Group 1, Census Tract 402, Peach County, Georgia",2304,458,1944,423,360,271
1500000US132250402002,132250402002,"Block Group 2, Census Tract 402, Peach County, Georgia",2262,369,1651,272,611,255
1500000US132250403011,132250403011,"Block Group 1, Census Tract 403.01, Peach County, Georgia",1624,309,1275,264,349,181
1500000US132250403012,132250403012,"Block Group 2, Census Tract 403.01, Peach County, Georgia",1021,248,831,216,190,138
1500000US132250403021,132250403021,"Block Group 1, Census Tract 403.02, Peach County, Georgia",2115,289,1942,286,173,115
1500000US132250404001,132250404001,"Block Group 1, Census Tract 404, Peach County, Georgia",4285,400,4175,398,110,76
1500000US132250404002,132250404002,"Block Group 2, Census Tract 404, Peach County, Georgia",1766,326,1766,326,0,13
1500000US132270501001,132270501001,"Block Group 1, Census Tract 501, Pickens County, Georgia",2017,424,1867,394,150,155
1500000US132270501002,132270501002,"Block Group 2, Census Tract 501, Pickens County, Georgia",1747,392,1747,392,0,13
1500000US132270501003,132270501003,"Block Group 3, Census Tract 501, Pickens County, Georgia",1355,325,1355,325,0,13
1500000US132270502001,132270502001,"Block Group 1, Census Tract 502, Pickens County, Georgia",1462,418,1462,418,0,13
1500000US132270502002,132270502002,"Block Group 2, Census Tract 502, Pickens County, Georgia",2056,378,1994,393,62,83
1500000US132270502003,132270502003,"Block Group 3, Census Tract 502, Pickens County, Georgia",997,394,730,256,267,300
1500000US132270502004,132270502004,"Block Group 4, Census Tract 502, Pickens County, Georgia",1751,424,1595,362,156,176
1500000US132270503001,132270503001,"Block Group 1, Census Tract 503, Pickens County, Georgia",1761,317,1728,297,33,56
1500000US132270503002,132270503002,"Block Group 2, Census Tract 503, Pickens County, Georgia",2516,409,2516,409,0,13
1500000US132270504001,132270504001,"Block Group 1, Census Tract 504, Pickens County, Georgia",1943,368,1909,352,34,58
1500000US132270504002,132270504002,"Block Group 2, Census Tract 504, Pickens County, Georgia",2014,414,2002,410,12,21
1500000US132270505001,132270505001,"Block Group 1, Census Tract 505, Pickens County, Georgia",1694,392,1569,343,125,159
1500000US132270505002,132270505002,"Block Group 2, Census Tract 505, Pickens County, Georgia",2686,397,2671,391,15,28
1500000US132270506001,132270506001,"Block Group 1, Census Tract 506, Pickens County, Georgia",1750,503,1750,503,0,13
1500000US132270506002,132270506002,"Block Group 2, Census Tract 506, Pickens County, Georgia",518,277,518,277,0,13
1500000US132270506003,132270506003,"Block Group 3, Census Tract 506, Pickens County, Georgia",1741,446,1741,446,0,13
1500000US132270506004,132270506004,"Block Group 4, Census Tract 506, Pickens County, Georgia",1732,501,1672,496,60,114
1500000US132299601001,132299601001,"Block Group 1, Census Tract 9601, Pierce County, Georgia",1349,236,1235,224,114,96
1500000US132299601002,132299601002,"Block Group 2, Census Tract 9601, Pierce County, Georgia",1283,244,1257,249,26,27
1500000US132299602001,132299602001,"Block Group 1, Census Tract 9602, Pierce County, Georgia",988,209,824,185,164,134
1500000US132299602002,132299602002,"Block Group 2, Census Tract 9602, Pierce County, Georgia",899,170,680,143,219,129
1500000US132299603001,132299603001,"Block Group 1, Census Tract 9603, Pierce County, Georgia",2194,383,2099,396,95,118
1500000US132299603002,132299603002,"Block Group 2, Census Tract 9603, Pierce County, Georgia",1424,396,1268,373,156,194
1500000US132299603003,132299603003,"Block Group 3, Census Tract 9603, Pierce County, Georgia",1512,376,1512,376,0,13
1500000US132299603004,132299603004,"Block Group 4, Census Tract 9603, Pierce County, Georgia",1492,368,1468,366,24,30
1500000US132299604001,132299604001,"Block Group 1, Census Tract 9604, Pierce County, Georgia",1696,407,1595,403,101,97
1500000US132299604002,132299604002,"Block Group 2, Census Tract 9604, Pierce County, Georgia",1581,363,1563,358,18,29
1500000US132299604003,132299604003,"Block Group 3, Census Tract 9604, Pierce County, Georgia",1383,354,1383,354,0,13
1500000US132299604004,132299604004,"Block Group 4, Census Tract 9604, Pierce County, Georgia",3133,530,3080,514,53,70
1500000US132310101001,132310101001,"Block Group 1, Census Tract 101, Pike County, Georgia",2486,447,2463,450,23,31
1500000US132310101002,132310101002,"Block Group 2, Census Tract 101, Pike County, Georgia",2290,390,2265,383,25,24
1500000US132310101003,132310101003,"Block Group 3, Census Tract 101, Pike County, Georgia",2157,441,2119,429,38,46
1500000US132310102001,132310102001,"Block Group 1, Census Tract 102, Pike County, Georgia",3516,293,3459,290,57,32
1500000US132310103001,132310103001,"Block Group 1, Census Tract 103, Pike County, Georgia",1531,294,1483,293,48,35
1500000US132310103002,132310103002,"Block Group 2, Census Tract 103, Pike County, Georgia",2594,284,2568,280,26,23
1500000US132310104001,132310104001,"Block Group 1, Census Tract 104, Pike County, Georgia",1386,341,1378,337,8,15
1500000US132310104002,132310104002,"Block Group 2, Census Tract 104, Pike County, Georgia",1852,279,1827,281,25,27
1500000US132330101001,132330101001,"Block Group 1, Census Tract 101, Polk County, Georgia",1342,393,1322,391,20,28
1500000US132330101002,132330101002,"Block Group 2, Census Tract 101, Polk County, Georgia",852,210,849,210,3,6
1500000US132330101003,132330101003,"Block Group 3, Census Tract 101, Polk County, Georgia",1510,411,1289,361,221,295
1500000US132330101004,132330101004,"Block Group 4, Census Tract 101, Polk County, Georgia",1265,314,1265,314,0,13
1500000US132330102001,132330102001,"Block Group 1, Census Tract 102, Polk County, Georgia",1679,404,1520,366,159,177
1500000US132330102002,132330102002,"Block Group 2, Census Tract 102, Polk County, Georgia",1810,408,1759,403,51,69
1500000US132330102003,132330102003,"Block Group 3, Census Tract 102, Polk County, Georgia",1887,613,1156,288,731,530
1500000US132330102004,132330102004,"Block Group 4, Census Tract 102, Polk County, Georgia",1415,423,1327,348,88,132
1500000US132330102005,132330102005,"Block Group 5, Census Tract 102, Polk County, Georgia",1126,516,721,201,405,537
1500000US132330103001,132330103001,"Block Group 1, Census Tract 103, Polk County, Georgia",1428,307,1289,297,139,175
1500000US132330103002,132330103002,"Block Group 2, Census Tract 103, Polk County, Georgia",1318,314,1201,277,117,117
1500000US132330103003,132330103003,"Block Group 3, Census Tract 103, Polk County, Georgia",2245,499,1050,256,1195,494
1500000US132330104001,132330104001,"Block Group 1, Census Tract 104, Polk County, Georgia",1341,356,1295,356,46,51
1500000US132330104002,132330104002,"Block Group 2, Census Tract 104, Polk County, Georgia",1101,381,1095,383,6,11
1500000US132330104003,132330104003,"Block Group 3, Census Tract 104, Polk County, Georgia",1351,553,877,488,474,303
1500000US132330104004,132330104004,"Block Group 4, Census Tract 104, Polk County, Georgia",1072,362,923,344,149,157
1500000US132330104005,132330104005,"Block Group 5, Census Tract 104, Polk County, Georgia",1355,547,934,360,421,334
1500000US132330105001,132330105001,"Block Group 1, Census Tract 105, Polk County, Georgia",1517,373,1507,368,10,23
1500000US132330105002,132330105002,"Block Group 2, Census Tract 105, Polk County, Georgia",1065,366,1006,339,59,62
1500000US132330105003,132330105003,"Block Group 3, Census Tract 105, Polk County, Georgia",539,310,210,150,329,249
1500000US132330105004,132330105004,"Block Group 4, Census Tract 105, Polk County, Georgia",1005,489,751,331,254,382
1500000US132330105005,132330105005,"Block Group 5, Census Tract 105, Polk County, Georgia",711,370,484,215,227,299
1500000US132330105006,132330105006,"Block Group 6, Census Tract 105, Polk County, Georgia",873,252,873,252,0,13
1500000US132330106001,132330106001,"Block Group 1, Census Tract 106, Polk County, Georgia",1194,496,1128,429,66,95
1500000US132330106002,132330106002,"Block Group 2, Census Tract 106, Polk County, Georgia",1988,484,1988,484,0,13
1500000US132330106003,132330106003,"Block Group 3, Census Tract 106, Polk County, Georgia",1455,451,1455,451,0,13
1500000US132330106004,132330106004,"Block Group 4, Census Tract 106, Polk County, Georgia",1279,277,1279,277,0,13
1500000US132330107001,132330107001,"Block Group 1, Census Tract 107, Polk County, Georgia",1585,417,1560,426,25,38
1500000US132330107002,132330107002,"Block Group 2, Census Tract 107, Polk County, Georgia",954,394,898,376,56,68
1500000US132330107003,132330107003,"Block Group 3, Census Tract 107, Polk County, Georgia",930,435,930,435,0,13
1500000US132330107004,132330107004,"Block Group 4, Census Tract 107, Polk County, Georgia",1053,374,1053,374,0,13
1500000US132330107005,132330107005,"Block Group 5, Census Tract 107, Polk County, Georgia",970,460,970,460,0,13
1500000US132359501001,132359501001,"Block Group 1, Census Tract 9501, Pulaski County, Georgia",2222,553,2049,542,173,156
1500000US132359501002,132359501002,"Block Group 2, Census Tract 9501, Pulaski County, Georgia",767,204,734,198,33,38
1500000US132359502001,132359502001,"Block Group 1, Census Tract 9502, Pulaski County, Georgia",1390,315,1390,315,0,13
1500000US132359502002,132359502002,"Block Group 2, Census Tract 9502, Pulaski County, Georgia",702,432,702,432,0,13
1500000US132359502003,132359502003,"Block Group 3, Census Tract 9502, Pulaski County, Georgia",941,373,941,373,0,13
1500000US132359502004,132359502004,"Block Group 4, Census Tract 9502, Pulaski County, Georgia",1016,376,1016,376,0,13
1500000US132359502005,132359502005,"Block Group 5, Census Tract 9502, Pulaski County, Georgia",1192,400,1192,400,0,13
1500000US132359502006,132359502006,"Block Group 6, Census Tract 9502, Pulaski County, Georgia",1906,500,1584,422,322,257
1500000US132359503001,132359503001,"Block Group 1, Census Tract 9503, Pulaski County, Georgia",1454,248,1441,250,13,16
1500000US132379601011,132379601011,"Block Group 1, Census Tract 9601.01, Putnam County, Georgia",1047,224,1047,224,0,13
1500000US132379601012,132379601012,"Block Group 2, Census Tract 9601.01, Putnam County, Georgia",764,362,647,340,117,123
1500000US132379601013,132379601013,"Block Group 3, Census Tract 9601.01, Putnam County, Georgia",1402,270,1402,270,0,13
1500000US132379601021,132379601021,"Block Group 1, Census Tract 9601.02, Putnam County, Georgia",2615,526,2526,507,89,121
1500000US132379601022,132379601022,"Block Group 2, Census Tract 9601.02, Putnam County, Georgia",2881,522,2417,450,464,393
1500000US132379602011,132379602011,"Block Group 1, Census Tract 9602.01, Putnam County, Georgia",1147,289,1003,208,144,234
1500000US132379602021,132379602021,"Block Group 1, Census Tract 9602.02, Putnam County, Georgia",942,421,739,417,203,302
1500000US132379602022,132379602022,"Block Group 2, Census Tract 9602.02, Putnam County, Georgia",2008,477,2006,477,2,5
1500000US132379602023,132379602023,"Block Group 3, Census Tract 9602.02, Putnam County, Georgia",910,368,910,368,0,13
1500000US132379602024,132379602024,"Block Group 4, Census Tract 9602.02, Putnam County, Georgia",1024,427,1024,427,0,13
1500000US132379602025,132379602025,"Block Group 5, Census Tract 9602.02, Putnam County, Georgia",1105,480,762,369,343,410
1500000US132379602026,132379602026,"Block Group 6, Census Tract 9602.02, Putnam County, Georgia",555,289,555,289,0,13
1500000US132379602027,132379602027,"Block Group 7, Census Tract 9602.02, Putnam County, Georgia",582,155,582,155,0,13
1500000US132379603001,132379603001,"Block Group 1, Census Tract 9603, Putnam County, Georgia",1355,375,1324,377,31,53
1500000US132379603002,132379603002,"Block Group 2, Census Tract 9603, Putnam County, Georgia",715,315,697,316,18,40
1500000US132379603003,132379603003,"Block Group 3, Census Tract 9603, Putnam County, Georgia",581,229,581,229,0,13
1500000US132379603004,132379603004,"Block Group 4, Census Tract 9603, Putnam County, Georgia",1614,461,1614,461,0,13
1500000US132399603001,132399603001,"Block Group 1, Census Tract 9603, Quitman County, Georgia",1181,207,1181,207,0,13
1500000US132399603002,132399603002,"Block Group 2, Census Tract 9603, Quitman County, Georgia",1145,191,1145,191,0,13
1500000US132419701001,132419701001,"Block Group 1, Census Tract 9701, Rabun County, Georgia",510,115,510,115,0,13
1500000US132419701002,132419701002,"Block Group 2, Census Tract 9701, Rabun County, Georgia",2209,324,1707,298,502,200
1500000US132419701003,132419701003,"Block Group 3, Census Tract 9701, Rabun County, Georgia",1648,359,1616,360,32,52
1500000US132419701004,132419701004,"Block Group 4, Census Tract 9701, Rabun County, Georgia",1369,284,1244,272,125,109
1500000US132419702011,132419702011,"Block Group 1, Census Tract 9702.01, Rabun County, Georgia",1866,315,1659,299,207,119
1500000US132419702012,132419702012,"Block Group 2, Census Tract 9702.01, Rabun County, Georgia",470,178,470,178,0,13
1500000US132419702013,132419702013,"Block Group 3, Census Tract 9702.01, Rabun County, Georgia",833,196,800,203,33,43
1500000US132419702021,132419702021,"Block Group 1, Census Tract 9702.02, Rabun County, Georgia",1158,233,1158,233,0,13
1500000US132419702022,132419702022,"Block Group 2, Census Tract 9702.02, Rabun County, Georgia",1335,294,1033,230,302,214
1500000US132419703011,132419703011,"Block Group 1, Census Tract 9703.01, Rabun County, Georgia",484,170,474,167,10,16
1500000US132419703012,132419703012,"Block Group 2, Census Tract 9703.01, Rabun County, Georgia",671,250,671,250,0,13
1500000US132419703013,132419703013,"Block Group 3, Census Tract 9703.01, Rabun County, Georgia",2018,323,1996,322,22,25
1500000US132419703021,132419703021,"Block Group 1, Census Tract 9703.02, Rabun County, Georgia",1695,299,1610,264,85,84
1500000US132437901001,132437901001,"Block Group 1, Census Tract 7901, Randolph County, Georgia",1162,260,1131,258,31,47
1500000US132437901002,132437901002,"Block Group 2, Census Tract 7901, Randolph County, Georgia",615,196,615,196,0,13
1500000US132437902001,132437902001,"Block Group 1, Census Tract 7902, Randolph County, Georgia",839,343,839,343,0,13
1500000US132437902002,132437902002,"Block Group 2, Census Tract 7902, Randolph County, Georgia",1207,459,1174,453,33,47
1500000US132437902003,132437902003,"Block Group 3, Census Tract 7902, Randolph County, Georgia",1115,379,1115,379,0,13
1500000US132437902004,132437902004,"Block Group 4, Census Tract 7902, Randolph County, Georgia",1885,452,1859,461,26,37
1500000US132437902005,132437902005,"Block Group 5, Census Tract 7902, Randolph County, Georgia",492,286,492,286,0,13
1500000US132450001001,132450001001,"Block Group 1, Census Tract 1, Richmond County, Georgia",709,232,709,232,0,13
1500000US132450001002,132450001002,"Block Group 2, Census Tract 1, Richmond County, Georgia",1337,302,1257,289,80,93
1500000US132450001003,132450001003,"Block Group 3, Census Tract 1, Richmond County, Georgia",687,157,677,159,10,16
1500000US132450001004,132450001004,"Block Group 4, Census Tract 1, Richmond County, Georgia",579,258,579,258,0,13
1500000US132450001005,132450001005,"Block Group 5, Census Tract 1, Richmond County, Georgia",616,232,593,226,23,37
1500000US132450002001,132450002001,"Block Group 1, Census Tract 2, Richmond County, Georgia",966,262,946,258,20,26
1500000US132450002002,132450002002,"Block Group 2, Census Tract 2, Richmond County, Georgia",619,236,619,236,0,13
1500000US132450002003,132450002003,"Block Group 3, Census Tract 2, Richmond County, Georgia",750,288,694,281,56,88
1500000US132450003001,132450003001,"Block Group 1, Census Tract 3, Richmond County, Georgia",383,126,383,126,0,13
1500000US132450003002,132450003002,"Block Group 2, Census Tract 3, Richmond County, Georgia",586,166,576,167,10,17
1500000US132450006001,132450006001,"Block Group 1, Census Tract 6, Richmond County, Georgia",645,186,623,191,22,24
1500000US132450006002,132450006002,"Block Group 2, Census Tract 6, Richmond County, Georgia",1308,319,1296,326,12,33
1500000US132450006003,132450006003,"Block Group 3, Census Tract 6, Richmond County, Georgia",557,213,557,213,0,13
1500000US132450007001,132450007001,"Block Group 1, Census Tract 7, Richmond County, Georgia",577,243,577,243,0,13
1500000US132450007002,132450007002,"Block Group 2, Census Tract 7, Richmond County, Georgia",438,134,429,135,9,14
1500000US132450009001,132450009001,"Block Group 1, Census Tract 9, Richmond County, Georgia",616,195,616,195,0,13
1500000US132450009002,132450009002,"Block Group 2, Census Tract 9, Richmond County, Georgia",126,64,122,63,4,7
1500000US132450009003,132450009003,"Block Group 3, Census Tract 9, Richmond County, Georgia",499,141,499,141,0,13
1500000US132450010001,132450010001,"Block Group 1, Census Tract 10, Richmond County, Georgia",645,391,573,318,72,93
1500000US132450010002,132450010002,"Block Group 2, Census Tract 10, Richmond County, Georgia",585,178,541,160,44,61
1500000US132450010003,132450010003,"Block Group 3, Census Tract 10, Richmond County, Georgia",779,206,779,206,0,13
1500000US132450010004,132450010004,"Block Group 4, Census Tract 10, Richmond County, Georgia",857,199,822,192,35,37
1500000US132450011001,132450011001,"Block Group 1, Census Tract 11, Richmond County, Georgia",1103,183,1077,178,26,26
1500000US132450011002,132450011002,"Block Group 2, Census Tract 11, Richmond County, Georgia",744,132,724,121,20,34
1500000US132450012001,132450012001,"Block Group 1, Census Tract 12, Richmond County, Georgia",395,240,395,240,0,13
1500000US132450012002,132450012002,"Block Group 2, Census Tract 12, Richmond County, Georgia",678,245,671,243,7,14
1500000US132450012003,132450012003,"Block Group 3, Census Tract 12, Richmond County, Georgia",852,310,852,310,0,13
1500000US132450012004,132450012004,"Block Group 4, Census Tract 12, Richmond County, Georgia",326,130,318,132,8,13
1500000US132450012005,132450012005,"Block Group 5, Census Tract 12, Richmond County, Georgia",1404,526,1404,526,0,13
1500000US132450012006,132450012006,"Block Group 6, Census Tract 12, Richmond County, Georgia",652,287,645,287,7,12
1500000US132450013001,132450013001,"Block Group 1, Census Tract 13, Richmond County, Georgia",798,178,798,178,0,13
1500000US132450013002,132450013002,"Block Group 2, Census Tract 13, Richmond County, Georgia",781,193,716,171,65,92
1500000US132450014001,132450014001,"Block Group 1, Census Tract 14, Richmond County, Georgia",428,156,413,152,15,25
1500000US132450014002,132450014002,"Block Group 2, Census Tract 14, Richmond County, Georgia",641,161,629,158,12,15
1500000US132450014003,132450014003,"Block Group 3, Census Tract 14, Richmond County, Georgia",801,286,791,286,10,15
1500000US132450015001,132450015001,"Block Group 1, Census Tract 15, Richmond County, Georgia",197,85,197,85,0,13
1500000US132450015002,132450015002,"Block Group 2, Census Tract 15, Richmond County, Georgia",580,167,580,167,0,13
1500000US132450016011,132450016011,"Block Group 1, Census Tract 16.01, Richmond County, Georgia",2016,603,2016,603,0,13
1500000US132450016012,132450016012,"Block Group 2, Census Tract 16.01, Richmond County, Georgia",1674,604,1674,604,0,13
1500000US132450016013,132450016013,"Block Group 3, Census Tract 16.01, Richmond County, Georgia",368,256,321,247,47,75
1500000US132450016021,132450016021,"Block Group 1, Census Tract 16.02, Richmond County, Georgia",1916,338,1853,337,63,101
1500000US132450016022,132450016022,"Block Group 2, Census Tract 16.02, Richmond County, Georgia",921,227,921,227,0,13
1500000US132450016023,132450016023,"Block Group 3, Census Tract 16.02, Richmond County, Georgia",1129,287,1121,287,8,12
1500000US132450101011,132450101011,"Block Group 1, Census Tract 101.01, Richmond County, Georgia",1835,281,1711,232,124,131
1500000US132450101012,132450101012,"Block Group 2, Census Tract 101.01, Richmond County, Georgia",1616,497,1354,299,262,338
1500000US132450101041,132450101041,"Block Group 1, Census Tract 101.04, Richmond County, Georgia",2013,629,1980,619,33,44
1500000US132450101042,132450101042,"Block Group 2, Census Tract 101.04, Richmond County, Georgia",887,300,860,300,27,44
1500000US132450101043,132450101043,"Block Group 3, Census Tract 101.04, Richmond County, Georgia",1077,389,1022,385,55,69
1500000US132450101051,132450101051,"Block Group 1, Census Tract 101.05, Richmond County, Georgia",887,288,840,300,47,83
1500000US132450101052,132450101052,"Block Group 2, Census Tract 101.05, Richmond County, Georgia",2227,499,2176,473,51,57
1500000US132450101053,132450101053,"Block Group 3, Census Tract 101.05, Richmond County, Georgia",1792,416,1689,408,103,102
1500000US132450101061,132450101061,"Block Group 1, Census Tract 101.06, Richmond County, Georgia",836,280,836,280,0,13
1500000US132450101062,132450101062,"Block Group 2, Census Tract 101.06, Richmond County, Georgia",2133,422,2049,434,84,109
1500000US132450101063,132450101063,"Block Group 3, Census Tract 101.06, Richmond County, Georgia",2051,619,2024,615,27,31
1500000US132450101071,132450101071,"Block Group 1, Census Tract 101.07, Richmond County, Georgia",1247,344,1157,327,90,84
1500000US132450101072,132450101072,"Block Group 2, Census Tract 101.07, Richmond County, Georgia",1215,387,1207,388,8,19
1500000US132450102011,132450102011,"Block Group 1, Census Tract 102.01, Richmond County, Georgia",1694,399,1656,398,38,57
1500000US132450102012,132450102012,"Block Group 2, Census Tract 102.01, Richmond County, Georgia",686,214,682,215,4,7
1500000US132450102013,132450102013,"Block Group 3, Census Tract 102.01, Richmond County, Georgia",2115,490,2094,489,21,30
1500000US132450102031,132450102031,"Block Group 1, Census Tract 102.03, Richmond County, Georgia",1371,344,1345,343,26,42
1500000US132450102032,132450102032,"Block Group 2, Census Tract 102.03, Richmond County, Georgia",1673,397,1673,397,0,13
1500000US132450102033,132450102033,"Block Group 3, Census Tract 102.03, Richmond County, Georgia",1113,243,1031,250,82,76
1500000US132450102041,132450102041,"Block Group 1, Census Tract 102.04, Richmond County, Georgia",6518,1335,6055,1290,463,405
1500000US132450102042,132450102042,"Block Group 2, Census Tract 102.04, Richmond County, Georgia",992,336,992,336,0,13
1500000US132450102043,132450102043,"Block Group 3, Census Tract 102.04, Richmond County, Georgia",3542,910,3228,871,314,215
1500000US132450102044,132450102044,"Block Group 4, Census Tract 102.04, Richmond County, Georgia",3229,522,2580,483,649,377
1500000US132450103001,132450103001,"Block Group 1, Census Tract 103, Richmond County, Georgia",1462,585,1344,548,118,183
1500000US132450103002,132450103002,"Block Group 2, Census Tract 103, Richmond County, Georgia",529,293,529,293,0,13
1500000US132450103003,132450103003,"Block Group 3, Census Tract 103, Richmond County, Georgia",2224,651,2188,651,36,57
1500000US132450103004,132450103004,"Block Group 4, Census Tract 103, Richmond County, Georgia",502,204,409,151,93,115
1500000US132450103005,132450103005,"Block Group 5, Census Tract 103, Richmond County, Georgia",638,395,498,334,140,212
1500000US132450104001,132450104001,"Block Group 1, Census Tract 104, Richmond County, Georgia",964,331,964,331,0,13
1500000US132450104002,132450104002,"Block Group 2, Census Tract 104, Richmond County, Georgia",863,390,833,382,30,39
1500000US132450104003,132450104003,"Block Group 3, Census Tract 104, Richmond County, Georgia",732,266,732,266,0,13
1500000US132450104004,132450104004,"Block Group 4, Census Tract 104, Richmond County, Georgia",712,204,687,197,25,32
1500000US132450104005,132450104005,"Block Group 5, Census Tract 104, Richmond County, Georgia",1037,435,987,436,50,63
1500000US132450105041,132450105041,"Block Group 1, Census Tract 105.04, Richmond County, Georgia",2156,529,2129,538,27,40
1500000US132450105042,132450105042,"Block Group 2, Census Tract 105.04, Richmond County, Georgia",2789,802,2560,744,229,291
1500000US132450105043,132450105043,"Block Group 3, Census Tract 105.04, Richmond County, Georgia",810,361,810,361,0,13
1500000US132450105044,132450105044,"Block Group 4, Census Tract 105.04, Richmond County, Georgia",1424,506,1398,504,26,36
1500000US132450105061,132450105061,"Block Group 1, Census Tract 105.06, Richmond County, Georgia",1748,479,1748,479,0,13
1500000US132450105062,132450105062,"Block Group 2, Census Tract 105.06, Richmond County, Georgia",1199,354,1154,350,45,56
1500000US132450105063,132450105063,"Block Group 3, Census Tract 105.06, Richmond County, Georgia",1971,434,1844,445,127,116
1500000US132450105071,132450105071,"Block Group 1, Census Tract 105.07, Richmond County, Georgia",1422,586,1422,586,0,13
1500000US132450105072,132450105072,"Block Group 2, Census Tract 105.07, Richmond County, Georgia",959,381,915,368,44,54
1500000US132450105073,132450105073,"Block Group 3, Census Tract 105.07, Richmond County, Georgia",2899,683,2841,685,58,64
1500000US132450105074,132450105074,"Block Group 4, Census Tract 105.07, Richmond County, Georgia",394,219,369,205,25,44
1500000US132450105081,132450105081,"Block Group 1, Census Tract 105.08, Richmond County, Georgia",3036,674,2942,681,94,112
1500000US132450105082,132450105082,"Block Group 2, Census Tract 105.08, Richmond County, Georgia",1264,393,1235,403,29,47
1500000US132450105091,132450105091,"Block Group 1, Census Tract 105.09, Richmond County, Georgia",1144,201,1133,209,11,18
1500000US132450105092,132450105092,"Block Group 2, Census Tract 105.09, Richmond County, Georgia",2939,485,2893,477,46,48
1500000US132450105101,132450105101,"Block Group 1, Census Tract 105.10, Richmond County, Georgia",1063,355,1056,356,7,13
1500000US132450105102,132450105102,"Block Group 2, Census Tract 105.10, Richmond County, Georgia",357,128,343,129,14,23
1500000US132450105103,132450105103,"Block Group 3, Census Tract 105.10, Richmond County, Georgia",2213,399,2198,399,15,23
1500000US132450105104,132450105104,"Block Group 4, Census Tract 105.10, Richmond County, Georgia",1311,409,1311,409,0,13
1500000US132450105111,132450105111,"Block Group 1, Census Tract 105.11, Richmond County, Georgia",3021,489,2954,490,67,43
1500000US132450105112,132450105112,"Block Group 2, Census Tract 105.11, Richmond County, Georgia",1451,278,1431,277,20,23
1500000US132450105121,132450105121,"Block Group 1, Census Tract 105.12, Richmond County, Georgia",1417,462,1417,462,0,13
1500000US132450105122,132450105122,"Block Group 2, Census Tract 105.12, Richmond County, Georgia",1540,467,1532,468,8,14
1500000US132450105123,132450105123,"Block Group 3, Census Tract 105.12, Richmond County, Georgia",1568,435,1468,438,100,109
1500000US132450105131,132450105131,"Block Group 1, Census Tract 105.13, Richmond County, Georgia",1999,378,1984,372,15,26
1500000US132450105132,132450105132,"Block Group 2, Census Tract 105.13, Richmond County, Georgia",1097,441,1038,451,59,74
1500000US132450106001,132450106001,"Block Group 1, Census Tract 106, Richmond County, Georgia",859,272,823,274,36,34
1500000US132450106002,132450106002,"Block Group 2, Census Tract 106, Richmond County, Georgia",841,286,788,251,53,64
1500000US132450106003,132450106003,"Block Group 3, Census Tract 106, Richmond County, Georgia",1813,343,1796,341,17,21
1500000US132450106004,132450106004,"Block Group 4, Census Tract 106, Richmond County, Georgia",848,314,848,314,0,13
1500000US132450107061,132450107061,"Block Group 1, Census Tract 107.06, Richmond County, Georgia",1828,369,1816,370,12,20
1500000US132450107062,132450107062,"Block Group 2, Census Tract 107.06, Richmond County, Georgia",2105,658,1855,670,250,166
1500000US132450107063,132450107063,"Block Group 3, Census Tract 107.06, Richmond County, Georgia",1305,349,1296,351,9,17
1500000US132450107071,132450107071,"Block Group 1, Census Tract 107.07, Richmond County, Georgia",2436,461,2339,396,97,149
1500000US132450107072,132450107072,"Block Group 2, Census Tract 107.07, Richmond County, Georgia",470,168,470,168,0,13
1500000US132450107081,132450107081,"Block Group 1, Census Tract 107.08, Richmond County, Georgia",2038,574,1675,559,363,279
1500000US132450107082,132450107082,"Block Group 2, Census Tract 107.08, Richmond County, Georgia",1492,447,1443,445,49,61
1500000US132450107083,132450107083,"Block Group 3, Census Tract 107.08, Richmond County, Georgia",2155,671,1982,678,173,111
1500000US132450107091,132450107091,"Block Group 1, Census Tract 107.09, Richmond County, Georgia",3390,707,3311,708,79,80
1500000US132450107092,132450107092,"Block Group 2, Census Tract 107.09, Richmond County, Georgia",2693,527,2608,527,85,70
1500000US132450107101,132450107101,"Block Group 1, Census Tract 107.10, Richmond County, Georgia",1623,425,1571,418,52,73
1500000US132450107102,132450107102,"Block Group 2, Census Tract 107.10, Richmond County, Georgia",1321,486,1289,489,32,59
1500000US132450107103,132450107103,"Block Group 3, Census Tract 107.10, Richmond County, Georgia",3101,825,3049,809,52,64
1500000US132450107111,132450107111,"Block Group 1, Census Tract 107.11, Richmond County, Georgia",1253,376,1152,336,101,111
1500000US132450107112,132450107112,"Block Group 2, Census Tract 107.11, Richmond County, Georgia",1660,441,1600,447,60,68
1500000US132450107121,132450107121,"Block Group 1, Census Tract 107.12, Richmond County, Georgia",2286,618,2216,584,70,122
1500000US132450107122,132450107122,"Block Group 2, Census Tract 107.12, Richmond County, Georgia",3407,649,3330,656,77,81
1500000US132450107123,132450107123,"Block Group 3, Census Tract 107.12, Richmond County, Georgia",3036,676,2924,673,112,101
1500000US132450108001,132450108001,"Block Group 1, Census Tract 108, Richmond County, Georgia",1075,234,904,209,171,75
1500000US132450108002,132450108002,"Block Group 2, Census Tract 108, Richmond County, Georgia",3123,377,2554,392,569,258
1500000US132450108003,132450108003,"Block Group 3, Census Tract 108, Richmond County, Georgia",2563,399,2151,340,412,114
1500000US132450108004,132450108004,"Block Group 4, Census Tract 108, Richmond County, Georgia",1311,351,1089,320,222,136
1500000US132450109031,132450109031,"Block Group 1, Census Tract 109.03, Richmond County, Georgia",2244,425,2124,404,120,89
1500000US132450109032,132450109032,"Block Group 2, Census Tract 109.03, Richmond County, Georgia",2972,353,2774,350,198,134
1500000US132450109041,132450109041,"Block Group 1, Census Tract 109.04, Richmond County, Georgia",884,254,884,254,0,13
1500000US132450109042,132450109042,"Block Group 2, Census Tract 109.04, Richmond County, Georgia",2542,404,2517,402,25,36
1500000US132450109051,132450109051,"Block Group 1, Census Tract 109.05, Richmond County, Georgia",1172,313,1172,313,0,13
1500000US132450109052,132450109052,"Block Group 2, Census Tract 109.05, Richmond County, Georgia",2102,541,2073,537,29,30
1500000US132450109053,132450109053,"Block Group 3, Census Tract 109.05, Richmond County, Georgia",1845,647,1828,647,17,26
1500000US132450109061,132450109061,"Block Group 1, Census Tract 109.06, Richmond County, Georgia",863,307,863,307,0,13
1500000US132450109062,132450109062,"Block Group 2, Census Tract 109.06, Richmond County, Georgia",3056,758,2315,696,741,413
1500000US132450109063,132450109063,"Block Group 3, Census Tract 109.06, Richmond County, Georgia",3274,553,3242,559,32,43
1500000US132450110001,132450110001,"Block Group 1, Census Tract 110, Richmond County, Georgia",528,147,485,130,43,39
1500000US132450110002,132450110002,"Block Group 2, Census Tract 110, Richmond County, Georgia",906,169,868,165,38,29
1500000US132470601011,132470601011,"Block Group 1, Census Tract 601.01, Rockdale County, Georgia",833,224,822,225,11,19
1500000US132470601012,132470601012,"Block Group 2, Census Tract 601.01, Rockdale County, Georgia",1016,397,955,395,61,80
1500000US132470601013,132470601013,"Block Group 3, Census Tract 601.01, Rockdale County, Georgia",1424,321,1227,316,197,193
1500000US132470601021,132470601021,"Block Group 1, Census Tract 601.02, Rockdale County, Georgia",1122,361,1122,361,0,13
1500000US132470601022,132470601022,"Block Group 2, Census Tract 601.02, Rockdale County, Georgia",852,320,852,320,0,13
1500000US132470601023,132470601023,"Block Group 3, Census Tract 601.02, Rockdale County, Georgia",3281,598,3058,587,223,181
1500000US132470602011,132470602011,"Block Group 1, Census Tract 602.01, Rockdale County, Georgia",2819,501,348,193,2471,481
1500000US132470602012,132470602012,"Block Group 2, Census Tract 602.01, Rockdale County, Georgia",1646,380,1646,380,0,13
1500000US132470602013,132470602013,"Block Group 3, Census Tract 602.01, Rockdale County, Georgia",635,180,635,180,0,13
1500000US132470602021,132470602021,"Block Group 1, Census Tract 602.02, Rockdale County, Georgia",2471,610,2395,602,76,95
1500000US132470602022,132470602022,"Block Group 2, Census Tract 602.02, Rockdale County, Georgia",2444,607,2263,655,181,158
1500000US132470602023,132470602023,"Block Group 3, Census Tract 602.02, Rockdale County, Georgia",1916,465,1905,467,11,18
1500000US132470602024,132470602024,"Block Group 4, Census Tract 602.02, Rockdale County, Georgia",3016,538,2952,537,64,62
1500000US132470603041,132470603041,"Block Group 1, Census Tract 603.04, Rockdale County, Georgia",638,351,541,317,97,154
1500000US132470603042,132470603042,"Block Group 2, Census Tract 603.04, Rockdale County, Georgia",1318,369,1295,367,23,27
1500000US132470603043,132470603043,"Block Group 3, Census Tract 603.04, Rockdale County, Georgia",1915,551,1780,544,135,120
1500000US132470603044,132470603044,"Block Group 4, Census Tract 603.04, Rockdale County, Georgia",1330,674,1247,654,83,96
1500000US132470603051,132470603051,"Block Group 1, Census Tract 603.05, Rockdale County, Georgia",1035,334,736,257,299,235
1500000US132470603052,132470603052,"Block Group 2, Census Tract 603.05, Rockdale County, Georgia",1941,478,1366,319,575,331
1500000US132470603053,132470603053,"Block Group 3, Census Tract 603.05, Rockdale County, Georgia",2358,448,2034,433,324,177
1500000US132470603061,132470603061,"Block Group 1, Census Tract 603.06, Rockdale County, Georgia",3097,373,3069,371,28,23
1500000US132470603071,132470603071,"Block Group 1, Census Tract 603.07, Rockdale County, Georgia",2477,710,2244,702,233,173
1500000US132470603072,132470603072,"Block Group 2, Census Tract 603.07, Rockdale County, Georgia",2329,487,2252,484,77,120
1500000US132470603073,132470603073,"Block Group 3, Census Tract 603.07, Rockdale County, Georgia",4276,816,4060,810,216,198
1500000US132470603074,132470603074,"Block Group 4, Census Tract 603.07, Rockdale County, Georgia",1301,382,1301,382,0,13
1500000US132470603081,132470603081,"Block Group 1, Census Tract 603.08, Rockdale County, Georgia",3842,851,3685,873,157,116
1500000US132470603082,132470603082,"Block Group 2, Census Tract 603.08, Rockdale County, Georgia",2006,485,1804,471,202,227
1500000US132470603083,132470603083,"Block Group 3, Census Tract 603.08, Rockdale County, Georgia",2666,678,1654,569,1012,597
1500000US132470603091,132470603091,"Block Group 1, Census Tract 603.09, Rockdale County, Georgia",1067,226,893,212,174,152
1500000US132470603092,132470603092,"Block Group 2, Census Tract 603.09, Rockdale County, Georgia",1827,461,1742,443,85,134
1500000US132470603093,132470603093,"Block Group 3, Census Tract 603.09, Rockdale County, Georgia",2403,521,2241,477,162,157
1500000US132470604031,132470604031,"Block Group 1, Census Tract 604.03, Rockdale County, Georgia",1911,343,1864,349,47,44
1500000US132470604032,132470604032,"Block Group 2, Census Tract 604.03, Rockdale County, Georgia",561,185,561,185,0,13
1500000US132470604033,132470604033,"Block Group 3, Census Tract 604.03, Rockdale County, Georgia",1030,231,951,240,79,92
1500000US132470604041,132470604041,"Block Group 1, Census Tract 604.04, Rockdale County, Georgia",2696,576,2455,643,241,210
1500000US132470604042,132470604042,"Block Group 2, Census Tract 604.04, Rockdale County, Georgia",1386,406,1277,404,109,110
1500000US132470604043,132470604043,"Block Group 3, Census Tract 604.04, Rockdale County, Georgia",1923,372,1923,372,0,13
1500000US132470604051,132470604051,"Block Group 1, Census Tract 604.05, Rockdale County, Georgia",2850,530,2785,525,65,68
1500000US132470604052,132470604052,"Block Group 2, Census Tract 604.05, Rockdale County, Georgia",2995,812,2781,784,214,226
1500000US132470604053,132470604053,"Block Group 3, Census Tract 604.05, Rockdale County, Georgia",1369,463,1369,463,0,13
1500000US132470604061,132470604061,"Block Group 1, Census Tract 604.06, Rockdale County, Georgia",1139,377,1058,369,81,81
1500000US132470604062,132470604062,"Block Group 2, Census Tract 604.06, Rockdale County, Georgia",2772,398,2384,323,388,248
1500000US132470604063,132470604063,"Block Group 3, Census Tract 604.06, Rockdale County, Georgia",1752,449,1740,452,12,19
1500000US132470604071,132470604071,"Block Group 1, Census Tract 604.07, Rockdale County, Georgia",1281,247,1203,257,78,73
1500000US132470604072,132470604072,"Block Group 2, Census Tract 604.07, Rockdale County, Georgia",1177,303,1081,301,96,82
1500000US132470604073,132470604073,"Block Group 3, Census Tract 604.07, Rockdale County, Georgia",758,212,728,202,30,48
1500000US132499601001,132499601001,"Block Group 1, Census Tract 9601, Schley County, Georgia",1280,201,1236,205,44,42
1500000US132499601002,132499601002,"Block Group 2, Census Tract 9601, Schley County, Georgia",1690,247,1554,264,136,148
1500000US132499602001,132499602001,"Block Group 1, Census Tract 9602, Schley County, Georgia",2104,160,2058,156,46,65
1500000US132519702001,132519702001,"Block Group 1, Census Tract 9702, Screven County, Georgia",1146,195,1142,195,4,6
1500000US132519702002,132519702002,"Block Group 2, Census Tract 9702, Screven County, Georgia",789,236,789,236,0,13
1500000US132519703001,132519703001,"Block Group 1, Census Tract 9703, Screven County, Georgia",964,217,913,205,51,65
1500000US132519703002,132519703002,"Block Group 2, Census Tract 9703, Screven County, Georgia",1124,366,1124,366,0,13
1500000US132519703003,132519703003,"Block Group 3, Census Tract 9703, Screven County, Georgia",847,270,845,269,2,5
1500000US132519703004,132519703004,"Block Group 4, Census Tract 9703, Screven County, Georgia",373,130,373,130,0,13
1500000US132519704001,132519704001,"Block Group 1, Census Tract 9704, Screven County, Georgia",993,238,980,238,13,23
1500000US132519704002,132519704002,"Block Group 2, Census Tract 9704, Screven County, Georgia",1556,396,1499,388,57,66
1500000US132519704003,132519704003,"Block Group 3, Census Tract 9704, Screven County, Georgia",888,238,888,238,0,13
1500000US132519704004,132519704004,"Block Group 4, Census Tract 9704, Screven County, Georgia",1103,224,1030,209,73,67
1500000US132519705001,132519705001,"Block Group 1, Census Tract 9705, Screven County, Georgia",1702,262,1699,262,3,6
1500000US132519705002,132519705002,"Block Group 2, Census Tract 9705, Screven County, Georgia",995,250,987,249,8,14
1500000US132519706001,132519706001,"Block Group 1, Census Tract 9706, Screven County, Georgia",1044,294,1042,294,2,2
1500000US132519706002,132519706002,"Block Group 2, Census Tract 9706, Screven County, Georgia",682,125,664,117,18,28
1500000US132532001001,132532001001,"Block Group 1, Census Tract 2001, Seminole County, Georgia",831,266,780,240,51,87
1500000US132532001002,132532001002,"Block Group 2, Census Tract 2001, Seminole County, Georgia",835,179,769,177,66,85
1500000US132532001003,132532001003,"Block Group 3, Census Tract 2001, Seminole County, Georgia",837,235,811,231,26,35
1500000US132532002001,132532002001,"Block Group 1, Census Tract 2002, Seminole County, Georgia",1871,313,1840,317,31,179
1500000US132532002002,132532002002,"Block Group 2, Census Tract 2002, Seminole County, Georgia",965,284,950,283,15,35
1500000US132532002003,132532002003,"Block Group 3, Census Tract 2002, Seminole County, Georgia",907,251,901,248,6,15
1500000US132532003001,132532003001,"Block Group 1, Census Tract 2003, Seminole County, Georgia",1023,241,966,230,57,87
1500000US132532003002,132532003002,"Block Group 2, Census Tract 2003, Seminole County, Georgia",390,157,390,157,0,13
1500000US132532003003,132532003003,"Block Group 3, Census Tract 2003, Seminole County, Georgia",1110,233,1110,233,0,13
1500000US132551601001,132551601001,"Block Group 1, Census Tract 1601, Spalding County, Georgia",3022,456,3021,456,1,3
1500000US132551601002,132551601002,"Block Group 2, Census Tract 1601, Spalding County, Georgia",956,332,848,281,108,143
1500000US132551601003,132551601003,"Block Group 3, Census Tract 1601, Spalding County, Georgia",1810,644,1269,413,541,555
1500000US132551602001,132551602001,"Block Group 1, Census Tract 1602, Spalding County, Georgia",1567,597,1457,556,110,136
1500000US132551602002,132551602002,"Block Group 2, Census Tract 1602, Spalding County, Georgia",1660,389,1660,389,0,13
1500000US132551602003,132551602003,"Block Group 3, Census Tract 1602, Spalding County, Georgia",3051,525,2899,498,152,168
1500000US132551603001,132551603001,"Block Group 1, Census Tract 1603, Spalding County, Georgia",1488,358,1325,306,163,196
1500000US132551603002,132551603002,"Block Group 2, Census Tract 1603, Spalding County, Georgia",1730,375,1730,375,0,13
1500000US132551604001,132551604001,"Block Group 1, Census Tract 1604, Spalding County, Georgia",1927,568,1927,568,0,13
1500000US132551604002,132551604002,"Block Group 2, Census Tract 1604, Spalding County, Georgia",1246,549,1225,547,21,35
1500000US132551604003,132551604003,"Block Group 3, Census Tract 1604, Spalding County, Georgia",914,443,914,443,0,13
1500000US132551604004,132551604004,"Block Group 4, Census Tract 1604, Spalding County, Georgia",327,312,119,109,208,303
1500000US132551604005,132551604005,"Block Group 5, Census Tract 1604, Spalding County, Georgia",1079,380,1079,380,0,13
1500000US132551605001,132551605001,"Block Group 1, Census Tract 1605, Spalding County, Georgia",3637,725,3579,729,58,73
1500000US132551605002,132551605002,"Block Group 2, Census Tract 1605, Spalding County, Georgia",2835,735,2651,702,184,201
1500000US132551606001,132551606001,"Block Group 1, Census Tract 1606, Spalding County, Georgia",1480,356,1439,349,41,50
1500000US132551606002,132551606002,"Block Group 2, Census Tract 1606, Spalding County, Georgia",2416,319,2388,315,28,42
1500000US132551607001,132551607001,"Block Group 1, Census Tract 1607, Spalding County, Georgia",2428,782,2428,782,0,13
1500000US132551607002,132551607002,"Block Group 2, Census Tract 1607, Spalding County, Georgia",1677,548,1639,538,38,60
1500000US132551607003,132551607003,"Block Group 3, Census Tract 1607, Spalding County, Georgia",3306,705,3177,696,129,135
1500000US132551608001,132551608001,"Block Group 1, Census Tract 1608, Spalding County, Georgia",1559,517,1459,448,100,137
1500000US132551608002,132551608002,"Block Group 2, Census Tract 1608, Spalding County, Georgia",1385,538,1065,444,320,297
1500000US132551608003,132551608003,"Block Group 3, Census Tract 1608, Spalding County, Georgia",1929,537,1884,525,45,78
1500000US132551609001,132551609001,"Block Group 1, Census Tract 1609, Spalding County, Georgia",725,185,725,185,0,13
1500000US132551609002,132551609002,"Block Group 2, Census Tract 1609, Spalding County, Georgia",1230,235,1230,235,0,13
1500000US132551609003,132551609003,"Block Group 3, Census Tract 1609, Spalding County, Georgia",746,228,672,215,74,96
1500000US132551610001,132551610001,"Block Group 1, Census Tract 1610, Spalding County, Georgia",1002,364,1002,364,0,13
1500000US132551610002,132551610002,"Block Group 2, Census Tract 1610, Spalding County, Georgia",1323,298,1292,303,31,35
1500000US132551610003,132551610003,"Block Group 3, Census Tract 1610, Spalding County, Georgia",2831,464,2774,452,57,97
1500000US132551611001,132551611001,"Block Group 1, Census Tract 1611, Spalding County, Georgia",1173,238,1063,218,110,94
1500000US132551611002,132551611002,"Block Group 2, Census Tract 1611, Spalding County, Georgia",2756,389,2684,392,72,89
1500000US132551612001,132551612001,"Block Group 1, Census Tract 1612, Spalding County, Georgia",2568,450,2451,430,117,183
1500000US132551612002,132551612002,"Block Group 2, Census Tract 1612, Spalding County, Georgia",617,354,617,354,0,13
1500000US132551612003,132551612003,"Block Group 3, Census Tract 1612, Spalding County, Georgia",1170,466,1170,466,0,13
1500000US132551612004,132551612004,"Block Group 4, Census Tract 1612, Spalding County, Georgia",4303,619,4303,619,0,13
1500000US132579701001,132579701001,"Block Group 1, Census Tract 9701, Stephens County, Georgia",1336,399,1336,399,0,13
1500000US132579701002,132579701002,"Block Group 2, Census Tract 9701, Stephens County, Georgia",1547,346,1480,323,67,82
1500000US132579701003,132579701003,"Block Group 3, Census Tract 9701, Stephens County, Georgia",930,480,906,490,24,27
1500000US132579701004,132579701004,"Block Group 4, Census Tract 9701, Stephens County, Georgia",1364,416,1364,416,0,13
1500000US132579701005,132579701005,"Block Group 5, Census Tract 9701, Stephens County, Georgia",1564,377,1491,384,73,91
1500000US132579702001,132579702001,"Block Group 1, Census Tract 9702, Stephens County, Georgia",2406,590,2287,563,119,156
1500000US132579702002,132579702002,"Block Group 2, Census Tract 9702, Stephens County, Georgia",1945,466,1945,466,0,13
1500000US132579702003,132579702003,"Block Group 3, Census Tract 9702, Stephens County, Georgia",1794,536,1736,517,58,103
1500000US132579703011,132579703011,"Block Group 1, Census Tract 9703.01, Stephens County, Georgia",348,166,348,166,0,13
1500000US132579703012,132579703012,"Block Group 2, Census Tract 9703.01, Stephens County, Georgia",1015,320,788,251,227,271
1500000US132579703013,132579703013,"Block Group 3, Census Tract 9703.01, Stephens County, Georgia",555,228,555,228,0,13
1500000US132579703014,132579703014,"Block Group 4, Census Tract 9703.01, Stephens County, Georgia",1093,326,1001,301,92,127
1500000US132579703021,132579703021,"Block Group 1, Census Tract 9703.02, Stephens County, Georgia",1212,386,1167,377,45,80
1500000US132579703022,132579703022,"Block Group 2, Census Tract 9703.02, Stephens County, Georgia",1517,453,1517,453,0,13
1500000US132579704001,132579704001,"Block Group 1, Census Tract 9704, Stephens County, Georgia",1879,405,1840,406,39,57
1500000US132579704002,132579704002,"Block Group 2, Census Tract 9704, Stephens County, Georgia",1505,434,1505,434,0,13
1500000US132579704003,132579704003,"Block Group 3, Census Tract 9704, Stephens County, Georgia",1962,458,1962,458,0,13
1500000US132579704004,132579704004,"Block Group 4, Census Tract 9704, Stephens County, Georgia",1648,462,1648,462,0,13
1500000US132599501001,132599501001,"Block Group 1, Census Tract 9501, Stewart County, Georgia",1310,239,1294,239,16,14
1500000US132599501002,132599501002,"Block Group 2, Census Tract 9501, Stewart County, Georgia",791,169,791,169,0,13
1500000US132599504001,132599504001,"Block Group 1, Census Tract 9504, Stewart County, Georgia",597,212,591,212,6,9
1500000US132599504002,132599504002,"Block Group 2, Census Tract 9504, Stewart County, Georgia",2446,259,1191,208,1255,186
1500000US132599504003,132599504003,"Block Group 3, Census Tract 9504, Stewart County, Georgia",724,178,724,178,0,13
1500000US132619501001,132619501001,"Block Group 1, Census Tract 9501, Sumter County, Georgia",1245,184,1219,185,26,34
1500000US132619502001,132619502001,"Block Group 1, Census Tract 9502, Sumter County, Georgia",1678,507,1528,512,150,170
1500000US132619502002,132619502002,"Block Group 2, Census Tract 9502, Sumter County, Georgia",1015,549,1007,549,8,15
1500000US132619502003,132619502003,"Block Group 3, Census Tract 9502, Sumter County, Georgia",1343,449,1343,449,0,13
1500000US132619502004,132619502004,"Block Group 4, Census Tract 9502, Sumter County, Georgia",1059,344,1059,344,0,13
1500000US132619503001,132619503001,"Block Group 1, Census Tract 9503, Sumter County, Georgia",1801,506,1787,505,14,23
1500000US132619503002,132619503002,"Block Group 2, Census Tract 9503, Sumter County, Georgia",1269,310,1246,302,23,37
1500000US132619503003,132619503003,"Block Group 3, Census Tract 9503, Sumter County, Georgia",533,286,533,286,0,13
1500000US132619503004,132619503004,"Block Group 4, Census Tract 9503, Sumter County, Georgia",1100,484,1100,484,0,13
1500000US132619503005,132619503005,"Block Group 5, Census Tract 9503, Sumter County, Georgia",2520,555,2500,554,20,22
1500000US132619504001,132619504001,"Block Group 1, Census Tract 9504, Sumter County, Georgia",853,233,843,232,10,16
1500000US132619504002,132619504002,"Block Group 2, Census Tract 9504, Sumter County, Georgia",968,222,895,198,73,86
1500000US132619504003,132619504003,"Block Group 3, Census Tract 9504, Sumter County, Georgia",899,257,899,257,0,13
1500000US132619505001,132619505001,"Block Group 1, Census Tract 9505, Sumter County, Georgia",979,237,970,237,9,13
1500000US132619505002,132619505002,"Block Group 2, Census Tract 9505, Sumter County, Georgia",1092,282,986,214,106,140
1500000US132619505003,132619505003,"Block Group 3, Census Tract 9505, Sumter County, Georgia",1357,392,1194,369,163,131
1500000US132619506001,132619506001,"Block Group 1, Census Tract 9506, Sumter County, Georgia",514,171,514,171,0,13
1500000US132619506002,132619506002,"Block Group 2, Census Tract 9506, Sumter County, Georgia",796,202,784,201,12,14
1500000US132619506003,132619506003,"Block Group 3, Census Tract 9506, Sumter County, Georgia",832,247,743,238,89,81
1500000US132619507001,132619507001,"Block Group 1, Census Tract 9507, Sumter County, Georgia",1770,524,1649,491,121,173
1500000US132619507002,132619507002,"Block Group 2, Census Tract 9507, Sumter County, Georgia",1783,515,1471,481,312,199
1500000US132619507003,132619507003,"Block Group 3, Census Tract 9507, Sumter County, Georgia",1498,353,1186,312,312,239
1500000US132619507004,132619507004,"Block Group 4, Census Tract 9507, Sumter County, Georgia",1698,319,1680,317,18,17
1500000US132619508001,132619508001,"Block Group 1, Census Tract 9508, Sumter County, Georgia",927,318,853,285,74,66
1500000US132619508002,132619508002,"Block Group 2, Census Tract 9508, Sumter County, Georgia",931,178,859,182,72,69
1500000US132619508003,132619508003,"Block Group 3, Census Tract 9508, Sumter County, Georgia",969,333,930,334,39,34
1500000US132639601001,132639601001,"Block Group 1, Census Tract 9601, Talbot County, Georgia",774,248,774,248,0,13
1500000US132639601002,132639601002,"Block Group 2, Census Tract 9601, Talbot County, Georgia",1665,242,1665,242,0,13
1500000US132639602001,132639602001,"Block Group 1, Census Tract 9602, Talbot County, Georgia",961,172,954,172,7,16
1500000US132639602002,132639602002,"Block Group 2, Census Tract 9602, Talbot County, Georgia",1429,210,1360,199,69,56
1500000US132639603001,132639603001,"Block Group 1, Census Tract 9603, Talbot County, Georgia",514,113,514,113,0,13
1500000US132639603002,132639603002,"Block Group 2, Census Tract 9603, Talbot County, Georgia",1147,163,1097,165,50,54
1500000US132650102001,132650102001,"Block Group 1, Census Tract 102, Taliaferro County, Georgia",672,108,670,108,2,3
1500000US132650102002,132650102002,"Block Group 2, Census Tract 102, Taliaferro County, Georgia",616,136,584,124,32,40
1500000US132650102003,132650102003,"Block Group 3, Census Tract 102, Taliaferro County, Georgia",433,105,429,101,4,7
1500000US132679501001,132679501001,"Block Group 1, Census Tract 9501, Tattnall County, Georgia",1012,279,843,221,169,176
1500000US132679501002,132679501002,"Block Group 2, Census Tract 9501, Tattnall County, Georgia",549,166,549,166,0,13
1500000US132679501003,132679501003,"Block Group 3, Census Tract 9501, Tattnall County, Georgia",988,324,967,318,21,31
1500000US132679501004,132679501004,"Block Group 4, Census Tract 9501, Tattnall County, Georgia",908,286,860,285,48,53
1500000US132679502011,132679502011,"Block Group 1, Census Tract 9502.01, Tattnall County, Georgia",1814,349,1779,345,35,47
1500000US132679502012,132679502012,"Block Group 2, Census Tract 9502.01, Tattnall County, Georgia",2741,193,2595,248,146,131
1500000US132679502021,132679502021,"Block Group 1, Census Tract 9502.02, Tattnall County, Georgia",4273,277,4024,281,249,68
1500000US132679502022,132679502022,"Block Group 2, Census Tract 9502.02, Tattnall County, Georgia",3220,360,1684,343,1536,245
1500000US132679503001,132679503001,"Block Group 1, Census Tract 9503, Tattnall County, Georgia",3108,382,2851,313,257,183
1500000US132679503002,132679503002,"Block Group 2, Census Tract 9503, Tattnall County, Georgia",1122,315,1016,295,106,152
1500000US132679503003,132679503003,"Block Group 3, Census Tract 9503, Tattnall County, Georgia",1272,285,1193,285,79,82
1500000US132679503004,132679503004,"Block Group 4, Census Tract 9503, Tattnall County, Georgia",408,156,408,156,0,13
1500000US132679504001,132679504001,"Block Group 1, Census Tract 9504, Tattnall County, Georgia",816,266,816,266,0,13
1500000US132679504002,132679504002,"Block Group 2, Census Tract 9504, Tattnall County, Georgia",716,261,716,261,0,13
1500000US132679504003,132679504003,"Block Group 3, Census Tract 9504, Tattnall County, Georgia",386,154,386,154,0,13
1500000US132679504004,132679504004,"Block Group 4, Census Tract 9504, Tattnall County, Georgia",1969,383,1910,376,59,69
1500000US132699501001,132699501001,"Block Group 1, Census Tract 9501, Taylor County, Georgia",1556,168,1556,168,0,13
1500000US132699502001,132699502001,"Block Group 1, Census Tract 9502, Taylor County, Georgia",1080,249,1078,248,2,7
1500000US132699502002,132699502002,"Block Group 2, Census Tract 9502, Taylor County, Georgia",1268,213,1148,212,120,69
1500000US132699503001,132699503001,"Block Group 1, Census Tract 9503, Taylor County, Georgia",1588,284,1588,284,0,13
1500000US132699503002,132699503002,"Block Group 2, Census Tract 9503, Taylor County, Georgia",1058,357,1058,357,0,13
1500000US132699503003,132699503003,"Block Group 3, Census Tract 9503, Taylor County, Georgia",918,205,849,198,69,68
1500000US132699503004,132699503004,"Block Group 4, Census Tract 9503, Taylor County, Georgia",933,240,933,240,0,13
1500000US132719501001,132719501001,"Block Group 1, Census Tract 9501, Telfair County, Georgia",2163,445,2163,445,0,13
1500000US132719501002,132719501002,"Block Group 2, Census Tract 9501, Telfair County, Georgia",2908,476,2700,424,208,152
1500000US132719501003,132719501003,"Block Group 3, Census Tract 9501, Telfair County, Georgia",1428,329,1428,329,0,13
1500000US132719501004,132719501004,"Block Group 4, Census Tract 9501, Telfair County, Georgia",1101,365,997,352,104,96
1500000US132719501005,132719501005,"Block Group 5, Census Tract 9501, Telfair County, Georgia",3905,446,2152,415,1753,192
1500000US132719502001,132719502001,"Block Group 1, Census Tract 9502, Telfair County, Georgia",743,207,743,207,0,13
1500000US132719502002,132719502002,"Block Group 2, Census Tract 9502, Telfair County, Georgia",1041,224,974,197,67,107
1500000US132719505001,132719505001,"Block Group 1, Census Tract 9505, Telfair County, Georgia",1098,270,1098,270,0,13
1500000US132719505002,132719505002,"Block Group 2, Census Tract 9505, Telfair County, Georgia",926,234,787,206,139,183
1500000US132719505003,132719505003,"Block Group 3, Census Tract 9505, Telfair County, Georgia",1103,284,1103,284,0,13
1500000US132731202001,132731202001,"Block Group 1, Census Tract 1202, Terrell County, Georgia",679,147,676,147,3,6
1500000US132731202002,132731202002,"Block Group 2, Census Tract 1202, Terrell County, Georgia",911,167,901,160,10,23
1500000US132731203001,132731203001,"Block Group 1, Census Tract 1203, Terrell County, Georgia",673,172,673,172,0,13
1500000US132731203002,132731203002,"Block Group 2, Census Tract 1203, Terrell County, Georgia",1132,281,1132,281,0,13
1500000US132731203003,132731203003,"Block Group 3, Census Tract 1203, Terrell County, Georgia",703,293,703,293,0,13
1500000US132731203004,132731203004,"Block Group 4, Census Tract 1203, Terrell County, Georgia",464,203,464,203,0,13
1500000US132731204001,132731204001,"Block Group 1, Census Tract 1204, Terrell County, Georgia",1367,278,1362,278,5,9
1500000US132731204002,132731204002,"Block Group 2, Census Tract 1204, Terrell County, Georgia",687,180,687,180,0,13
1500000US132731204003,132731204003,"Block Group 3, Census Tract 1204, Terrell County, Georgia",960,275,960,275,0,13
1500000US132731205001,132731205001,"Block Group 1, Census Tract 1205, Terrell County, Georgia",1637,148,1433,148,204,26
1500000US132759601001,132759601001,"Block Group 1, Census Tract 9601, Thomas County, Georgia",574,115,516,94,58,68
1500000US132759601002,132759601002,"Block Group 2, Census Tract 9601, Thomas County, Georgia",638,160,526,121,112,93
1500000US132759602001,132759602001,"Block Group 1, Census Tract 9602, Thomas County, Georgia",2668,339,2655,340,13,17
1500000US132759602002,132759602002,"Block Group 2, Census Tract 9602, Thomas County, Georgia",1286,291,1221,269,65,82
1500000US132759603001,132759603001,"Block Group 1, Census Tract 9603, Thomas County, Georgia",1194,222,1109,222,85,65
1500000US132759603002,132759603002,"Block Group 2, Census Tract 9603, Thomas County, Georgia",1045,134,1040,134,5,8
1500000US132759604001,132759604001,"Block Group 1, Census Tract 9604, Thomas County, Georgia",863,157,841,158,22,29
1500000US132759604002,132759604002,"Block Group 2, Census Tract 9604, Thomas County, Georgia",1288,189,1260,184,28,37
1500000US132759605001,132759605001,"Block Group 1, Census Tract 9605, Thomas County, Georgia",3228,507,3178,508,50,57
1500000US132759605002,132759605002,"Block Group 2, Census Tract 9605, Thomas County, Georgia",1531,417,1531,417,0,13
1500000US132759605003,132759605003,"Block Group 3, Census Tract 9605, Thomas County, Georgia",2060,473,1997,452,63,92
1500000US132759606001,132759606001,"Block Group 1, Census Tract 9606, Thomas County, Georgia",1643,367,1597,368,46,61
1500000US132759606002,132759606002,"Block Group 2, Census Tract 9606, Thomas County, Georgia",1017,290,1017,290,0,13
1500000US132759606003,132759606003,"Block Group 3, Census Tract 9606, Thomas County, Georgia",368,188,368,188,0,13
1500000US132759606004,132759606004,"Block Group 4, Census Tract 9606, Thomas County, Georgia",1684,441,1644,434,40,45
1500000US132759606005,132759606005,"Block Group 5, Census Tract 9606, Thomas County, Georgia",856,305,856,305,0,13
1500000US132759607001,132759607001,"Block Group 1, Census Tract 9607, Thomas County, Georgia",1970,404,1970,404,0,13
1500000US132759607002,132759607002,"Block Group 2, Census Tract 9607, Thomas County, Georgia",1539,557,1539,557,0,13
1500000US132759607003,132759607003,"Block Group 3, Census Tract 9607, Thomas County, Georgia",1312,418,1164,405,148,176
1500000US132759607004,132759607004,"Block Group 4, Census Tract 9607, Thomas County, Georgia",911,362,911,362,0,13
1500000US132759607005,132759607005,"Block Group 5, Census Tract 9607, Thomas County, Georgia",781,403,725,391,56,61
1500000US132759607006,132759607006,"Block Group 6, Census Tract 9607, Thomas County, Georgia",366,232,366,232,0,13
1500000US132759608001,132759608001,"Block Group 1, Census Tract 9608, Thomas County, Georgia",932,277,788,267,144,121
1500000US132759608002,132759608002,"Block Group 2, Census Tract 9608, Thomas County, Georgia",1457,623,1457,623,0,13
1500000US132759608003,132759608003,"Block Group 3, Census Tract 9608, Thomas County, Georgia",564,238,564,238,0,13
1500000US132759608004,132759608004,"Block Group 4, Census Tract 9608, Thomas County, Georgia",851,393,851,393,0,13
1500000US132759608005,132759608005,"Block Group 5, Census Tract 9608, Thomas County, Georgia",1695,482,1691,480,4,9
1500000US132759609001,132759609001,"Block Group 1, Census Tract 9609, Thomas County, Georgia",860,284,848,276,12,18
1500000US132759609002,132759609002,"Block Group 2, Census Tract 9609, Thomas County, Georgia",1883,426,1862,421,21,31
1500000US132759609003,132759609003,"Block Group 3, Census Tract 9609, Thomas County, Georgia",934,205,934,205,0,13
1500000US132759610001,132759610001,"Block Group 1, Census Tract 9610, Thomas County, Georgia",1984,320,1920,314,64,76
1500000US132759610002,132759610002,"Block Group 2, Census Tract 9610, Thomas County, Georgia",970,370,659,222,311,284
1500000US132759610003,132759610003,"Block Group 3, Census Tract 9610, Thomas County, Georgia",1047,257,1047,257,0,13
1500000US132759611001,132759611001,"Block Group 1, Census Tract 9611, Thomas County, Georgia",892,257,790,221,102,114
1500000US132759611002,132759611002,"Block Group 2, Census Tract 9611, Thomas County, Georgia",1072,247,1025,237,47,68
1500000US132759611003,132759611003,"Block Group 3, Census Tract 9611, Thomas County, Georgia",861,224,861,224,0,13
1500000US132779601001,132779601001,"Block Group 1, Census Tract 9601, Tift County, Georgia",1346,334,917,230,429,272
1500000US132779601002,132779601002,"Block Group 2, Census Tract 9601, Tift County, Georgia",1157,231,1157,231,0,13
1500000US132779602001,132779602001,"Block Group 1, Census Tract 9602, Tift County, Georgia",1419,303,1324,282,95,109
1500000US132779602002,132779602002,"Block Group 2, Census Tract 9602, Tift County, Georgia",1565,268,1473,264,92,102
1500000US132779603001,132779603001,"Block Group 1, Census Tract 9603, Tift County, Georgia",512,225,512,225,0,13
1500000US132779603002,132779603002,"Block Group 2, Census Tract 9603, Tift County, Georgia",998,343,998,343,0,13
1500000US132779603003,132779603003,"Block Group 3, Census Tract 9603, Tift County, Georgia",4345,540,4294,543,51,28
1500000US132779603004,132779603004,"Block Group 4, Census Tract 9603, Tift County, Georgia",687,516,687,516,0,13
1500000US132779603005,132779603005,"Block Group 5, Census Tract 9603, Tift County, Georgia",849,287,673,219,176,223
1500000US132779603006,132779603006,"Block Group 6, Census Tract 9603, Tift County, Georgia",492,222,431,198,61,97
1500000US132779604001,132779604001,"Block Group 1, Census Tract 9604, Tift County, Georgia",304,187,235,144,69,115
1500000US132779604002,132779604002,"Block Group 2, Census Tract 9604, Tift County, Georgia",944,311,944,311,0,13
1500000US132779604003,132779604003,"Block Group 3, Census Tract 9604, Tift County, Georgia",2353,706,1955,513,398,492
1500000US132779604004,132779604004,"Block Group 4, Census Tract 9604, Tift County, Georgia",982,365,982,365,0,13
1500000US132779604005,132779604005,"Block Group 5, Census Tract 9604, Tift County, Georgia",401,172,390,168,11,16
1500000US132779604006,132779604006,"Block Group 6, Census Tract 9604, Tift County, Georgia",1201,329,1053,252,148,185
1500000US132779605001,132779605001,"Block Group 1, Census Tract 9605, Tift County, Georgia",2766,354,2738,353,28,43
1500000US132779605002,132779605002,"Block Group 2, Census Tract 9605, Tift County, Georgia",1775,297,1768,297,7,13
1500000US132779606001,132779606001,"Block Group 1, Census Tract 9606, Tift County, Georgia",1278,542,1045,544,233,241
1500000US132779606002,132779606002,"Block Group 2, Census Tract 9606, Tift County, Georgia",2892,820,2825,808,67,79
1500000US132779606003,132779606003,"Block Group 3, Census Tract 9606, Tift County, Georgia",1011,466,1011,466,0,13
1500000US132779606004,132779606004,"Block Group 4, Census Tract 9606, Tift County, Georgia",639,268,639,268,0,13
1500000US132779607001,132779607001,"Block Group 1, Census Tract 9607, Tift County, Georgia",1016,315,957,304,59,73
1500000US132779607002,132779607002,"Block Group 2, Census Tract 9607, Tift County, Georgia",2639,471,1326,271,1313,442
1500000US132779607003,132779607003,"Block Group 3, Census Tract 9607, Tift County, Georgia",383,169,383,169,0,13
1500000US132779607004,132779607004,"Block Group 4, Census Tract 9607, Tift County, Georgia",805,575,805,575,0,13
1500000US132779608001,132779608001,"Block Group 1, Census Tract 9608, Tift County, Georgia",1238,257,830,180,408,199
1500000US132779608002,132779608002,"Block Group 2, Census Tract 9608, Tift County, Georgia",1333,402,744,219,589,339
1500000US132779609001,132779609001,"Block Group 1, Census Tract 9609, Tift County, Georgia",840,273,825,270,15,24
1500000US132779609002,132779609002,"Block Group 2, Census Tract 9609, Tift County, Georgia",1221,394,1056,358,165,277
1500000US132779609003,132779609003,"Block Group 3, Census Tract 9609, Tift County, Georgia",1396,338,1396,338,0,13
1500000US132799701001,132799701001,"Block Group 1, Census Tract 9701, Toombs County, Georgia",2339,570,1709,486,630,352
1500000US132799701002,132799701002,"Block Group 2, Census Tract 9701, Toombs County, Georgia",898,405,767,392,131,192
1500000US132799701003,132799701003,"Block Group 3, Census Tract 9701, Toombs County, Georgia",1068,352,957,310,111,196
1500000US132799701004,132799701004,"Block Group 4, Census Tract 9701, Toombs County, Georgia",1174,366,1003,258,171,257
1500000US132799702001,132799702001,"Block Group 1, Census Tract 9702, Toombs County, Georgia",1568,366,1568,366,0,13
1500000US132799702002,132799702002,"Block Group 2, Census Tract 9702, Toombs County, Georgia",964,365,964,365,0,13
1500000US132799702003,132799702003,"Block Group 3, Census Tract 9702, Toombs County, Georgia",976,310,698,265,278,297
1500000US132799702004,132799702004,"Block Group 4, Census Tract 9702, Toombs County, Georgia",765,303,765,303,0,13
1500000US132799702005,132799702005,"Block Group 5, Census Tract 9702, Toombs County, Georgia",466,169,466,169,0,13
1500000US132799703001,132799703001,"Block Group 1, Census Tract 9703, Toombs County, Georgia",1219,390,1080,348,139,218
1500000US132799703002,132799703002,"Block Group 2, Census Tract 9703, Toombs County, Georgia",1425,638,1347,630,78,201
1500000US132799703003,132799703003,"Block Group 3, Census Tract 9703, Toombs County, Georgia",1237,302,1087,301,150,215
1500000US132799703004,132799703004,"Block Group 4, Census Tract 9703, Toombs County, Georgia",683,360,683,360,0,13
1500000US132799703005,132799703005,"Block Group 5, Census Tract 9703, Toombs County, Georgia",1751,548,1407,478,344,201
1500000US132799704001,132799704001,"Block Group 1, Census Tract 9704, Toombs County, Georgia",689,304,689,304,0,13
1500000US132799704002,132799704002,"Block Group 2, Census Tract 9704, Toombs County, Georgia",525,257,479,245,46,56
1500000US132799704003,132799704003,"Block Group 3, Census Tract 9704, Toombs County, Georgia",1155,335,1155,335,0,13
1500000US132799704004,132799704004,"Block Group 4, Census Tract 9704, Toombs County, Georgia",1800,436,1618,443,182,194
1500000US132799705001,132799705001,"Block Group 1, Census Tract 9705, Toombs County, Georgia",398,160,308,133,90,119
1500000US132799705002,132799705002,"Block Group 2, Census Tract 9705, Toombs County, Georgia",1674,365,1385,333,289,221
1500000US132799705003,132799705003,"Block Group 3, Census Tract 9705, Toombs County, Georgia",1512,322,1324,324,188,135
1500000US132799706001,132799706001,"Block Group 1, Census Tract 9706, Toombs County, Georgia",1012,259,919,235,93,133
1500000US132799706002,132799706002,"Block Group 2, Census Tract 9706, Toombs County, Georgia",1338,285,1243,230,95,138
1500000US132799706003,132799706003,"Block Group 3, Census Tract 9706, Toombs County, Georgia",574,208,489,187,85,102
1500000US132819601001,132819601001,"Block Group 1, Census Tract 9601, Towns County, Georgia",1822,283,1800,286,22,42
1500000US132819601002,132819601002,"Block Group 2, Census Tract 9601, Towns County, Georgia",1294,367,1271,365,23,37
1500000US132819601003,132819601003,"Block Group 3, Census Tract 9601, Towns County, Georgia",1333,246,1299,243,34,31
1500000US132819602001,132819602001,"Block Group 1, Census Tract 9602, Towns County, Georgia",1249,269,1152,256,97,100
1500000US132819602002,132819602002,"Block Group 2, Census Tract 9602, Towns County, Georgia",1463,296,1463,296,0,13
1500000US132819603001,132819603001,"Block Group 1, Census Tract 9603, Towns County, Georgia",1227,214,1227,214,0,13
1500000US132819603002,132819603002,"Block Group 2, Census Tract 9603, Towns County, Georgia",1191,229,1168,236,23,40
1500000US132819603003,132819603003,"Block Group 3, Census Tract 9603, Towns County, Georgia",1221,271,1160,269,61,71
1500000US132839601001,132839601001,"Block Group 1, Census Tract 9601, Treutlen County, Georgia",582,165,532,169,50,65
1500000US132839601002,132839601002,"Block Group 2, Census Tract 9601, Treutlen County, Georgia",559,157,559,157,0,13
1500000US132839602001,132839602001,"Block Group 1, Census Tract 9602, Treutlen County, Georgia",970,272,970,272,0,13
1500000US132839602002,132839602002,"Block Group 2, Census Tract 9602, Treutlen County, Georgia",921,245,921,245,0,13
1500000US132839602003,132839602003,"Block Group 3, Census Tract 9602, Treutlen County, Georgia",1432,296,1432,296,0,13
1500000US132839602004,132839602004,"Block Group 4, Census Tract 9602, Treutlen County, Georgia",666,204,666,204,0,13
1500000US132839602005,132839602005,"Block Group 5, Census Tract 9602, Treutlen County, Georgia",1632,263,1603,254,29,33
1500000US132859601001,132859601001,"Block Group 1, Census Tract 9601, Troup County, Georgia",1349,291,1339,292,10,17
1500000US132859601002,132859601002,"Block Group 2, Census Tract 9601, Troup County, Georgia",1310,288,1310,288,0,13
1500000US132859601003,132859601003,"Block Group 3, Census Tract 9601, Troup County, Georgia",1224,179,1211,177,13,21
1500000US132859601004,132859601004,"Block Group 4, Census Tract 9601, Troup County, Georgia",2211,391,2206,390,5,7
1500000US132859602011,132859602011,"Block Group 1, Census Tract 9602.01, Troup County, Georgia",3046,308,2989,310,57,55
1500000US132859602021,132859602021,"Block Group 1, Census Tract 9602.02, Troup County, Georgia",2346,307,2309,309,37,69
1500000US132859603001,132859603001,"Block Group 1, Census Tract 9603, Troup County, Georgia",830,238,790,241,40,53
1500000US132859603002,132859603002,"Block Group 2, Census Tract 9603, Troup County, Georgia",1171,204,1078,191,93,87
1500000US132859603003,132859603003,"Block Group 3, Census Tract 9603, Troup County, Georgia",1851,241,1851,241,0,13
1500000US132859604001,132859604001,"Block Group 1, Census Tract 9604, Troup County, Georgia",812,267,811,266,1,4
1500000US132859604002,132859604002,"Block Group 2, Census Tract 9604, Troup County, Georgia",1852,559,1831,554,21,35
1500000US132859604003,132859604003,"Block Group 3, Census Tract 9604, Troup County, Georgia",3021,474,3000,473,21,23
1500000US132859605011,132859605011,"Block Group 1, Census Tract 9605.01, Troup County, Georgia",1402,317,1393,316,9,15
1500000US132859605012,132859605012,"Block Group 2, Census Tract 9605.01, Troup County, Georgia",651,277,642,276,9,16
1500000US132859605013,132859605013,"Block Group 3, Census Tract 9605.01, Troup County, Georgia",1272,307,1049,275,223,202
1500000US132859605014,132859605014,"Block Group 4, Census Tract 9605.01, Troup County, Georgia",1379,465,1202,428,177,171
1500000US132859605021,132859605021,"Block Group 1, Census Tract 9605.02, Troup County, Georgia",2493,457,2328,438,165,152
1500000US132859605022,132859605022,"Block Group 2, Census Tract 9605.02, Troup County, Georgia",4974,612,4643,640,331,339
1500000US132859606001,132859606001,"Block Group 1, Census Tract 9606, Troup County, Georgia",1602,344,1564,340,38,34
1500000US132859606002,132859606002,"Block Group 2, Census Tract 9606, Troup County, Georgia",1640,406,1574,425,66,103
1500000US132859606003,132859606003,"Block Group 3, Census Tract 9606, Troup County, Georgia",922,309,912,308,10,11
1500000US132859606004,132859606004,"Block Group 4, Census Tract 9606, Troup County, Georgia",1651,492,1647,493,4,6
1500000US132859607001,132859607001,"Block Group 1, Census Tract 9607, Troup County, Georgia",1750,502,1614,475,136,180
1500000US132859607002,132859607002,"Block Group 2, Census Tract 9607, Troup County, Georgia",1792,352,1733,343,59,89
1500000US132859607003,132859607003,"Block Group 3, Census Tract 9607, Troup County, Georgia",1372,372,1372,372,0,13
1500000US132859607004,132859607004,"Block Group 4, Census Tract 9607, Troup County, Georgia",1340,372,1086,213,254,323
1500000US132859608001,132859608001,"Block Group 1, Census Tract 9608, Troup County, Georgia",1262,304,1226,296,36,38
1500000US132859608002,132859608002,"Block Group 2, Census Tract 9608, Troup County, Georgia",1170,390,1042,359,128,178
1500000US132859608003,132859608003,"Block Group 3, Census Tract 9608, Troup County, Georgia",1029,292,1027,292,2,4
1500000US132859609011,132859609011,"Block Group 1, Census Tract 9609.01, Troup County, Georgia",882,279,853,276,29,48
1500000US132859609012,132859609012,"Block Group 2, Census Tract 9609.01, Troup County, Georgia",1635,398,1440,333,195,236
1500000US132859609013,132859609013,"Block Group 3, Census Tract 9609.01, Troup County, Georgia",1935,433,1757,363,178,243
1500000US132859609021,132859609021,"Block Group 1, Census Tract 9609.02, Troup County, Georgia",2192,749,2192,749,0,13
1500000US132859609022,132859609022,"Block Group 2, Census Tract 9609.02, Troup County, Georgia",2849,441,2833,444,16,22
1500000US132859609023,132859609023,"Block Group 3, Census Tract 9609.02, Troup County, Georgia",1686,446,1655,440,31,50
1500000US132859610001,132859610001,"Block Group 1, Census Tract 9610, Troup County, Georgia",2005,572,1984,571,21,30
1500000US132859610002,132859610002,"Block Group 2, Census Tract 9610, Troup County, Georgia",1671,456,1657,454,14,23
1500000US132859610003,132859610003,"Block Group 3, Census Tract 9610, Troup County, Georgia",1084,494,1084,494,0,13
1500000US132859610004,132859610004,"Block Group 4, Census Tract 9610, Troup County, Georgia",1448,356,1431,353,17,24
1500000US132859611001,132859611001,"Block Group 1, Census Tract 9611, Troup County, Georgia",1353,268,1314,257,39,62
1500000US132859611002,132859611002,"Block Group 2, Census Tract 9611, Troup County, Georgia",1403,266,1403,266,0,13
1500000US132879702001,132879702001,"Block Group 1, Census Tract 9702, Turner County, Georgia",887,298,873,297,14,27
1500000US132879702002,132879702002,"Block Group 2, Census Tract 9702, Turner County, Georgia",1013,289,1013,289,0,13
1500000US132879702003,132879702003,"Block Group 3, Census Tract 9702, Turner County, Georgia",1005,333,1005,333,0,13
1500000US132879702004,132879702004,"Block Group 4, Census Tract 9702, Turner County, Georgia",1563,368,1563,368,0,13
1500000US132879702005,132879702005,"Block Group 5, Census Tract 9702, Turner County, Georgia",876,183,607,170,269,64
1500000US132879703001,132879703001,"Block Group 1, Census Tract 9703, Turner County, Georgia",1096,213,1069,212,27,17
1500000US132879703002,132879703002,"Block Group 2, Census Tract 9703, Turner County, Georgia",499,180,499,180,0,13
1500000US132879703003,132879703003,"Block Group 3, Census Tract 9703, Turner County, Georgia",686,214,654,216,32,43
1500000US132879703004,132879703004,"Block Group 4, Census Tract 9703, Turner County, Georgia",713,220,699,217,14,19
1500000US132890601001,132890601001,"Block Group 1, Census Tract 601, Twiggs County, Georgia",1019,311,1019,311,0,13
1500000US132890601002,132890601002,"Block Group 2, Census Tract 601, Twiggs County, Georgia",1479,440,1474,439,5,10
1500000US132890601003,132890601003,"Block Group 3, Census Tract 601, Twiggs County, Georgia",512,257,512,257,0,13
1500000US132890601004,132890601004,"Block Group 4, Census Tract 601, Twiggs County, Georgia",2048,394,2048,394,0,13
1500000US132890602001,132890602001,"Block Group 1, Census Tract 602, Twiggs County, Georgia",1108,328,1108,328,0,13
1500000US132890602002,132890602002,"Block Group 2, Census Tract 602, Twiggs County, Georgia",1209,316,1209,316,0,13
1500000US132890602003,132890602003,"Block Group 3, Census Tract 602, Twiggs County, Georgia",725,246,725,246,0,13
1500000US132890602004,132890602004,"Block Group 4, Census Tract 602, Twiggs County, Georgia",409,132,409,132,0,13
1500000US132910001011,132910001011,"Block Group 1, Census Tract 1.01, Union County, Georgia",2652,463,2652,463,0,13
1500000US132910001021,132910001021,"Block Group 1, Census Tract 1.02, Union County, Georgia",1922,529,1922,529,0,13
1500000US132910001022,132910001022,"Block Group 2, Census Tract 1.02, Union County, Georgia",1023,347,1023,347,0,13
1500000US132910001023,132910001023,"Block Group 3, Census Tract 1.02, Union County, Georgia",2164,663,2164,663,0,13
1500000US132910002011,132910002011,"Block Group 1, Census Tract 2.01, Union County, Georgia",958,380,923,379,35,58
1500000US132910002012,132910002012,"Block Group 2, Census Tract 2.01, Union County, Georgia",1839,432,1810,427,29,54
1500000US132910002031,132910002031,"Block Group 1, Census Tract 2.03, Union County, Georgia",1526,410,1379,306,147,207
1500000US132910002032,132910002032,"Block Group 2, Census Tract 2.03, Union County, Georgia",752,317,739,315,13,19
1500000US132910002041,132910002041,"Block Group 1, Census Tract 2.04, Union County, Georgia",735,321,735,321,0,13
1500000US132910002042,132910002042,"Block Group 2, Census Tract 2.04, Union County, Georgia",2375,703,2309,672,66,125
1500000US132910002051,132910002051,"Block Group 1, Census Tract 2.05, Union County, Georgia",1104,387,1104,387,0,13
1500000US132910002052,132910002052,"Block Group 2, Census Tract 2.05, Union County, Georgia",2400,506,2313,497,87,143
1500000US132910002053,132910002053,"Block Group 3, Census Tract 2.05, Union County, Georgia",1116,420,1116,420,0,13
1500000US132910002054,132910002054,"Block Group 4, Census Tract 2.05, Union County, Georgia",1159,482,915,394,244,286
1500000US132930101001,132930101001,"Block Group 1, Census Tract 101, Upson County, Georgia",1928,254,1870,256,58,120
1500000US132930101002,132930101002,"Block Group 2, Census Tract 101, Upson County, Georgia",1045,227,1045,227,0,13
1500000US132930102011,132930102011,"Block Group 1, Census Tract 102.01, Upson County, Georgia",1645,261,1645,261,0,13
1500000US132930102012,132930102012,"Block Group 2, Census Tract 102.01, Upson County, Georgia",2116,481,1814,356,302,317
1500000US132930102013,132930102013,"Block Group 3, Census Tract 102.01, Upson County, Georgia",1618,385,1375,249,243,303
1500000US132930102021,132930102021,"Block Group 1, Census Tract 102.02, Upson County, Georgia",1228,231,1228,231,0,13
1500000US132930102022,132930102022,"Block Group 2, Census Tract 102.02, Upson County, Georgia",1410,260,1410,260,0,13
1500000US132930103001,132930103001,"Block Group 1, Census Tract 103, Upson County, Georgia",1835,351,1835,351,0,13
1500000US132930103002,132930103002,"Block Group 2, Census Tract 103, Upson County, Georgia",1290,273,1290,273,0,13
1500000US132930104001,132930104001,"Block Group 1, Census Tract 104, Upson County, Georgia",1137,377,1137,377,0,13
1500000US132930104002,132930104002,"Block Group 2, Census Tract 104, Upson County, Georgia",1562,475,1562,475,0,13
1500000US132930104003,132930104003,"Block Group 3, Census Tract 104, Upson County, Georgia",1115,305,1115,305,0,13
1500000US132930104004,132930104004,"Block Group 4, Census Tract 104, Upson County, Georgia",1104,370,1104,370,0,13
1500000US132930104005,132930104005,"Block Group 5, Census Tract 104, Upson County, Georgia",494,210,494,210,0,13
1500000US132930104006,132930104006,"Block Group 6, Census Tract 104, Upson County, Georgia",489,190,489,190,0,13
1500000US132930105001,132930105001,"Block Group 1, Census Tract 105, Upson County, Georgia",1683,519,1683,519,0,13
1500000US132930105002,132930105002,"Block Group 2, Census Tract 105, Upson County, Georgia",1341,371,1341,371,0,13
1500000US132930105003,132930105003,"Block Group 3, Census Tract 105, Upson County, Georgia",498,189,498,189,0,13
1500000US132930105004,132930105004,"Block Group 4, Census Tract 105, Upson County, Georgia",571,252,571,252,0,13
1500000US132930105005,132930105005,"Block Group 5, Census Tract 105, Upson County, Georgia",1232,331,1204,325,28,60
1500000US132930106001,132930106001,"Block Group 1, Census Tract 106, Upson County, Georgia",1187,174,1187,174,0,13
1500000US132950201001,132950201001,"Block Group 1, Census Tract 201, Walker County, Georgia",909,245,909,245,0,13
1500000US132950201002,132950201002,"Block Group 2, Census Tract 201, Walker County, Georgia",1701,451,1671,449,30,47
1500000US132950201003,132950201003,"Block Group 3, Census Tract 201, Walker County, Georgia",951,297,873,280,78,89
1500000US132950201004,132950201004,"Block Group 4, Census Tract 201, Walker County, Georgia",830,256,802,243,28,42
1500000US132950201005,132950201005,"Block Group 5, Census Tract 201, Walker County, Georgia",1099,282,1099,282,0,13
1500000US132950201006,132950201006,"Block Group 6, Census Tract 201, Walker County, Georgia",1207,391,1207,391,0,13
1500000US132950202001,132950202001,"Block Group 1, Census Tract 202, Walker County, Georgia",2389,401,2331,410,58,71
1500000US132950202002,132950202002,"Block Group 2, Census Tract 202, Walker County, Georgia",1646,319,1640,320,6,10
1500000US132950203011,132950203011,"Block Group 1, Census Tract 203.01, Walker County, Georgia",2046,502,1733,519,313,319
1500000US132950203012,132950203012,"Block Group 2, Census Tract 203.01, Walker County, Georgia",999,356,999,356,0,13
1500000US132950203013,132950203013,"Block Group 3, Census Tract 203.01, Walker County, Georgia",981,358,966,350,15,29
1500000US132950203014,132950203014,"Block Group 4, Census Tract 203.01, Walker County, Georgia",693,292,693,292,0,13
1500000US132950203021,132950203021,"Block Group 1, Census Tract 203.02, Walker County, Georgia",915,309,781,238,134,186
1500000US132950203022,132950203022,"Block Group 2, Census Tract 203.02, Walker County, Georgia",454,167,422,153,32,46
1500000US132950203023,132950203023,"Block Group 3, Census Tract 203.02, Walker County, Georgia",675,299,675,299,0,13
1500000US132950203024,132950203024,"Block Group 4, Census Tract 203.02, Walker County, Georgia",784,291,728,274,56,97
1500000US132950203025,132950203025,"Block Group 5, Census Tract 203.02, Walker County, Georgia",2262,481,2262,481,0,13
1500000US132950204001,132950204001,"Block Group 1, Census Tract 204, Walker County, Georgia",740,163,725,162,15,15
1500000US132950204002,132950204002,"Block Group 2, Census Tract 204, Walker County, Georgia",924,170,916,169,8,13
1500000US132950204003,132950204003,"Block Group 3, Census Tract 204, Walker County, Georgia",1549,418,1549,418,0,13
1500000US132950205011,132950205011,"Block Group 1, Census Tract 205.01, Walker County, Georgia",1636,326,1626,323,10,17
1500000US132950205012,132950205012,"Block Group 2, Census Tract 205.01, Walker County, Georgia",2429,270,2412,267,17,30
1500000US132950205013,132950205013,"Block Group 3, Census Tract 205.01, Walker County, Georgia",4089,733,4089,733,0,13
1500000US132950205021,132950205021,"Block Group 1, Census Tract 205.02, Walker County, Georgia",1317,398,1317,398,0,13
1500000US132950205022,132950205022,"Block Group 2, Census Tract 205.02, Walker County, Georgia",3221,425,3193,425,28,34
1500000US132950205023,132950205023,"Block Group 3, Census Tract 205.02, Walker County, Georgia",2008,375,2008,375,0,13
1500000US132950206011,132950206011,"Block Group 1, Census Tract 206.01, Walker County, Georgia",2355,514,2355,514,0,13
1500000US132950206012,132950206012,"Block Group 2, Census Tract 206.01, Walker County, Georgia",2350,412,2266,385,84,85
1500000US132950206013,132950206013,"Block Group 3, Census Tract 206.01, Walker County, Georgia",2118,473,1882,430,236,190
1500000US132950206021,132950206021,"Block Group 1, Census Tract 206.02, Walker County, Georgia",2481,380,2477,380,4,9
1500000US132950206022,132950206022,"Block Group 2, Census Tract 206.02, Walker County, Georgia",1907,305,1878,302,29,31
1500000US132950207001,132950207001,"Block Group 1, Census Tract 207, Walker County, Georgia",1882,411,1844,419,38,66
1500000US132950207002,132950207002,"Block Group 2, Census Tract 207, Walker County, Georgia",1124,590,1124,590,0,13
1500000US132950207003,132950207003,"Block Group 3, Census Tract 207, Walker County, Georgia",827,293,824,292,3,7
1500000US132950207004,132950207004,"Block Group 4, Census Tract 207, Walker County, Georgia",689,298,689,298,0,13
1500000US132950207005,132950207005,"Block Group 5, Census Tract 207, Walker County, Georgia",2099,498,2099,498,0,13
1500000US132950207006,132950207006,"Block Group 6, Census Tract 207, Walker County, Georgia",689,376,689,376,0,13
1500000US132950208001,132950208001,"Block Group 1, Census Tract 208, Walker County, Georgia",1141,255,1132,256,9,14
1500000US132950208002,132950208002,"Block Group 2, Census Tract 208, Walker County, Georgia",958,224,958,224,0,13
1500000US132950208003,132950208003,"Block Group 3, Census Tract 208, Walker County, Georgia",1112,287,1112,287,0,13
1500000US132950209011,132950209011,"Block Group 1, Census Tract 209.01, Walker County, Georgia",2904,514,2904,514,0,13
1500000US132950209012,132950209012,"Block Group 2, Census Tract 209.01, Walker County, Georgia",1944,689,1944,689,0,13
1500000US132950209013,132950209013,"Block Group 3, Census Tract 209.01, Walker County, Georgia",673,350,673,350,0,13
1500000US132950209014,132950209014,"Block Group 4, Census Tract 209.01, Walker County, Georgia",746,280,746,280,0,13
1500000US132950209021,132950209021,"Block Group 1, Census Tract 209.02, Walker County, Georgia",660,145,644,149,16,15
1500000US132950209022,132950209022,"Block Group 2, Census Tract 209.02, Walker County, Georgia",1172,209,1169,210,3,6
1500000US132971101001,132971101001,"Block Group 1, Census Tract 1101, Walton County, Georgia",2813,595,2813,595,0,13
1500000US132971101002,132971101002,"Block Group 2, Census Tract 1101, Walton County, Georgia",1868,462,1836,446,32,50
1500000US132971101003,132971101003,"Block Group 3, Census Tract 1101, Walton County, Georgia",4191,614,4083,596,108,141
1500000US132971102001,132971102001,"Block Group 1, Census Tract 1102, Walton County, Georgia",1670,326,1670,326,0,13
1500000US132971102002,132971102002,"Block Group 2, Census Tract 1102, Walton County, Georgia",2555,337,2509,335,46,72
1500000US132971103001,132971103001,"Block Group 1, Census Tract 1103, Walton County, Georgia",1822,541,1772,542,50,59
1500000US132971103002,132971103002,"Block Group 2, Census Tract 1103, Walton County, Georgia",3869,702,3754,711,115,184
1500000US132971103003,132971103003,"Block Group 3, Census Tract 1103, Walton County, Georgia",1243,377,1132,374,111,158
1500000US132971104001,132971104001,"Block Group 1, Census Tract 1104, Walton County, Georgia",2501,390,2484,391,17,25
1500000US132971104002,132971104002,"Block Group 2, Census Tract 1104, Walton County, Georgia",2198,551,2198,551,0,13
1500000US132971104003,132971104003,"Block Group 3, Census Tract 1104, Walton County, Georgia",1951,445,1904,443,47,79
1500000US132971105031,132971105031,"Block Group 1, Census Tract 1105.03, Walton County, Georgia",3466,358,3285,329,181,166
1500000US132971105041,132971105041,"Block Group 1, Census Tract 1105.04, Walton County, Georgia",2085,432,1987,425,98,92
1500000US132971105042,132971105042,"Block Group 2, Census Tract 1105.04, Walton County, Georgia",2857,543,2484,557,373,334
1500000US132971105051,132971105051,"Block Group 1, Census Tract 1105.05, Walton County, Georgia",4223,428,4142,418,81,69
1500000US132971105061,132971105061,"Block Group 1, Census Tract 1105.06, Walton County, Georgia",1417,317,1320,283,97,136
1500000US132971105062,132971105062,"Block Group 2, Census Tract 1105.06, Walton County, Georgia",1459,362,1459,362,0,13
1500000US132971105063,132971105063,"Block Group 3, Census Tract 1105.06, Walton County, Georgia",2267,377,2180,378,87,90
1500000US132971105071,132971105071,"Block Group 1, Census Tract 1105.07, Walton County, Georgia",1478,480,1467,480,11,18
1500000US132971105072,132971105072,"Block Group 2, Census Tract 1105.07, Walton County, Georgia",1155,318,1021,331,134,118
1500000US132971105073,132971105073,"Block Group 3, Census Tract 1105.07, Walton County, Georgia",4992,516,4571,455,421,444
1500000US132971105081,132971105081,"Block Group 1, Census Tract 1105.08, Walton County, Georgia",1978,472,1957,473,21,33
1500000US132971105082,132971105082,"Block Group 2, Census Tract 1105.08, Walton County, Georgia",1822,385,1709,348,113,177
1500000US132971105083,132971105083,"Block Group 3, Census Tract 1105.08, Walton County, Georgia",1310,474,1039,354,271,384
1500000US132971106011,132971106011,"Block Group 1, Census Tract 1106.01, Walton County, Georgia",2057,353,2021,352,36,58
1500000US132971106012,132971106012,"Block Group 2, Census Tract 1106.01, Walton County, Georgia",2587,409,2587,409,0,13
1500000US132971106021,132971106021,"Block Group 1, Census Tract 1106.02, Walton County, Georgia",2745,406,2705,415,40,58
1500000US132971106022,132971106022,"Block Group 2, Census Tract 1106.02, Walton County, Georgia",2580,432,2527,441,53,85
1500000US132971106031,132971106031,"Block Group 1, Census Tract 1106.03, Walton County, Georgia",869,261,869,261,0,13
1500000US132971106032,132971106032,"Block Group 2, Census Tract 1106.03, Walton County, Georgia",3683,367,3502,360,181,183
1500000US132971107001,132971107001,"Block Group 1, Census Tract 1107, Walton County, Georgia",1804,527,1804,527,0,13
1500000US132971107002,132971107002,"Block Group 2, Census Tract 1107, Walton County, Georgia",2926,435,2829,425,97,116
1500000US132971107003,132971107003,"Block Group 3, Census Tract 1107, Walton County, Georgia",1503,448,1503,448,0,13
1500000US132971107004,132971107004,"Block Group 4, Census Tract 1107, Walton County, Georgia",1311,395,1304,395,7,11
1500000US132971108001,132971108001,"Block Group 1, Census Tract 1108, Walton County, Georgia",1792,480,1637,468,155,162
1500000US132971108002,132971108002,"Block Group 2, Census Tract 1108, Walton County, Georgia",1616,643,1330,545,286,348
1500000US132971108003,132971108003,"Block Group 3, Census Tract 1108, Walton County, Georgia",1753,481,1753,481,0,13
1500000US132971108004,132971108004,"Block Group 4, Census Tract 1108, Walton County, Georgia",1785,441,1785,441,0,13
1500000US132999501001,132999501001,"Block Group 1, Census Tract 9501, Ware County, Georgia",1616,205,1616,205,0,13
1500000US132999502001,132999502001,"Block Group 1, Census Tract 9502, Ware County, Georgia",1303,457,1303,457,0,13
1500000US132999502002,132999502002,"Block Group 2, Census Tract 9502, Ware County, Georgia",3392,402,3284,386,108,88
1500000US132999502003,132999502003,"Block Group 3, Census Tract 9502, Ware County, Georgia",2074,503,1703,481,371,319
1500000US132999502004,132999502004,"Block Group 4, Census Tract 9502, Ware County, Georgia",980,382,980,382,0,13
1500000US132999503001,132999503001,"Block Group 1, Census Tract 9503, Ware County, Georgia",750,202,750,202,0,13
1500000US132999503002,132999503002,"Block Group 2, Census Tract 9503, Ware County, Georgia",834,180,834,180,0,13
1500000US132999503003,132999503003,"Block Group 3, Census Tract 9503, Ware County, Georgia",343,131,343,131,0,13
1500000US132999504001,132999504001,"Block Group 1, Census Tract 9504, Ware County, Georgia",496,155,491,156,5,9
1500000US132999504002,132999504002,"Block Group 2, Census Tract 9504, Ware County, Georgia",545,149,522,153,23,28
1500000US132999504003,132999504003,"Block Group 3, Census Tract 9504, Ware County, Georgia",742,226,733,225,9,16
1500000US132999505001,132999505001,"Block Group 1, Census Tract 9505, Ware County, Georgia",1895,443,1895,443,0,13
1500000US132999505002,132999505002,"Block Group 2, Census Tract 9505, Ware County, Georgia",919,448,919,448,0,13
1500000US132999505003,132999505003,"Block Group 3, Census Tract 9505, Ware County, Georgia",974,318,952,319,22,35
1500000US132999505004,132999505004,"Block Group 4, Census Tract 9505, Ware County, Georgia",912,288,912,288,0,13
1500000US132999505005,132999505005,"Block Group 5, Census Tract 9505, Ware County, Georgia",798,407,798,407,0,13
1500000US132999506001,132999506001,"Block Group 1, Census Tract 9506, Ware County, Georgia",1657,359,1657,359,0,13
1500000US132999506002,132999506002,"Block Group 2, Census Tract 9506, Ware County, Georgia",1630,432,1619,430,11,21
1500000US132999506003,132999506003,"Block Group 3, Census Tract 9506, Ware County, Georgia",1384,368,1384,368,0,13
1500000US132999506004,132999506004,"Block Group 4, Census Tract 9506, Ware County, Georgia",659,404,659,404,0,13
1500000US132999506005,132999506005,"Block Group 5, Census Tract 9506, Ware County, Georgia",748,235,748,235,0,13
1500000US132999507001,132999507001,"Block Group 1, Census Tract 9507, Ware County, Georgia",421,135,381,120,40,51
1500000US132999507002,132999507002,"Block Group 2, Census Tract 9507, Ware County, Georgia",800,165,784,165,16,27
1500000US132999508001,132999508001,"Block Group 1, Census Tract 9508, Ware County, Georgia",721,354,562,290,159,237
1500000US132999508002,132999508002,"Block Group 2, Census Tract 9508, Ware County, Georgia",1252,377,1252,377,0,13
1500000US132999508003,132999508003,"Block Group 3, Census Tract 9508, Ware County, Georgia",1234,459,1234,459,0,13
1500000US132999508004,132999508004,"Block Group 4, Census Tract 9508, Ware County, Georgia",313,163,313,163,0,13
1500000US132999508005,132999508005,"Block Group 5, Census Tract 9508, Ware County, Georgia",1418,409,1238,396,180,237
1500000US132999508006,132999508006,"Block Group 6, Census Tract 9508, Ware County, Georgia",683,239,617,251,66,81
1500000US132999509001,132999509001,"Block Group 1, Census Tract 9509, Ware County, Georgia",1008,242,1008,242,0,13
1500000US132999509002,132999509002,"Block Group 2, Census Tract 9509, Ware County, Georgia",737,249,737,249,0,13
1500000US132999509003,132999509003,"Block Group 3, Census Tract 9509, Ware County, Georgia",1379,325,1361,326,18,23
1500000US132999509004,132999509004,"Block Group 4, Census Tract 9509, Ware County, Georgia",1106,308,834,221,272,242
1500000US133019704001,133019704001,"Block Group 1, Census Tract 9704, Warren County, Georgia",965,199,965,199,0,13
1500000US133019704002,133019704002,"Block Group 2, Census Tract 9704, Warren County, Georgia",1190,224,1190,224,0,13
1500000US133019704003,133019704003,"Block Group 3, Census Tract 9704, Warren County, Georgia",675,122,675,122,0,13
1500000US133019705001,133019705001,"Block Group 1, Census Tract 9705, Warren County, Georgia",1235,209,1192,212,43,47
1500000US133019705002,133019705002,"Block Group 2, Census Tract 9705, Warren County, Georgia",776,189,776,189,0,13
1500000US133019705003,133019705003,"Block Group 3, Census Tract 9705, Warren County, Georgia",720,172,720,172,0,13
1500000US133039501001,133039501001,"Block Group 1, Census Tract 9501, Washington County, Georgia",860,171,860,171,0,13
1500000US133039501002,133039501002,"Block Group 2, Census Tract 9501, Washington County, Georgia",879,179,879,179,0,13
1500000US133039503001,133039503001,"Block Group 1, Census Tract 9503, Washington County, Georgia",1855,274,1855,274,0,13
1500000US133039503002,133039503002,"Block Group 2, Census Tract 9503, Washington County, Georgia",1372,335,1372,335,0,13
1500000US133039503003,133039503003,"Block Group 3, Census Tract 9503, Washington County, Georgia",601,194,601,194,0,13
1500000US133039503004,133039503004,"Block Group 4, Census Tract 9503, Washington County, Georgia",550,151,550,151,0,13
1500000US133039504001,133039504001,"Block Group 1, Census Tract 9504, Washington County, Georgia",1808,459,1785,449,23,45
1500000US133039504002,133039504002,"Block Group 2, Census Tract 9504, Washington County, Georgia",973,364,961,364,12,25
1500000US133039504003,133039504003,"Block Group 3, Census Tract 9504, Washington County, Georgia",928,314,911,310,17,36
1500000US133039504004,133039504004,"Block Group 4, Census Tract 9504, Washington County, Georgia",1513,356,1513,356,0,13
1500000US133039505001,133039505001,"Block Group 1, Census Tract 9505, Washington County, Georgia",2343,275,2283,285,60,53
1500000US133039505002,133039505002,"Block Group 2, Census Tract 9505, Washington County, Georgia",1378,300,1301,278,77,99
1500000US133039505003,133039505003,"Block Group 3, Census Tract 9505, Washington County, Georgia",1573,250,1558,253,15,28
1500000US133039507001,133039507001,"Block Group 1, Census Tract 9507, Washington County, Georgia",1738,267,1515,241,223,168
1500000US133039507002,133039507002,"Block Group 2, Census Tract 9507, Washington County, Georgia",953,251,930,233,23,43
1500000US133039507003,133039507003,"Block Group 3, Census Tract 9507, Washington County, Georgia",1461,324,1461,324,0,13
1500000US133059701001,133059701001,"Block Group 1, Census Tract 9701, Wayne County, Georgia",1044,280,952,257,92,122
1500000US133059701002,133059701002,"Block Group 2, Census Tract 9701, Wayne County, Georgia",845,226,845,226,0,13
1500000US133059701003,133059701003,"Block Group 3, Census Tract 9701, Wayne County, Georgia",1009,267,963,262,46,71
1500000US133059701004,133059701004,"Block Group 4, Census Tract 9701, Wayne County, Georgia",1134,303,1060,298,74,79
1500000US133059702001,133059702001,"Block Group 1, Census Tract 9702, Wayne County, Georgia",2671,562,2647,555,24,37
1500000US133059702002,133059702002,"Block Group 2, Census Tract 9702, Wayne County, Georgia",2847,660,2784,646,63,97
1500000US133059702003,133059702003,"Block Group 3, Census Tract 9702, Wayne County, Georgia",942,530,791,501,151,165
1500000US133059702004,133059702004,"Block Group 4, Census Tract 9702, Wayne County, Georgia",890,298,890,298,0,13
1500000US133059702005,133059702005,"Block Group 5, Census Tract 9702, Wayne County, Georgia",401,232,401,232,0,13
1500000US133059703001,133059703001,"Block Group 1, Census Tract 9703, Wayne County, Georgia",1376,305,1339,293,37,60
1500000US133059703002,133059703002,"Block Group 2, Census Tract 9703, Wayne County, Georgia",1494,436,1304,431,190,202
1500000US133059703003,133059703003,"Block Group 3, Census Tract 9703, Wayne County, Georgia",1535,365,1398,339,137,126
1500000US133059703004,133059703004,"Block Group 4, Census Tract 9703, Wayne County, Georgia",806,212,753,208,53,44
1500000US133059704001,133059704001,"Block Group 1, Census Tract 9704, Wayne County, Georgia",1840,260,1671,202,169,180
1500000US133059704002,133059704002,"Block Group 2, Census Tract 9704, Wayne County, Georgia",1128,278,998,270,130,130
1500000US133059704003,133059704003,"Block Group 3, Census Tract 9704, Wayne County, Georgia",706,199,625,162,81,92
1500000US133059705001,133059705001,"Block Group 1, Census Tract 9705, Wayne County, Georgia",2778,382,2415,366,363,63
1500000US133059705002,133059705002,"Block Group 2, Census Tract 9705, Wayne County, Georgia",972,409,927,407,45,80
1500000US133059705003,133059705003,"Block Group 3, Census Tract 9705, Wayne County, Georgia",881,272,876,273,5,12
1500000US133059705004,133059705004,"Block Group 4, Census Tract 9705, Wayne County, Georgia",757,244,636,233,121,141
1500000US133059706001,133059706001,"Block Group 1, Census Tract 9706, Wayne County, Georgia",1975,414,1975,414,0,13
1500000US133059706002,133059706002,"Block Group 2, Census Tract 9706, Wayne County, Georgia",909,175,843,163,66,85
1500000US133059706003,133059706003,"Block Group 3, Census Tract 9706, Wayne County, Georgia",1106,229,1106,229,0,13
1500000US133079601001,133079601001,"Block Group 1, Census Tract 9601, Webster County, Georgia",1425,146,1399,138,26,41
1500000US133079602001,133079602001,"Block Group 1, Census Tract 9602, Webster County, Georgia",1295,146,1295,146,0,13
1500000US133097801001,133097801001,"Block Group 1, Census Tract 7801, Wheeler County, Georgia",644,139,644,139,0,13
1500000US133097801002,133097801002,"Block Group 2, Census Tract 7801, Wheeler County, Georgia",575,155,567,150,8,16
1500000US133097801003,133097801003,"Block Group 3, Census Tract 7801, Wheeler County, Georgia",916,223,916,223,0,13
1500000US133097802001,133097802001,"Block Group 1, Census Tract 7802, Wheeler County, Georgia",4072,301,3907,308,165,92
1500000US133097802002,133097802002,"Block Group 2, Census Tract 7802, Wheeler County, Georgia",1207,273,1207,273,0,13
1500000US133097802003,133097802003,"Block Group 3, Census Tract 7802, Wheeler County, Georgia",542,178,542,178,0,13
1500000US133119501001,133119501001,"Block Group 1, Census Tract 9501, White County, Georgia",1482,316,1482,316,0,13
1500000US133119501002,133119501002,"Block Group 2, Census Tract 9501, White County, Georgia",1272,239,1257,231,15,28
1500000US133119502011,133119502011,"Block Group 1, Census Tract 9502.01, White County, Georgia",2050,595,1890,593,160,166
1500000US133119502012,133119502012,"Block Group 2, Census Tract 9502.01, White County, Georgia",3201,596,3196,597,5,10
1500000US133119502013,133119502013,"Block Group 3, Census Tract 9502.01, White County, Georgia",3672,869,3521,865,151,180
1500000US133119502021,133119502021,"Block Group 1, Census Tract 9502.02, White County, Georgia",1343,242,1315,234,28,46
1500000US133119502022,133119502022,"Block Group 2, Census Tract 9502.02, White County, Georgia",1794,323,1794,323,0,13
1500000US133119502031,133119502031,"Block Group 1, Census Tract 9502.03, White County, Georgia",2854,565,2854,565,0,13
1500000US133119502032,133119502032,"Block Group 2, Census Tract 9502.03, White County, Georgia",2481,485,2481,485,0,13
1500000US133119503001,133119503001,"Block Group 1, Census Tract 9503, White County, Georgia",796,427,796,427,0,13
1500000US133119503002,133119503002,"Block Group 2, Census Tract 9503, White County, Georgia",4132,640,3989,622,143,126
1500000US133119503003,133119503003,"Block Group 3, Census Tract 9503, White County, Georgia",2714,539,2422,525,292,244
1500000US133130001011,133130001011,"Block Group 1, Census Tract 1.01, Whitfield County, Georgia",1196,330,1038,284,158,182
1500000US133130001012,133130001012,"Block Group 2, Census Tract 1.01, Whitfield County, Georgia",1665,490,1665,490,0,13
1500000US133130001013,133130001013,"Block Group 3, Census Tract 1.01, Whitfield County, Georgia",1133,290,1106,293,27,40
1500000US133130001021,133130001021,"Block Group 1, Census Tract 1.02, Whitfield County, Georgia",1102,280,882,197,220,218
1500000US133130001022,133130001022,"Block Group 2, Census Tract 1.02, Whitfield County, Georgia",3451,566,3206,498,245,192
1500000US133130001023,133130001023,"Block Group 3, Census Tract 1.02, Whitfield County, Georgia",1514,575,1457,570,57,61
1500000US133130001024,133130001024,"Block Group 4, Census Tract 1.02, Whitfield County, Georgia",2298,498,1198,373,1100,459
1500000US133130002001,133130002001,"Block Group 1, Census Tract 2, Whitfield County, Georgia",1916,455,1583,346,333,276
1500000US133130002002,133130002002,"Block Group 2, Census Tract 2, Whitfield County, Georgia",1001,240,992,241,9,12
1500000US133130002003,133130002003,"Block Group 3, Census Tract 2, Whitfield County, Georgia",1062,354,978,343,84,135
1500000US133130003011,133130003011,"Block Group 1, Census Tract 3.01, Whitfield County, Georgia",442,186,442,186,0,13
1500000US133130003012,133130003012,"Block Group 2, Census Tract 3.01, Whitfield County, Georgia",1094,341,805,304,289,187
1500000US133130003013,133130003013,"Block Group 3, Census Tract 3.01, Whitfield County, Georgia",2751,396,1282,360,1469,312
1500000US133130003021,133130003021,"Block Group 1, Census Tract 3.02, Whitfield County, Georgia",1226,469,864,364,362,331
1500000US133130003022,133130003022,"Block Group 2, Census Tract 3.02, Whitfield County, Georgia",3603,869,2793,663,810,596
1500000US133130003023,133130003023,"Block Group 3, Census Tract 3.02, Whitfield County, Georgia",1819,540,1445,545,374,285
1500000US133130003024,133130003024,"Block Group 4, Census Tract 3.02, Whitfield County, Georgia",2603,503,1792,344,811,431
1500000US133130004001,133130004001,"Block Group 1, Census Tract 4, Whitfield County, Georgia",905,468,649,302,256,367
1500000US133130004002,133130004002,"Block Group 2, Census Tract 4, Whitfield County, Georgia",1089,623,389,275,700,580
1500000US133130004003,133130004003,"Block Group 3, Census Tract 4, Whitfield County, Georgia",1194,522,467,184,727,457
1500000US133130004004,133130004004,"Block Group 4, Census Tract 4, Whitfield County, Georgia",2536,845,596,262,1940,879
1500000US133130004005,133130004005,"Block Group 5, Census Tract 4, Whitfield County, Georgia",1590,603,463,199,1127,615
1500000US133130004006,133130004006,"Block Group 6, Census Tract 4, Whitfield County, Georgia",547,238,264,146,283,233
1500000US133130005011,133130005011,"Block Group 1, Census Tract 5.01, Whitfield County, Georgia",965,493,599,294,366,378
1500000US133130005012,133130005012,"Block Group 2, Census Tract 5.01, Whitfield County, Georgia",2279,400,1817,378,462,201
1500000US133130005013,133130005013,"Block Group 3, Census Tract 5.01, Whitfield County, Georgia",974,270,811,232,163,197
1500000US133130005021,133130005021,"Block Group 1, Census Tract 5.02, Whitfield County, Georgia",1699,728,747,365,952,524
1500000US133130005022,133130005022,"Block Group 2, Census Tract 5.02, Whitfield County, Georgia",630,300,332,214,298,244
1500000US133130005023,133130005023,"Block Group 3, Census Tract 5.02, Whitfield County, Georgia",2278,649,1510,475,768,465
1500000US133130005024,133130005024,"Block Group 4, Census Tract 5.02, Whitfield County, Georgia",2269,555,1540,379,729,540
1500000US133130006001,133130006001,"Block Group 1, Census Tract 6, Whitfield County, Georgia",2112,341,2065,340,47,35
1500000US133130006002,133130006002,"Block Group 2, Census Tract 6, Whitfield County, Georgia",1293,415,987,334,306,313
1500000US133130006003,133130006003,"Block Group 3, Census Tract 6, Whitfield County, Georgia",868,276,649,175,219,227
1500000US133130007001,133130007001,"Block Group 1, Census Tract 7, Whitfield County, Georgia",1148,327,1095,315,53,96
1500000US133130007002,133130007002,"Block Group 2, Census Tract 7, Whitfield County, Georgia",1418,364,1418,364,0,13
1500000US133130007003,133130007003,"Block Group 3, Census Tract 7, Whitfield County, Georgia",1171,350,1142,347,29,30
1500000US133130007004,133130007004,"Block Group 4, Census Tract 7, Whitfield County, Georgia",1030,285,989,289,41,52
1500000US133130008001,133130008001,"Block Group 1, Census Tract 8, Whitfield County, Georgia",2899,605,2652,614,247,241
1500000US133130008002,133130008002,"Block Group 2, Census Tract 8, Whitfield County, Georgia",1435,384,1425,390,10,24
1500000US133130008003,133130008003,"Block Group 3, Census Tract 8, Whitfield County, Georgia",717,426,420,309,297,413
1500000US133130008004,133130008004,"Block Group 4, Census Tract 8, Whitfield County, Georgia",1151,354,1151,354,0,13
1500000US133130008005,133130008005,"Block Group 5, Census Tract 8, Whitfield County, Georgia",1598,500,1328,477,270,233
1500000US133130009001,133130009001,"Block Group 1, Census Tract 9, Whitfield County, Georgia",486,146,424,148,62,81
1500000US133130009002,133130009002,"Block Group 2, Census Tract 9, Whitfield County, Georgia",1595,244,1053,264,542,155
1500000US133130009003,133130009003,"Block Group 3, Census Tract 9, Whitfield County, Georgia",1644,331,1375,279,269,255
1500000US133130010001,133130010001,"Block Group 1, Census Tract 10, Whitfield County, Georgia",1944,662,602,218,1342,636
1500000US133130010002,133130010002,"Block Group 2, Census Tract 10, Whitfield County, Georgia",1509,420,302,150,1207,408
1500000US133130010003,133130010003,"Block Group 3, Census Tract 10, Whitfield County, Georgia",1041,435,223,108,818,444
1500000US133130011001,133130011001,"Block Group 1, Census Tract 11, Whitfield County, Georgia",592,219,468,154,124,166
1500000US133130011002,133130011002,"Block Group 2, Census Tract 11, Whitfield County, Georgia",1494,309,1022,212,472,273
1500000US133130011003,133130011003,"Block Group 3, Census Tract 11, Whitfield County, Georgia",1109,338,632,166,477,321
1500000US133130011004,133130011004,"Block Group 4, Census Tract 11, Whitfield County, Georgia",1838,498,401,154,1437,475
1500000US133130012001,133130012001,"Block Group 1, Census Tract 12, Whitfield County, Georgia",1517,476,987,303,530,363
1500000US133130012002,133130012002,"Block Group 2, Census Tract 12, Whitfield County, Georgia",1453,424,918,303,535,353
1500000US133130012003,133130012003,"Block Group 3, Census Tract 12, Whitfield County, Georgia",1637,534,728,338,909,480
1500000US133130012004,133130012004,"Block Group 4, Census Tract 12, Whitfield County, Georgia",1387,452,663,237,724,411
1500000US133130012005,133130012005,"Block Group 5, Census Tract 12, Whitfield County, Georgia",1081,469,437,246,644,433
1500000US133130012006,133130012006,"Block Group 6, Census Tract 12, Whitfield County, Georgia",763,453,48,62,715,452
1500000US133130013001,133130013001,"Block Group 1, Census Tract 13, Whitfield County, Georgia",2213,469,498,187,1715,473
1500000US133130013002,133130013002,"Block Group 2, Census Tract 13, Whitfield County, Georgia",499,272,164,90,335,256
1500000US133130013003,133130013003,"Block Group 3, Census Tract 13, Whitfield County, Georgia",1679,419,538,269,1141,411
1500000US133130014001,133130014001,"Block Group 1, Census Tract 14, Whitfield County, Georgia",1231,322,1146,347,85,132
1500000US133130014002,133130014002,"Block Group 2, Census Tract 14, Whitfield County, Georgia",1979,549,1145,347,834,508
1500000US133130014003,133130014003,"Block Group 3, Census Tract 14, Whitfield County, Georgia",1394,475,547,270,847,421
1500000US133130014004,133130014004,"Block Group 4, Census Tract 14, Whitfield County, Georgia",534,346,454,321,80,135
1500000US133130014005,133130014005,"Block Group 5, Census Tract 14, Whitfield County, Georgia",1527,928,480,155,1047,880
1500000US133130015001,133130015001,"Block Group 1, Census Tract 15, Whitfield County, Georgia",1013,291,983,283,30,38
1500000US133130015002,133130015002,"Block Group 2, Census Tract 15, Whitfield County, Georgia",814,287,695,254,119,100
1500000US133130015003,133130015003,"Block Group 3, Census Tract 15, Whitfield County, Georgia",896,359,812,338,84,124
1500000US133130015004,133130015004,"Block Group 4, Census Tract 15, Whitfield County, Georgia",1068,399,962,394,106,150
1500000US133130015005,133130015005,"Block Group 5, Census Tract 15, Whitfield County, Georgia",1848,538,1518,511,330,314
1500000US133159601001,133159601001,"Block Group 1, Census Tract 9601, Wilcox County, Georgia",3186,102,3097,107,89,56
1500000US133159601002,133159601002,"Block Group 2, Census Tract 9601, Wilcox County, Georgia",854,182,854,182,0,13
1500000US133159602001,133159602001,"Block Group 1, Census Tract 9602, Wilcox County, Georgia",1410,162,1376,169,34,36
1500000US133159603001,133159603001,"Block Group 1, Census Tract 9603, Wilcox County, Georgia",1431,188,1391,192,40,42
1500000US133159604001,133159604001,"Block Group 1, Census Tract 9604, Wilcox County, Georgia",1413,203,1386,205,27,39
1500000US133159604002,133159604002,"Block Group 2, Census Tract 9604, Wilcox County, Georgia",678,171,678,171,0,13
1500000US133170101011,133170101011,"Block Group 1, Census Tract 101.01, Wilkes County, Georgia",795,136,795,136,0,13
1500000US133170101012,133170101012,"Block Group 2, Census Tract 101.01, Wilkes County, Georgia",778,181,778,181,0,13
1500000US133170101021,133170101021,"Block Group 1, Census Tract 101.02, Wilkes County, Georgia",782,205,632,168,150,148
1500000US133170101022,133170101022,"Block Group 2, Census Tract 101.02, Wilkes County, Georgia",820,217,688,181,132,128
1500000US133170103011,133170103011,"Block Group 1, Census Tract 103.01, Wilkes County, Georgia",1228,234,1212,238,16,31
1500000US133170103012,133170103012,"Block Group 2, Census Tract 103.01, Wilkes County, Georgia",1065,213,1061,211,4,10
1500000US133170103021,133170103021,"Block Group 1, Census Tract 103.02, Wilkes County, Georgia",1533,255,1533,255,0,13
1500000US133170103022,133170103022,"Block Group 2, Census Tract 103.02, Wilkes County, Georgia",791,226,777,227,14,25
1500000US133170103023,133170103023,"Block Group 3, Census Tract 103.02, Wilkes County, Georgia",627,279,551,254,76,105
1500000US133170103024,133170103024,"Block Group 4, Census Tract 103.02, Wilkes County, Georgia",791,201,790,200,1,2
1500000US133170103025,133170103025,"Block Group 5, Census Tract 103.02, Wilkes County, Georgia",781,183,781,183,0,13
1500000US133199602001,133199602001,"Block Group 1, Census Tract 9602, Wilkinson County, Georgia",1392,263,1298,222,94,109
1500000US133199602002,133199602002,"Block Group 2, Census Tract 9602, Wilkinson County, Georgia",1055,211,966,183,89,103
1500000US133199602003,133199602003,"Block Group 3, Census Tract 9602, Wilkinson County, Georgia",749,152,746,152,3,4
1500000US133199603001,133199603001,"Block Group 1, Census Tract 9603, Wilkinson County, Georgia",662,192,652,193,10,16
1500000US133199603002,133199603002,"Block Group 2, Census Tract 9603, Wilkinson County, Georgia",1147,220,1147,220,0,13
1500000US133199603003,133199603003,"Block Group 3, Census Tract 9603, Wilkinson County, Georgia",1386,208,1382,208,4,7
1500000US133199603004,133199603004,"Block Group 4, Census Tract 9603, Wilkinson County, Georgia",1326,205,1310,210,16,29
1500000US133199604001,133199604001,"Block Group 1, Census Tract 9604, Wilkinson County, Georgia",1065,180,1060,179,5,11
1500000US133199604002,133199604002,"Block Group 2, Census Tract 9604, Wilkinson County, Georgia",604,106,582,106,22,31
1500000US133219501001,133219501001,"Block Group 1, Census Tract 9501, Worth County, Georgia",822,196,822,196,0,13
1500000US133219501002,133219501002,"Block Group 2, Census Tract 9501, Worth County, Georgia",2006,296,1957,280,49,76
1500000US133219502001,133219502001,"Block Group 1, Census Tract 9502, Worth County, Georgia",1715,479,1538,463,177,161
1500000US133219502002,133219502002,"Block Group 2, Census Tract 9502, Worth County, Georgia",2592,420,2494,413,98,118
1500000US133219502003,133219502003,"Block Group 3, Census Tract 9502, Worth County, Georgia",1304,366,1304,366,0,13
1500000US133219502004,133219502004,"Block Group 4, Census Tract 9502, Worth County, Georgia",1580,389,1547,400,33,61
1500000US133219504001,133219504001,"Block Group 1, Census Tract 9504, Worth County, Georgia",1905,349,1904,349,1,4
1500000US133219504002,133219504002,"Block Group 2, Census Tract 9504, Worth County, Georgia",651,183,644,181,7,16
1500000US133219504003,133219504003,"Block Group 3, Census Tract 9504, Worth County, Georgia",1012,230,989,233,23,37
1500000US133219504004,133219504004,"Block Group 4, Census Tract 9504, Worth County, Georgia",1253,301,1253,301,0,13
1500000US133219505001,133219505001,"Block Group 1, Census Tract 9505, Worth County, Georgia",1601,306,1595,304,6,14
1500000US133219505002,133219505002,"Block Group 2, Census Tract 9505, Worth County, Georgia",1134,377,1121,376,13,21
1500000US133219505003,133219505003,"Block Group 3, Census Tract 9505, Worth County, Georgia",1426,335,1419,336,7,11
1500000US133219506001,133219506001,"Block Group 1, Census Tract 9506, Worth County, Georgia",1295,305,1295,305,0,13
1500000US133219506002,133219506002,"Block Group 2, Census Tract 9506, Worth County, Georgia",860,298,831,292,29,52
