,ID,ID2,GEOGRAPHY,EST_T,EST_T_OWNER_OCCUPIED,EST_T_RENTER_OCCUPIED,PCT_EST_T_OWNER_OCCUPIED,PCT_EST_T_RENTER_OCCUPIED
0,1500000US130019501001,130019501001,"Block Group 1, Census Tract 9501, Appling County, Georgia",912,664,248,72.8070175439,27.1929824561
1,1500000US130019501002,130019501002,"Block Group 2, Census Tract 9501, Appling County, Georgia",2475,2086,389,84.2828282828,15.7171717172
2,1500000US130019502001,130019502001,"Block Group 1, Census Tract 9502, Appling County, Georgia",2036,1642,394,80.6483300589,19.3516699411
3,1500000US130019502002,130019502002,"Block Group 2, Census Tract 9502, Appling County, Georgia",1300,494,806,38.0,62.0
4,1500000US130019502003,130019502003,"Block Group 3, Census Tract 9502, Appling County, Georgia",1036,707,329,68.2432432432,31.7567567568
5,1500000US130019503001,130019503001,"Block Group 1, Census Tract 9503, Appling County, Georgia",708,172,536,24.2937853107,75.7062146893
6,1500000US130019503002,130019503002,"Block Group 2, Census Tract 9503, Appling County, Georgia",1585,581,1004,36.6561514196,63.3438485804
7,1500000US130019503003,130019503003,"Block Group 3, Census Tract 9503, Appling County, Georgia",983,474,509,48.2197355036,51.7802644964
8,1500000US130019503004,130019503004,"Block Group 4, Census Tract 9503, Appling County, Georgia",1460,1265,195,86.6438356164,13.3561643836
9,1500000US130019504001,130019504001,"Block Group 1, Census Tract 9504, Appling County, Georgia",755,600,155,79.4701986755,20.5298013245
10,1500000US130019504002,130019504002,"Block Group 2, Census Tract 9504, Appling County, Georgia",698,572,126,81.9484240688,18.0515759312
11,1500000US130019505001,130019505001,"Block Group 1, Census Tract 9505, Appling County, Georgia",695,500,195,71.9424460432,28.0575539568
12,1500000US130019505002,130019505002,"Block Group 2, Census Tract 9505, Appling County, Georgia",1627,1092,535,67.1173939766,32.8826060234
13,1500000US130019505003,130019505003,"Block Group 3, Census Tract 9505, Appling County, Georgia",1645,1203,442,73.1306990881,26.8693009119
14,1500000US130039601001,130039601001,"Block Group 1, Census Tract 9601, Atkinson County, Georgia",1031,773,258,74.9757516974,25.0242483026
15,1500000US130039601002,130039601002,"Block Group 2, Census Tract 9601, Atkinson County, Georgia",1054,773,281,73.339658444,26.660341556
16,1500000US130039602001,130039602001,"Block Group 1, Census Tract 9602, Atkinson County, Georgia",2046,1734,312,84.7507331378,15.2492668622
17,1500000US130039602002,130039602002,"Block Group 2, Census Tract 9602, Atkinson County, Georgia",1072,693,379,64.6455223881,35.3544776119
18,1500000US130039602003,130039602003,"Block Group 3, Census Tract 9602, Atkinson County, Georgia",1747,1006,741,57.5844304522,42.4155695478
19,1500000US130039603001,130039603001,"Block Group 1, Census Tract 9603, Atkinson County, Georgia",1307,1168,139,89.3649579189,10.6350420811
20,1500000US130059701001,130059701001,"Block Group 1, Census Tract 9701, Bacon County, Georgia",1527,1082,445,70.8578912901,29.1421087099
21,1500000US130059701002,130059701002,"Block Group 2, Census Tract 9701, Bacon County, Georgia",820,738,82,90.0,10.0
22,1500000US130059701003,130059701003,"Block Group 3, Census Tract 9701, Bacon County, Georgia",741,580,161,78.2726045884,21.7273954116
23,1500000US130059702011,130059702011,"Block Group 1, Census Tract 9702.01, Bacon County, Georgia",1557,1351,206,86.7694283879,13.2305716121
24,1500000US130059702012,130059702012,"Block Group 2, Census Tract 9702.01, Bacon County, Georgia",1161,738,423,63.5658914729,36.4341085271
25,1500000US130059702013,130059702013,"Block Group 3, Census Tract 9702.01, Bacon County, Georgia",1149,250,899,21.7580504787,78.2419495213
26,1500000US130059702021,130059702021,"Block Group 1, Census Tract 9702.02, Bacon County, Georgia",2324,1806,518,77.7108433735,22.2891566265
27,1500000US130059702022,130059702022,"Block Group 2, Census Tract 9702.02, Bacon County, Georgia",868,605,263,69.7004608295,30.2995391705
28,1500000US130059702023,130059702023,"Block Group 3, Census Tract 9702.02, Bacon County, Georgia",549,226,323,41.1657559199,58.8342440801
29,1500000US130079601001,130079601001,"Block Group 1, Census Tract 9601, Baker County, Georgia",815,509,306,62.4539877301,37.5460122699
30,1500000US130079601002,130079601002,"Block Group 2, Census Tract 9601, Baker County, Georgia",1394,956,438,68.5796269727,31.4203730273
31,1500000US130079602001,130079602001,"Block Group 1, Census Tract 9602, Baker County, Georgia",468,403,65,86.1111111111,13.8888888889
32,1500000US130079602002,130079602002,"Block Group 2, Census Tract 9602, Baker County, Georgia",615,525,90,85.3658536585,14.6341463415
33,1500000US130099701001,130099701001,"Block Group 1, Census Tract 9701, Baldwin County, Georgia",1461,1283,178,87.8165639973,12.1834360027
34,1500000US130099701002,130099701002,"Block Group 2, Census Tract 9701, Baldwin County, Georgia",1264,838,426,66.2974683544,33.7025316456
35,1500000US130099701003,130099701003,"Block Group 3, Census Tract 9701, Baldwin County, Georgia",2489,1967,522,79.0277219767,20.9722780233
36,1500000US130099702001,130099702001,"Block Group 1, Census Tract 9702, Baldwin County, Georgia",1025,493,532,48.0975609756,51.9024390244
37,1500000US130099702002,130099702002,"Block Group 2, Census Tract 9702, Baldwin County, Georgia",2291,1385,906,60.4539502401,39.5460497599
38,1500000US130099702003,130099702003,"Block Group 3, Census Tract 9702, Baldwin County, Georgia",2082,745,1337,35.7829010567,64.2170989433
39,1500000US130099702004,130099702004,"Block Group 4, Census Tract 9702, Baldwin County, Georgia",313,10,303,3.19488817891,96.8051118211
40,1500000US130099702005,130099702005,"Block Group 5, Census Tract 9702, Baldwin County, Georgia",784,114,670,14.5408163265,85.4591836735
41,1500000US130099703001,130099703001,"Block Group 1, Census Tract 9703, Baldwin County, Georgia",2826,2247,579,79.5116772824,20.4883227176
42,1500000US130099703002,130099703002,"Block Group 2, Census Tract 9703, Baldwin County, Georgia",3531,2260,1271,64.0045312943,35.9954687057
43,1500000US130099704001,130099704001,"Block Group 1, Census Tract 9704, Baldwin County, Georgia",1106,696,410,62.9294755877,37.0705244123
44,1500000US130099704002,130099704002,"Block Group 2, Census Tract 9704, Baldwin County, Georgia",1177,747,430,63.466440102,36.533559898
45,1500000US130099704003,130099704003,"Block Group 3, Census Tract 9704, Baldwin County, Georgia",998,413,585,41.3827655311,58.6172344689
46,1500000US130099704004,130099704004,"Block Group 4, Census Tract 9704, Baldwin County, Georgia",241,165,76,68.4647302905,31.5352697095
47,1500000US130099704005,130099704005,"Block Group 5, Census Tract 9704, Baldwin County, Georgia",1355,108,1247,7.9704797048,92.0295202952
48,1500000US130099705001,130099705001,"Block Group 1, Census Tract 9705, Baldwin County, Georgia",2960,314,2646,10.6081081081,89.3918918919
49,1500000US130099705002,130099705002,"Block Group 2, Census Tract 9705, Baldwin County, Georgia",396,138,258,34.8484848485,65.1515151515
50,1500000US130099705003,130099705003,"Block Group 3, Census Tract 9705, Baldwin County, Georgia",1739,1284,455,73.8355376653,26.1644623347
51,1500000US130099706001,130099706001,"Block Group 1, Census Tract 9706, Baldwin County, Georgia",1214,574,640,47.2817133443,52.7182866557
52,1500000US130099706002,130099706002,"Block Group 2, Census Tract 9706, Baldwin County, Georgia",857,229,628,26.7211201867,73.2788798133
53,1500000US130099706003,130099706003,"Block Group 3, Census Tract 9706, Baldwin County, Georgia",694,460,234,66.2824207493,33.7175792507
54,1500000US130099706004,130099706004,"Block Group 4, Census Tract 9706, Baldwin County, Georgia",732,359,373,49.043715847,50.956284153
55,1500000US130099707011,130099707011,"Block Group 1, Census Tract 9707.01, Baldwin County, Georgia",565,130,435,23.0088495575,76.9911504425
56,1500000US130099707012,130099707012,"Block Group 2, Census Tract 9707.01, Baldwin County, Georgia",440,143,297,32.5,67.5
57,1500000US130099707013,130099707013,"Block Group 3, Census Tract 9707.01, Baldwin County, Georgia",1320,248,1072,18.7878787879,81.2121212121
58,1500000US130099707021,130099707021,"Block Group 1, Census Tract 9707.02, Baldwin County, Georgia",1189,531,658,44.6593776283,55.3406223717
59,1500000US130099707022,130099707022,"Block Group 2, Census Tract 9707.02, Baldwin County, Georgia",563,223,340,39.6092362345,60.3907637655
60,1500000US130099708001,130099708001,"Block Group 1, Census Tract 9708, Baldwin County, Georgia",646,446,200,69.040247678,30.959752322
61,1500000US130099708002,130099708002,"Block Group 2, Census Tract 9708, Baldwin County, Georgia",3044,2574,470,84.5597897503,15.4402102497
62,1500000US130099708003,130099708003,"Block Group 3, Census Tract 9708, Baldwin County, Georgia",1251,1006,245,80.415667466,19.584332534
63,1500000US130099708004,130099708004,"Block Group 4, Census Tract 9708, Baldwin County, Georgia",1325,728,597,54.9433962264,45.0566037736
64,1500000US130119701001,130119701001,"Block Group 1, Census Tract 9701, Banks County, Georgia",2360,1693,667,71.7372881356,28.2627118644
65,1500000US130119701002,130119701002,"Block Group 2, Census Tract 9701, Banks County, Georgia",2909,2372,537,81.5400481265,18.4599518735
66,1500000US130119702001,130119702001,"Block Group 1, Census Tract 9702, Banks County, Georgia",2555,1702,853,66.614481409,33.385518591
67,1500000US130119702002,130119702002,"Block Group 2, Census Tract 9702, Banks County, Georgia",2458,1799,659,73.1895850285,26.8104149715
68,1500000US130119703001,130119703001,"Block Group 1, Census Tract 9703, Banks County, Georgia",1475,1222,253,82.8474576271,17.1525423729
69,1500000US130119703002,130119703002,"Block Group 2, Census Tract 9703, Banks County, Georgia",2691,2050,641,76.1798587886,23.8201412114
70,1500000US130119704001,130119704001,"Block Group 1, Census Tract 9704, Banks County, Georgia",3888,2925,963,75.2314814815,24.7685185185
71,1500000US130131801031,130131801031,"Block Group 1, Census Tract 1801.03, Barrow County, Georgia",4674,3961,713,84.7454000856,15.2545999144
72,1500000US130131801041,130131801041,"Block Group 1, Census Tract 1801.04, Barrow County, Georgia",1976,1468,508,74.2914979757,25.7085020243
73,1500000US130131801051,130131801051,"Block Group 1, Census Tract 1801.05, Barrow County, Georgia",2802,2545,257,90.8279800143,9.17201998572
74,1500000US130131801061,130131801061,"Block Group 1, Census Tract 1801.06, Barrow County, Georgia",1946,1190,756,61.1510791367,38.8489208633
75,1500000US130131801062,130131801062,"Block Group 2, Census Tract 1801.06, Barrow County, Georgia",885,610,275,68.9265536723,31.0734463277
76,1500000US130131801071,130131801071,"Block Group 1, Census Tract 1801.07, Barrow County, Georgia",1214,856,358,70.510708402,29.489291598
77,1500000US130131801072,130131801072,"Block Group 2, Census Tract 1801.07, Barrow County, Georgia",2639,1667,972,63.1678666161,36.8321333839
78,1500000US130131801081,130131801081,"Block Group 1, Census Tract 1801.08, Barrow County, Georgia",1568,1246,322,79.4642857143,20.5357142857
79,1500000US130131801082,130131801082,"Block Group 2, Census Tract 1801.08, Barrow County, Georgia",1634,987,647,60.4039167687,39.5960832313
80,1500000US130131802031,130131802031,"Block Group 1, Census Tract 1802.03, Barrow County, Georgia",1822,617,1205,33.8638858397,66.1361141603
81,1500000US130131802032,130131802032,"Block Group 2, Census Tract 1802.03, Barrow County, Georgia",1594,869,725,54.5169385194,45.4830614806
82,1500000US130131802041,130131802041,"Block Group 1, Census Tract 1802.04, Barrow County, Georgia",963,159,804,16.5109034268,83.4890965732
83,1500000US130131802042,130131802042,"Block Group 2, Census Tract 1802.04, Barrow County, Georgia",1560,904,656,57.9487179487,42.0512820513
84,1500000US130131802051,130131802051,"Block Group 1, Census Tract 1802.05, Barrow County, Georgia",1196,845,351,70.652173913,29.347826087
85,1500000US130131802052,130131802052,"Block Group 2, Census Tract 1802.05, Barrow County, Georgia",653,158,495,24.1960183767,75.8039816233
86,1500000US130131802053,130131802053,"Block Group 3, Census Tract 1802.05, Barrow County, Georgia",2504,735,1769,29.3530351438,70.6469648562
87,1500000US130131802061,130131802061,"Block Group 1, Census Tract 1802.06, Barrow County, Georgia",1358,774,584,56.9955817378,43.0044182622
88,1500000US130131802062,130131802062,"Block Group 2, Census Tract 1802.06, Barrow County, Georgia",1358,612,746,45.0662739323,54.9337260677
89,1500000US130131803011,130131803011,"Block Group 1, Census Tract 1803.01, Barrow County, Georgia",2167,1770,397,81.6797415782,18.3202584218
90,1500000US130131803021,130131803021,"Block Group 1, Census Tract 1803.02, Barrow County, Georgia",2276,1449,827,63.6643233743,36.3356766257
91,1500000US130131803022,130131803022,"Block Group 2, Census Tract 1803.02, Barrow County, Georgia",3231,2483,748,76.849272671,23.150727329
92,1500000US130131803031,130131803031,"Block Group 1, Census Tract 1803.03, Barrow County, Georgia",2334,2003,331,85.8183376178,14.1816623822
93,1500000US130131803032,130131803032,"Block Group 2, Census Tract 1803.03, Barrow County, Georgia",1980,1248,732,63.0303030303,36.9696969697
94,1500000US130131804011,130131804011,"Block Group 1, Census Tract 1804.01, Barrow County, Georgia",1852,1600,252,86.3930885529,13.6069114471
95,1500000US130131804012,130131804012,"Block Group 2, Census Tract 1804.01, Barrow County, Georgia",3616,2664,952,73.6725663717,26.3274336283
96,1500000US130131804021,130131804021,"Block Group 1, Census Tract 1804.02, Barrow County, Georgia",1197,425,772,35.5054302423,64.4945697577
97,1500000US130131804022,130131804022,"Block Group 2, Census Tract 1804.02, Barrow County, Georgia",4149,2738,1411,65.9918052543,34.0081947457
98,1500000US130131804023,130131804023,"Block Group 3, Census Tract 1804.02, Barrow County, Georgia",747,568,179,76.0374832664,23.9625167336
99,1500000US130131805011,130131805011,"Block Group 1, Census Tract 1805.01, Barrow County, Georgia",5718,4336,1382,75.8307100385,24.1692899615
100,1500000US130131805021,130131805021,"Block Group 1, Census Tract 1805.02, Barrow County, Georgia",1667,1360,307,81.5836832633,18.4163167367
101,1500000US130131805022,130131805022,"Block Group 2, Census Tract 1805.02, Barrow County, Georgia",1451,1170,281,80.6340454859,19.3659545141
102,1500000US130131805023,130131805023,"Block Group 3, Census Tract 1805.02, Barrow County, Georgia",1064,507,557,47.6503759398,52.3496240602
103,1500000US130131805024,130131805024,"Block Group 4, Census Tract 1805.02, Barrow County, Georgia",366,285,81,77.868852459,22.131147541
104,1500000US130131805031,130131805031,"Block Group 1, Census Tract 1805.03, Barrow County, Georgia",5592,4671,921,83.5300429185,16.4699570815
105,1500000US130159601011,130159601011,"Block Group 1, Census Tract 9601.01, Bartow County, Georgia",1474,1134,340,76.9335142469,23.0664857531
106,1500000US130159601021,130159601021,"Block Group 1, Census Tract 9601.02, Bartow County, Georgia",3913,3222,691,82.3409148991,17.6590851009
107,1500000US130159601022,130159601022,"Block Group 2, Census Tract 9601.02, Bartow County, Georgia",2919,2228,691,76.327509421,23.672490579
108,1500000US130159601023,130159601023,"Block Group 3, Census Tract 9601.02, Bartow County, Georgia",2386,1897,489,79.5054484493,20.4945515507
109,1500000US130159602001,130159602001,"Block Group 1, Census Tract 9602, Bartow County, Georgia",2727,2081,646,76.3109644298,23.6890355702
110,1500000US130159602002,130159602002,"Block Group 2, Census Tract 9602, Bartow County, Georgia",1029,197,832,19.1448007775,80.8551992225
111,1500000US130159602003,130159602003,"Block Group 3, Census Tract 9602, Bartow County, Georgia",2579,2061,518,79.9146956185,20.0853043815
112,1500000US130159602004,130159602004,"Block Group 4, Census Tract 9602, Bartow County, Georgia",3146,1929,1217,61.3159567705,38.6840432295
113,1500000US130159602005,130159602005,"Block Group 5, Census Tract 9602, Bartow County, Georgia",2260,1482,778,65.5752212389,34.4247787611
114,1500000US130159603001,130159603001,"Block Group 1, Census Tract 9603, Bartow County, Georgia",3139,2249,890,71.6470213444,28.3529786556
115,1500000US130159603002,130159603002,"Block Group 2, Census Tract 9603, Bartow County, Georgia",3501,2814,687,80.3770351328,19.6229648672
116,1500000US130159604011,130159604011,"Block Group 1, Census Tract 9604.01, Bartow County, Georgia",1259,925,334,73.4710087371,26.5289912629
117,1500000US130159604012,130159604012,"Block Group 2, Census Tract 9604.01, Bartow County, Georgia",4471,1098,3373,24.5582643704,75.4417356296
118,1500000US130159604013,130159604013,"Block Group 3, Census Tract 9604.01, Bartow County, Georgia",3565,2364,1201,66.3113604488,33.6886395512
119,1500000US130159604021,130159604021,"Block Group 1, Census Tract 9604.02, Bartow County, Georgia",1627,1215,412,74.6773202213,25.3226797787
120,1500000US130159604022,130159604022,"Block Group 2, Census Tract 9604.02, Bartow County, Georgia",3594,1743,1851,48.4974958264,51.5025041736
121,1500000US130159604023,130159604023,"Block Group 3, Census Tract 9604.02, Bartow County, Georgia",3190,1568,1622,49.1536050157,50.8463949843
122,1500000US130159605001,130159605001,"Block Group 1, Census Tract 9605, Bartow County, Georgia",1342,774,568,57.6751117735,42.3248882265
123,1500000US130159605002,130159605002,"Block Group 2, Census Tract 9605, Bartow County, Georgia",1317,724,593,54.9734244495,45.0265755505
124,1500000US130159605003,130159605003,"Block Group 3, Census Tract 9605, Bartow County, Georgia",1779,687,1092,38.6172006745,61.3827993255
125,1500000US130159605004,130159605004,"Block Group 4, Census Tract 9605, Bartow County, Georgia",3708,1569,2139,42.3139158576,57.6860841424
126,1500000US130159606001,130159606001,"Block Group 1, Census Tract 9606, Bartow County, Georgia",2025,726,1299,35.8518518519,64.1481481481
127,1500000US130159606002,130159606002,"Block Group 2, Census Tract 9606, Bartow County, Georgia",487,163,324,33.4702258727,66.5297741273
128,1500000US130159606003,130159606003,"Block Group 3, Census Tract 9606, Bartow County, Georgia",872,523,349,59.9770642202,40.0229357798
129,1500000US130159606004,130159606004,"Block Group 4, Census Tract 9606, Bartow County, Georgia",1408,576,832,40.9090909091,59.0909090909
130,1500000US130159606005,130159606005,"Block Group 5, Census Tract 9606, Bartow County, Georgia",4003,2684,1319,67.0497127155,32.9502872845
131,1500000US130159606006,130159606006,"Block Group 6, Census Tract 9606, Bartow County, Georgia",507,331,176,65.2859960552,34.7140039448
132,1500000US130159607001,130159607001,"Block Group 1, Census Tract 9607, Bartow County, Georgia",1655,1007,648,60.8459214502,39.1540785498
133,1500000US130159607002,130159607002,"Block Group 2, Census Tract 9607, Bartow County, Georgia",2143,1080,1063,50.396640224,49.603359776
134,1500000US130159607003,130159607003,"Block Group 3, Census Tract 9607, Bartow County, Georgia",1912,856,1056,44.769874477,55.230125523
135,1500000US130159607004,130159607004,"Block Group 4, Census Tract 9607, Bartow County, Georgia",887,193,694,21.7587373168,78.2412626832
136,1500000US130159607005,130159607005,"Block Group 5, Census Tract 9607, Bartow County, Georgia",422,61,361,14.4549763033,85.5450236967
137,1500000US130159608011,130159608011,"Block Group 1, Census Tract 9608.01, Bartow County, Georgia",1152,960,192,83.3333333333,16.6666666667
138,1500000US130159608012,130159608012,"Block Group 2, Census Tract 9608.01, Bartow County, Georgia",2333,1825,508,78.2254607801,21.7745392199
139,1500000US130159608021,130159608021,"Block Group 1, Census Tract 9608.02, Bartow County, Georgia",1712,1035,677,60.4556074766,39.5443925234
140,1500000US130159608022,130159608022,"Block Group 2, Census Tract 9608.02, Bartow County, Georgia",1106,939,167,84.9005424955,15.0994575045
141,1500000US130159608031,130159608031,"Block Group 1, Census Tract 9608.03, Bartow County, Georgia",1739,1283,456,73.7780333525,26.2219666475
142,1500000US130159608032,130159608032,"Block Group 2, Census Tract 9608.03, Bartow County, Georgia",1181,454,727,38.4419983065,61.5580016935
143,1500000US130159608033,130159608033,"Block Group 3, Census Tract 9608.03, Bartow County, Georgia",2785,1935,850,69.4793536804,30.5206463196
144,1500000US130159609011,130159609011,"Block Group 1, Census Tract 9609.01, Bartow County, Georgia",975,460,515,47.1794871795,52.8205128205
145,1500000US130159609012,130159609012,"Block Group 2, Census Tract 9609.01, Bartow County, Georgia",2261,1808,453,79.9646174259,20.0353825741
146,1500000US130159609021,130159609021,"Block Group 1, Census Tract 9609.02, Bartow County, Georgia",2467,1916,551,77.665180381,22.334819619
147,1500000US130159609022,130159609022,"Block Group 2, Census Tract 9609.02, Bartow County, Georgia",943,725,218,76.882290562,23.117709438
148,1500000US130159609023,130159609023,"Block Group 3, Census Tract 9609.02, Bartow County, Georgia",1044,1044,0,100.0,0.0
149,1500000US130159609024,130159609024,"Block Group 4, Census Tract 9609.02, Bartow County, Georgia",1850,1295,555,70.0,30.0
150,1500000US130159610001,130159610001,"Block Group 1, Census Tract 9610, Bartow County, Georgia",770,713,57,92.5974025974,7.4025974026
151,1500000US130159610002,130159610002,"Block Group 2, Census Tract 9610, Bartow County, Georgia",1922,1532,390,79.7086368366,20.2913631634
152,1500000US130159610003,130159610003,"Block Group 3, Census Tract 9610, Bartow County, Georgia",2409,2294,115,95.2262349523,4.77376504774
153,1500000US130159610004,130159610004,"Block Group 4, Census Tract 9610, Bartow County, Georgia",2576,2184,392,84.7826086957,15.2173913043
154,1500000US130179601001,130179601001,"Block Group 1, Census Tract 9601, Ben Hill County, Georgia",2674,2418,256,90.4263275991,9.5736724009
155,1500000US130179602001,130179602001,"Block Group 1, Census Tract 9602, Ben Hill County, Georgia",1730,1500,230,86.7052023121,13.2947976879
156,1500000US130179603001,130179603001,"Block Group 1, Census Tract 9603, Ben Hill County, Georgia",1165,734,431,63.0042918455,36.9957081545
157,1500000US130179603002,130179603002,"Block Group 2, Census Tract 9603, Ben Hill County, Georgia",533,217,316,40.712945591,59.287054409
158,1500000US130179603003,130179603003,"Block Group 3, Census Tract 9603, Ben Hill County, Georgia",1075,260,815,24.1860465116,75.8139534884
159,1500000US130179603004,130179603004,"Block Group 4, Census Tract 9603, Ben Hill County, Georgia",521,379,142,72.7447216891,27.2552783109
160,1500000US130179604001,130179604001,"Block Group 1, Census Tract 9604, Ben Hill County, Georgia",1699,798,901,46.9688051795,53.0311948205
161,1500000US130179604002,130179604002,"Block Group 2, Census Tract 9604, Ben Hill County, Georgia",1104,461,643,41.7572463768,58.2427536232
162,1500000US130179604003,130179604003,"Block Group 3, Census Tract 9604, Ben Hill County, Georgia",248,214,34,86.2903225806,13.7096774194
163,1500000US130179604004,130179604004,"Block Group 4, Census Tract 9604, Ben Hill County, Georgia",858,595,263,69.3473193473,30.6526806527
164,1500000US130179605001,130179605001,"Block Group 1, Census Tract 9605, Ben Hill County, Georgia",1231,1131,100,91.8765231519,8.12347684809
165,1500000US130179605002,130179605002,"Block Group 2, Census Tract 9605, Ben Hill County, Georgia",1199,589,610,49.1242702252,50.8757297748
166,1500000US130179605003,130179605003,"Block Group 3, Census Tract 9605, Ben Hill County, Georgia",1054,777,277,73.7191650854,26.2808349146
167,1500000US130179605004,130179605004,"Block Group 4, Census Tract 9605, Ben Hill County, Georgia",1162,395,767,33.9931153184,66.0068846816
168,1500000US130179605005,130179605005,"Block Group 5, Census Tract 9605, Ben Hill County, Georgia",912,632,280,69.298245614,30.701754386
169,1500000US130199701001,130199701001,"Block Group 1, Census Tract 9701, Berrien County, Georgia",850,769,81,90.4705882353,9.52941176471
170,1500000US130199701002,130199701002,"Block Group 2, Census Tract 9701, Berrien County, Georgia",994,768,226,77.2635814889,22.7364185111
171,1500000US130199702001,130199702001,"Block Group 1, Census Tract 9702, Berrien County, Georgia",2022,1168,854,57.7645895153,42.2354104847
172,1500000US130199702002,130199702002,"Block Group 2, Census Tract 9702, Berrien County, Georgia",1834,1314,520,71.6466739368,28.3533260632
173,1500000US130199703001,130199703001,"Block Group 1, Census Tract 9703, Berrien County, Georgia",1037,923,114,89.0067502411,10.9932497589
174,1500000US130199703002,130199703002,"Block Group 2, Census Tract 9703, Berrien County, Georgia",1205,980,225,81.3278008299,18.6721991701
175,1500000US130199703003,130199703003,"Block Group 3, Census Tract 9703, Berrien County, Georgia",911,445,466,48.8474204171,51.1525795829
176,1500000US130199704001,130199704001,"Block Group 1, Census Tract 9704, Berrien County, Georgia",843,572,271,67.8529062871,32.1470937129
177,1500000US130199704002,130199704002,"Block Group 2, Census Tract 9704, Berrien County, Georgia",803,577,226,71.8555417186,28.1444582814
178,1500000US130199704003,130199704003,"Block Group 3, Census Tract 9704, Berrien County, Georgia",1217,733,484,60.2300739523,39.7699260477
179,1500000US130199705001,130199705001,"Block Group 1, Census Tract 9705, Berrien County, Georgia",751,497,254,66.1784287617,33.8215712383
180,1500000US130199705002,130199705002,"Block Group 2, Census Tract 9705, Berrien County, Georgia",2627,2138,489,81.3856109631,18.6143890369
181,1500000US130199706001,130199706001,"Block Group 1, Census Tract 9706, Berrien County, Georgia",1198,1155,43,96.4106844741,3.58931552588
182,1500000US130199706002,130199706002,"Block Group 2, Census Tract 9706, Berrien County, Georgia",1697,1113,584,65.5863288156,34.4136711844
183,1500000US130199706003,130199706003,"Block Group 3, Census Tract 9706, Berrien County, Georgia",852,440,412,51.6431924883,48.3568075117
184,1500000US130210101001,130210101001,"Block Group 1, Census Tract 101, Bibb County, Georgia",630,166,464,26.3492063492,73.6507936508
185,1500000US130210101002,130210101002,"Block Group 2, Census Tract 101, Bibb County, Georgia",865,200,665,23.1213872832,76.8786127168
186,1500000US130210102001,130210102001,"Block Group 1, Census Tract 102, Bibb County, Georgia",420,74,346,17.619047619,82.380952381
187,1500000US130210102002,130210102002,"Block Group 2, Census Tract 102, Bibb County, Georgia",572,198,374,34.6153846154,65.3846153846
188,1500000US130210102003,130210102003,"Block Group 3, Census Tract 102, Bibb County, Georgia",949,623,326,65.6480505796,34.3519494204
189,1500000US130210103001,130210103001,"Block Group 1, Census Tract 103, Bibb County, Georgia",764,414,350,54.1884816754,45.8115183246
190,1500000US130210104001,130210104001,"Block Group 1, Census Tract 104, Bibb County, Georgia",421,130,291,30.8788598575,69.1211401425
191,1500000US130210104002,130210104002,"Block Group 2, Census Tract 104, Bibb County, Georgia",354,64,290,18.0790960452,81.9209039548
192,1500000US130210104003,130210104003,"Block Group 3, Census Tract 104, Bibb County, Georgia",588,239,349,40.6462585034,59.3537414966
193,1500000US130210104004,130210104004,"Block Group 4, Census Tract 104, Bibb County, Georgia",806,286,520,35.4838709677,64.5161290323
194,1500000US130210105001,130210105001,"Block Group 1, Census Tract 105, Bibb County, Georgia",1285,209,1076,16.2645914397,83.7354085603
195,1500000US130210105002,130210105002,"Block Group 2, Census Tract 105, Bibb County, Georgia",446,59,387,13.2286995516,86.7713004484
196,1500000US130210108001,130210108001,"Block Group 1, Census Tract 108, Bibb County, Georgia",1459,499,960,34.2015078821,65.7984921179
197,1500000US130210110001,130210110001,"Block Group 1, Census Tract 110, Bibb County, Georgia",487,470,17,96.5092402464,3.49075975359
198,1500000US130210110002,130210110002,"Block Group 2, Census Tract 110, Bibb County, Georgia",1890,289,1601,15.291005291,84.708994709
199,1500000US130210110003,130210110003,"Block Group 3, Census Tract 110, Bibb County, Georgia",615,486,129,79.0243902439,20.9756097561
200,1500000US130210110004,130210110004,"Block Group 4, Census Tract 110, Bibb County, Georgia",674,0,674,0.0,100.0
201,1500000US130210110005,130210110005,"Block Group 5, Census Tract 110, Bibb County, Georgia",905,483,422,53.3701657459,46.6298342541
202,1500000US130210111001,130210111001,"Block Group 1, Census Tract 111, Bibb County, Georgia",854,221,633,25.8782201405,74.1217798595
203,1500000US130210111002,130210111002,"Block Group 2, Census Tract 111, Bibb County, Georgia",665,151,514,22.7067669173,77.2932330827
204,1500000US130210111003,130210111003,"Block Group 3, Census Tract 111, Bibb County, Georgia",391,100,291,25.5754475703,74.4245524297
205,1500000US130210115001,130210115001,"Block Group 1, Census Tract 115, Bibb County, Georgia",504,245,259,48.6111111111,51.3888888889
206,1500000US130210115002,130210115002,"Block Group 2, Census Tract 115, Bibb County, Georgia",622,105,517,16.8810289389,83.1189710611
207,1500000US130210117011,130210117011,"Block Group 1, Census Tract 117.01, Bibb County, Georgia",1092,598,494,54.7619047619,45.2380952381
208,1500000US130210117012,130210117012,"Block Group 2, Census Tract 117.01, Bibb County, Georgia",1426,605,821,42.4263674614,57.5736325386
209,1500000US130210117021,130210117021,"Block Group 1, Census Tract 117.02, Bibb County, Georgia",555,250,305,45.045045045,54.954954955
210,1500000US130210117022,130210117022,"Block Group 2, Census Tract 117.02, Bibb County, Georgia",759,550,209,72.4637681159,27.5362318841
211,1500000US130210117023,130210117023,"Block Group 3, Census Tract 117.02, Bibb County, Georgia",871,475,396,54.5350172216,45.4649827784
212,1500000US130210117024,130210117024,"Block Group 4, Census Tract 117.02, Bibb County, Georgia",880,280,600,31.8181818182,68.1818181818
213,1500000US130210117025,130210117025,"Block Group 5, Census Tract 117.02, Bibb County, Georgia",815,467,348,57.3006134969,42.6993865031
214,1500000US130210117026,130210117026,"Block Group 6, Census Tract 117.02, Bibb County, Georgia",586,486,100,82.9351535836,17.0648464164
215,1500000US130210118001,130210118001,"Block Group 1, Census Tract 118, Bibb County, Georgia",1201,389,812,32.3896752706,67.6103247294
216,1500000US130210118002,130210118002,"Block Group 2, Census Tract 118, Bibb County, Georgia",751,525,226,69.9067909454,30.0932090546
217,1500000US130210118003,130210118003,"Block Group 3, Census Tract 118, Bibb County, Georgia",378,119,259,31.4814814815,68.5185185185
218,1500000US130210118004,130210118004,"Block Group 4, Census Tract 118, Bibb County, Georgia",1110,813,297,73.2432432432,26.7567567568
219,1500000US130210119001,130210119001,"Block Group 1, Census Tract 119, Bibb County, Georgia",426,43,383,10.0938967136,89.9061032864
220,1500000US130210119002,130210119002,"Block Group 2, Census Tract 119, Bibb County, Georgia",859,285,574,33.1781140861,66.8218859139
221,1500000US130210119003,130210119003,"Block Group 3, Census Tract 119, Bibb County, Georgia",547,185,362,33.8208409506,66.1791590494
222,1500000US130210120001,130210120001,"Block Group 1, Census Tract 120, Bibb County, Georgia",964,617,347,64.0041493776,35.9958506224
223,1500000US130210120002,130210120002,"Block Group 2, Census Tract 120, Bibb County, Georgia",689,606,83,87.9535558781,12.0464441219
224,1500000US130210120003,130210120003,"Block Group 3, Census Tract 120, Bibb County, Georgia",1367,1151,216,84.1989758595,15.8010241405
225,1500000US130210120004,130210120004,"Block Group 4, Census Tract 120, Bibb County, Georgia",1366,1035,331,75.7686676428,24.2313323572
226,1500000US130210121011,130210121011,"Block Group 1, Census Tract 121.01, Bibb County, Georgia",1703,1112,591,65.2965355255,34.7034644745
227,1500000US130210121021,130210121021,"Block Group 1, Census Tract 121.02, Bibb County, Georgia",1720,933,787,54.2441860465,45.7558139535
228,1500000US130210121022,130210121022,"Block Group 2, Census Tract 121.02, Bibb County, Georgia",1950,1373,577,70.4102564103,29.5897435897
229,1500000US130210121023,130210121023,"Block Group 3, Census Tract 121.02, Bibb County, Georgia",1333,766,567,57.4643660915,42.5356339085
230,1500000US130210122001,130210122001,"Block Group 1, Census Tract 122, Bibb County, Georgia",970,158,812,16.2886597938,83.7113402062
231,1500000US130210122002,130210122002,"Block Group 2, Census Tract 122, Bibb County, Georgia",1410,868,542,61.5602836879,38.4397163121
232,1500000US130210123001,130210123001,"Block Group 1, Census Tract 123, Bibb County, Georgia",895,248,647,27.7094972067,72.2905027933
233,1500000US130210123002,130210123002,"Block Group 2, Census Tract 123, Bibb County, Georgia",377,92,285,24.4031830239,75.5968169761
234,1500000US130210123003,130210123003,"Block Group 3, Census Tract 123, Bibb County, Georgia",1265,601,664,47.5098814229,52.4901185771
235,1500000US130210124001,130210124001,"Block Group 1, Census Tract 124, Bibb County, Georgia",1593,386,1207,24.2310106717,75.7689893283
236,1500000US130210124002,130210124002,"Block Group 2, Census Tract 124, Bibb County, Georgia",1135,589,546,51.8942731278,48.1057268722
237,1500000US130210124003,130210124003,"Block Group 3, Census Tract 124, Bibb County, Georgia",897,367,530,40.9141583055,59.0858416945
238,1500000US130210124004,130210124004,"Block Group 4, Census Tract 124, Bibb County, Georgia",579,536,43,92.573402418,7.42659758204
239,1500000US130210125001,130210125001,"Block Group 1, Census Tract 125, Bibb County, Georgia",776,311,465,40.0773195876,59.9226804124
240,1500000US130210125002,130210125002,"Block Group 2, Census Tract 125, Bibb County, Georgia",1045,393,652,37.6076555024,62.3923444976
241,1500000US130210125003,130210125003,"Block Group 3, Census Tract 125, Bibb County, Georgia",1185,339,846,28.6075949367,71.3924050633
242,1500000US130210126001,130210126001,"Block Group 1, Census Tract 126, Bibb County, Georgia",1637,813,824,49.664019548,50.335980452
243,1500000US130210126002,130210126002,"Block Group 2, Census Tract 126, Bibb County, Georgia",646,505,141,78.173374613,21.826625387
244,1500000US130210126003,130210126003,"Block Group 3, Census Tract 126, Bibb County, Georgia",1312,536,776,40.8536585366,59.1463414634
245,1500000US130210126004,130210126004,"Block Group 4, Census Tract 126, Bibb County, Georgia",1275,690,585,54.1176470588,45.8823529412
246,1500000US130210127001,130210127001,"Block Group 1, Census Tract 127, Bibb County, Georgia",956,140,816,14.6443514644,85.3556485356
247,1500000US130210127002,130210127002,"Block Group 2, Census Tract 127, Bibb County, Georgia",778,232,546,29.8200514139,70.1799485861
248,1500000US130210127003,130210127003,"Block Group 3, Census Tract 127, Bibb County, Georgia",423,310,113,73.2860520095,26.7139479905
249,1500000US130210128001,130210128001,"Block Group 1, Census Tract 128, Bibb County, Georgia",2049,627,1422,30.6002928258,69.3997071742
250,1500000US130210128002,130210128002,"Block Group 2, Census Tract 128, Bibb County, Georgia",1137,283,854,24.8900615655,75.1099384345
251,1500000US130210128003,130210128003,"Block Group 3, Census Tract 128, Bibb County, Georgia",396,122,274,30.8080808081,69.1919191919
252,1500000US130210129001,130210129001,"Block Group 1, Census Tract 129, Bibb County, Georgia",932,153,779,16.4163090129,83.5836909871
253,1500000US130210129002,130210129002,"Block Group 2, Census Tract 129, Bibb County, Georgia",767,307,460,40.0260756193,59.9739243807
254,1500000US130210131011,130210131011,"Block Group 1, Census Tract 131.01, Bibb County, Georgia",2693,1270,1423,47.1593018938,52.8406981062
255,1500000US130210131012,130210131012,"Block Group 2, Census Tract 131.01, Bibb County, Georgia",1581,571,1010,36.1163820367,63.8836179633
256,1500000US130210131013,130210131013,"Block Group 3, Census Tract 131.01, Bibb County, Georgia",1482,275,1207,18.5560053981,81.4439946019
257,1500000US130210131021,130210131021,"Block Group 1, Census Tract 131.02, Bibb County, Georgia",466,348,118,74.678111588,25.321888412
258,1500000US130210131022,130210131022,"Block Group 2, Census Tract 131.02, Bibb County, Georgia",2087,1208,879,57.8821274557,42.1178725443
259,1500000US130210131023,130210131023,"Block Group 3, Census Tract 131.02, Bibb County, Georgia",1072,447,625,41.697761194,58.302238806
260,1500000US130210131024,130210131024,"Block Group 4, Census Tract 131.02, Bibb County, Georgia",653,355,298,54.3644716692,45.6355283308
261,1500000US130210132011,130210132011,"Block Group 1, Census Tract 132.01, Bibb County, Georgia",764,174,590,22.7748691099,77.2251308901
262,1500000US130210132012,130210132012,"Block Group 2, Census Tract 132.01, Bibb County, Georgia",3342,1241,2101,37.1334530221,62.8665469779
263,1500000US130210132013,130210132013,"Block Group 3, Census Tract 132.01, Bibb County, Georgia",1175,192,983,16.3404255319,83.6595744681
264,1500000US130210132014,130210132014,"Block Group 4, Census Tract 132.01, Bibb County, Georgia",759,350,409,46.1133069829,53.8866930171
265,1500000US130210132021,130210132021,"Block Group 1, Census Tract 132.02, Bibb County, Georgia",1035,287,748,27.729468599,72.270531401
266,1500000US130210132022,130210132022,"Block Group 2, Census Tract 132.02, Bibb County, Georgia",854,140,714,16.393442623,83.606557377
267,1500000US130210132023,130210132023,"Block Group 3, Census Tract 132.02, Bibb County, Georgia",1025,447,578,43.6097560976,56.3902439024
268,1500000US130210133021,130210133021,"Block Group 1, Census Tract 133.02, Bibb County, Georgia",438,154,284,35.1598173516,64.8401826484
269,1500000US130210133022,130210133022,"Block Group 2, Census Tract 133.02, Bibb County, Georgia",826,658,168,79.6610169492,20.3389830508
270,1500000US130210133023,130210133023,"Block Group 3, Census Tract 133.02, Bibb County, Georgia",761,464,297,60.9724047306,39.0275952694
271,1500000US130210133024,130210133024,"Block Group 4, Census Tract 133.02, Bibb County, Georgia",1720,1476,244,85.8139534884,14.1860465116
272,1500000US130210134071,130210134071,"Block Group 1, Census Tract 134.07, Bibb County, Georgia",2057,1385,672,67.3310646573,32.6689353427
273,1500000US130210134072,130210134072,"Block Group 2, Census Tract 134.07, Bibb County, Georgia",1578,282,1296,17.8707224335,82.1292775665
274,1500000US130210134073,130210134073,"Block Group 3, Census Tract 134.07, Bibb County, Georgia",1038,642,396,61.8497109827,38.1502890173
275,1500000US130210134081,130210134081,"Block Group 1, Census Tract 134.08, Bibb County, Georgia",3394,2966,428,87.3895109016,12.6104890984
276,1500000US130210134082,130210134082,"Block Group 2, Census Tract 134.08, Bibb County, Georgia",1141,1041,100,91.2357581069,8.76424189308
277,1500000US130210134091,130210134091,"Block Group 1, Census Tract 134.09, Bibb County, Georgia",2201,1427,774,64.8341662881,35.1658337119
278,1500000US130210134092,130210134092,"Block Group 2, Census Tract 134.09, Bibb County, Georgia",1618,729,889,45.0556242274,54.9443757726
279,1500000US130210134101,130210134101,"Block Group 1, Census Tract 134.10, Bibb County, Georgia",1733,1582,151,91.2867859204,8.71321407963
280,1500000US130210134102,130210134102,"Block Group 2, Census Tract 134.10, Bibb County, Georgia",1976,1619,357,81.9331983806,18.0668016194
281,1500000US130210134103,130210134103,"Block Group 3, Census Tract 134.10, Bibb County, Georgia",1442,1151,291,79.8196948682,20.1803051318
282,1500000US130210134111,130210134111,"Block Group 1, Census Tract 134.11, Bibb County, Georgia",1333,208,1125,15.6039009752,84.3960990248
283,1500000US130210134112,130210134112,"Block Group 2, Census Tract 134.11, Bibb County, Georgia",2435,1207,1228,49.568788501,50.431211499
284,1500000US130210135021,130210135021,"Block Group 1, Census Tract 135.02, Bibb County, Georgia",462,349,113,75.5411255411,24.4588744589
285,1500000US130210135022,130210135022,"Block Group 2, Census Tract 135.02, Bibb County, Georgia",1285,741,544,57.6653696498,42.3346303502
286,1500000US130210135031,130210135031,"Block Group 1, Census Tract 135.03, Bibb County, Georgia",2754,1539,1215,55.8823529412,44.1176470588
287,1500000US130210135041,130210135041,"Block Group 1, Census Tract 135.04, Bibb County, Georgia",2350,1949,401,82.9361702128,17.0638297872
288,1500000US130210135042,130210135042,"Block Group 2, Census Tract 135.04, Bibb County, Georgia",2275,2145,130,94.2857142857,5.71428571429
289,1500000US130210135043,130210135043,"Block Group 3, Census Tract 135.04, Bibb County, Georgia",1537,1477,60,96.0962914769,3.9037085231
290,1500000US130210135044,130210135044,"Block Group 4, Census Tract 135.04, Bibb County, Georgia",2258,1983,275,87.8210806023,12.1789193977
291,1500000US130210136031,130210136031,"Block Group 1, Census Tract 136.03, Bibb County, Georgia",2521,2250,271,89.250297501,10.749702499
292,1500000US130210136032,130210136032,"Block Group 2, Census Tract 136.03, Bibb County, Georgia",1159,578,581,49.8705780846,50.1294219154
293,1500000US130210136041,130210136041,"Block Group 1, Census Tract 136.04, Bibb County, Georgia",1686,1318,368,78.1731909846,21.8268090154
294,1500000US130210136042,130210136042,"Block Group 2, Census Tract 136.04, Bibb County, Georgia",1782,1413,369,79.2929292929,20.7070707071
295,1500000US130210136043,130210136043,"Block Group 3, Census Tract 136.04, Bibb County, Georgia",1823,1694,129,92.923752057,7.07624794295
296,1500000US130210136051,130210136051,"Block Group 1, Census Tract 136.05, Bibb County, Georgia",1683,660,1023,39.2156862745,60.7843137255
297,1500000US130210136052,130210136052,"Block Group 2, Census Tract 136.05, Bibb County, Georgia",1459,1025,434,70.253598355,29.746401645
298,1500000US130210136053,130210136053,"Block Group 3, Census Tract 136.05, Bibb County, Georgia",1580,1163,417,73.6075949367,26.3924050633
299,1500000US130210136061,130210136061,"Block Group 1, Census Tract 136.06, Bibb County, Georgia",753,753,0,100.0,0.0
300,1500000US130210136062,130210136062,"Block Group 2, Census Tract 136.06, Bibb County, Georgia",1180,1049,131,88.8983050847,11.1016949153
301,1500000US130210136063,130210136063,"Block Group 3, Census Tract 136.06, Bibb County, Georgia",1207,1047,160,86.743993372,13.256006628
302,1500000US130210136064,130210136064,"Block Group 4, Census Tract 136.06, Bibb County, Georgia",2969,2265,704,76.2883125632,23.7116874368
303,1500000US130210137001,130210137001,"Block Group 1, Census Tract 137, Bibb County, Georgia",612,165,447,26.9607843137,73.0392156863
304,1500000US130210137002,130210137002,"Block Group 2, Census Tract 137, Bibb County, Georgia",769,313,456,40.7022106632,59.2977893368
305,1500000US130210137003,130210137003,"Block Group 3, Census Tract 137, Bibb County, Georgia",395,125,270,31.6455696203,68.3544303797
306,1500000US130210138001,130210138001,"Block Group 1, Census Tract 138, Bibb County, Georgia",778,207,571,26.6066838046,73.3933161954
307,1500000US130210138002,130210138002,"Block Group 2, Census Tract 138, Bibb County, Georgia",1361,153,1208,11.2417340191,88.7582659809
308,1500000US130210139001,130210139001,"Block Group 1, Census Tract 139, Bibb County, Georgia",823,516,307,62.6974483597,37.3025516403
309,1500000US130210139002,130210139002,"Block Group 2, Census Tract 139, Bibb County, Georgia",1047,458,589,43.7440305635,56.2559694365
310,1500000US130237901001,130237901001,"Block Group 1, Census Tract 7901, Bleckley County, Georgia",2093,1683,410,80.4108934544,19.5891065456
311,1500000US130237901002,130237901002,"Block Group 2, Census Tract 7901, Bleckley County, Georgia",2528,2035,493,80.4984177215,19.5015822785
312,1500000US130237902001,130237902001,"Block Group 1, Census Tract 7902, Bleckley County, Georgia",1784,786,998,44.0582959641,55.9417040359
313,1500000US130237902002,130237902002,"Block Group 2, Census Tract 7902, Bleckley County, Georgia",535,415,120,77.5700934579,22.4299065421
314,1500000US130237903001,130237903001,"Block Group 1, Census Tract 7903, Bleckley County, Georgia",1880,1399,481,74.414893617,25.585106383
315,1500000US130237903002,130237903002,"Block Group 2, Census Tract 7903, Bleckley County, Georgia",744,544,200,73.1182795699,26.8817204301
316,1500000US130237903003,130237903003,"Block Group 3, Census Tract 7903, Bleckley County, Georgia",998,931,67,93.2865731463,6.71342685371
317,1500000US130237903004,130237903004,"Block Group 4, Census Tract 7903, Bleckley County, Georgia",586,416,170,70.9897610922,29.0102389078
318,1500000US130259601001,130259601001,"Block Group 1, Census Tract 9601, Brantley County, Georgia",3188,3035,153,95.2007528231,4.79924717691
319,1500000US130259601002,130259601002,"Block Group 2, Census Tract 9601, Brantley County, Georgia",2626,2019,607,76.8849961919,23.1150038081
320,1500000US130259601003,130259601003,"Block Group 3, Census Tract 9601, Brantley County, Georgia",1428,1410,18,98.7394957983,1.26050420168
321,1500000US130259602001,130259602001,"Block Group 1, Census Tract 9602, Brantley County, Georgia",2301,2006,295,87.1794871795,12.8205128205
322,1500000US130259602002,130259602002,"Block Group 2, Census Tract 9602, Brantley County, Georgia",1676,1344,332,80.1909307876,19.8090692124
323,1500000US130259602003,130259602003,"Block Group 3, Census Tract 9602, Brantley County, Georgia",1941,1657,284,85.3683668212,14.6316331788
324,1500000US130259603001,130259603001,"Block Group 1, Census Tract 9603, Brantley County, Georgia",976,530,446,54.3032786885,45.6967213115
325,1500000US130259603002,130259603002,"Block Group 2, Census Tract 9603, Brantley County, Georgia",2202,1752,450,79.5640326975,20.4359673025
326,1500000US130259603003,130259603003,"Block Group 3, Census Tract 9603, Brantley County, Georgia",2041,1264,777,61.9304262616,38.0695737384
327,1500000US130279602001,130279602001,"Block Group 1, Census Tract 9602, Brooks County, Georgia",872,476,396,54.5871559633,45.4128440367
328,1500000US130279602002,130279602002,"Block Group 2, Census Tract 9602, Brooks County, Georgia",707,623,84,88.1188118812,11.8811881188
329,1500000US130279603001,130279603001,"Block Group 1, Census Tract 9603, Brooks County, Georgia",1330,1005,325,75.5639097744,24.4360902256
330,1500000US130279603002,130279603002,"Block Group 2, Census Tract 9603, Brooks County, Georgia",893,724,169,81.0750279955,18.9249720045
331,1500000US130279603003,130279603003,"Block Group 3, Census Tract 9603, Brooks County, Georgia",2028,1644,384,81.0650887574,18.9349112426
332,1500000US130279603004,130279603004,"Block Group 4, Census Tract 9603, Brooks County, Georgia",1338,936,402,69.9551569507,30.0448430493
333,1500000US130279604001,130279604001,"Block Group 1, Census Tract 9604, Brooks County, Georgia",770,400,370,51.9480519481,48.0519480519
334,1500000US130279604002,130279604002,"Block Group 2, Census Tract 9604, Brooks County, Georgia",1649,949,700,57.5500303214,42.4499696786
335,1500000US130279604003,130279604003,"Block Group 3, Census Tract 9604, Brooks County, Georgia",951,416,535,43.7434279706,56.2565720294
336,1500000US130279605001,130279605001,"Block Group 1, Census Tract 9605, Brooks County, Georgia",845,526,319,62.2485207101,37.7514792899
337,1500000US130279605002,130279605002,"Block Group 2, Census Tract 9605, Brooks County, Georgia",700,538,162,76.8571428571,23.1428571429
338,1500000US130279605003,130279605003,"Block Group 3, Census Tract 9605, Brooks County, Georgia",1193,836,357,70.0754400671,29.9245599329
339,1500000US130279606001,130279606001,"Block Group 1, Census Tract 9606, Brooks County, Georgia",1122,702,420,62.5668449198,37.4331550802
340,1500000US130279606002,130279606002,"Block Group 2, Census Tract 9606, Brooks County, Georgia",636,573,63,90.0943396226,9.90566037736
341,1500000US130279606003,130279606003,"Block Group 3, Census Tract 9606, Brooks County, Georgia",562,417,145,74.1992882562,25.8007117438
342,1500000US130299201011,130299201011,"Block Group 1, Census Tract 9201.01, Bryan County, Georgia",2259,1458,801,64.5418326693,35.4581673307
343,1500000US130299201012,130299201012,"Block Group 2, Census Tract 9201.01, Bryan County, Georgia",2826,1894,932,67.0205237084,32.9794762916
344,1500000US130299201021,130299201021,"Block Group 1, Census Tract 9201.02, Bryan County, Georgia",2594,1487,1107,57.3245952197,42.6754047803
345,1500000US130299201022,130299201022,"Block Group 2, Census Tract 9201.02, Bryan County, Georgia",1673,1424,249,85.1165570831,14.8834429169
346,1500000US130299201023,130299201023,"Block Group 3, Census Tract 9201.02, Bryan County, Georgia",1480,1082,398,73.1081081081,26.8918918919
347,1500000US130299203011,130299203011,"Block Group 1, Census Tract 9203.01, Bryan County, Georgia",2041,1597,444,78.2459578638,21.7540421362
348,1500000US130299203031,130299203031,"Block Group 1, Census Tract 9203.03, Bryan County, Georgia",2880,1109,1771,38.5069444444,61.4930555556
349,1500000US130299203032,130299203032,"Block Group 2, Census Tract 9203.03, Bryan County, Georgia",3074,949,2125,30.8718282368,69.1281717632
350,1500000US130299203051,130299203051,"Block Group 1, Census Tract 9203.05, Bryan County, Georgia",2298,1943,355,84.5517841601,15.4482158399
351,1500000US130299203052,130299203052,"Block Group 2, Census Tract 9203.05, Bryan County, Georgia",2211,1876,335,84.8484848485,15.1515151515
352,1500000US130299203061,130299203061,"Block Group 1, Census Tract 9203.06, Bryan County, Georgia",2508,1870,638,74.5614035088,25.4385964912
353,1500000US130299203062,130299203062,"Block Group 2, Census Tract 9203.06, Bryan County, Georgia",5431,3977,1454,73.2277665255,26.7722334745
354,1500000US130299203063,130299203063,"Block Group 3, Census Tract 9203.06, Bryan County, Georgia",1784,1573,211,88.1726457399,11.8273542601
355,1500000US130299800001,130299800001,"Block Group 1, Census Tract 9800, Bryan County, Georgia",0,0,0,,
356,1500000US130311101001,130311101001,"Block Group 1, Census Tract 1101, Bulloch County, Georgia",1084,882,202,81.3653136531,18.6346863469
357,1500000US130311101002,130311101002,"Block Group 2, Census Tract 1101, Bulloch County, Georgia",1375,782,593,56.8727272727,43.1272727273
358,1500000US130311101003,130311101003,"Block Group 3, Census Tract 1101, Bulloch County, Georgia",1316,1010,306,76.7477203647,23.2522796353
359,1500000US130311102001,130311102001,"Block Group 1, Census Tract 1102, Bulloch County, Georgia",1777,1574,203,88.5762521103,11.4237478897
360,1500000US130311102002,130311102002,"Block Group 2, Census Tract 1102, Bulloch County, Georgia",1798,926,872,51.5016685206,48.4983314794
361,1500000US130311102003,130311102003,"Block Group 3, Census Tract 1102, Bulloch County, Georgia",969,482,487,49.742002064,50.257997936
362,1500000US130311102004,130311102004,"Block Group 4, Census Tract 1102, Bulloch County, Georgia",594,231,363,38.8888888889,61.1111111111
363,1500000US130311102005,130311102005,"Block Group 5, Census Tract 1102, Bulloch County, Georgia",679,59,620,8.68924889543,91.3107511046
364,1500000US130311102006,130311102006,"Block Group 6, Census Tract 1102, Bulloch County, Georgia",977,186,791,19.0378710338,80.9621289662
365,1500000US130311103001,130311103001,"Block Group 1, Census Tract 1103, Bulloch County, Georgia",2062,1196,866,58.0019398642,41.9980601358
366,1500000US130311103002,130311103002,"Block Group 2, Census Tract 1103, Bulloch County, Georgia",1582,675,907,42.6675094817,57.3324905183
367,1500000US130311103003,130311103003,"Block Group 3, Census Tract 1103, Bulloch County, Georgia",1927,1444,483,74.93513233,25.06486767
368,1500000US130311103004,130311103004,"Block Group 4, Census Tract 1103, Bulloch County, Georgia",2744,2496,248,90.9620991254,9.03790087464
369,1500000US130311104011,130311104011,"Block Group 1, Census Tract 1104.01, Bulloch County, Georgia",600,180,420,30.0,70.0
370,1500000US130311104012,130311104012,"Block Group 2, Census Tract 1104.01, Bulloch County, Georgia",2058,658,1400,31.9727891156,68.0272108844
371,1500000US130311104013,130311104013,"Block Group 3, Census Tract 1104.01, Bulloch County, Georgia",605,438,167,72.3966942149,27.6033057851
372,1500000US130311104031,130311104031,"Block Group 1, Census Tract 1104.03, Bulloch County, Georgia",2775,0,2775,0.0,100.0
373,1500000US130311104032,130311104032,"Block Group 2, Census Tract 1104.03, Bulloch County, Georgia",2741,168,2573,6.12914994528,93.8708500547
374,1500000US130311104033,130311104033,"Block Group 3, Census Tract 1104.03, Bulloch County, Georgia",1485,14,1471,0.942760942761,99.0572390572
375,1500000US130311104041,130311104041,"Block Group 1, Census Tract 1104.04, Bulloch County, Georgia",11,0,11,0.0,100.0
376,1500000US130311104042,130311104042,"Block Group 2, Census Tract 1104.04, Bulloch County, Georgia",1531,0,1531,0.0,100.0
377,1500000US130311104043,130311104043,"Block Group 3, Census Tract 1104.04, Bulloch County, Georgia",585,15,570,2.5641025641,97.4358974359
378,1500000US130311105001,130311105001,"Block Group 1, Census Tract 1105, Bulloch County, Georgia",995,287,708,28.8442211055,71.1557788945
379,1500000US130311105002,130311105002,"Block Group 2, Census Tract 1105, Bulloch County, Georgia",1039,404,635,38.8835418672,61.1164581328
380,1500000US130311105003,130311105003,"Block Group 3, Census Tract 1105, Bulloch County, Georgia",1684,509,1175,30.2256532067,69.7743467933
381,1500000US130311105004,130311105004,"Block Group 4, Census Tract 1105, Bulloch County, Georgia",1026,295,731,28.7524366472,71.2475633528
382,1500000US130311106011,130311106011,"Block Group 1, Census Tract 1106.01, Bulloch County, Georgia",3328,1609,1719,48.3473557692,51.6526442308
383,1500000US130311106012,130311106012,"Block Group 2, Census Tract 1106.01, Bulloch County, Georgia",965,92,873,9.53367875648,90.4663212435
384,1500000US130311106013,130311106013,"Block Group 3, Census Tract 1106.01, Bulloch County, Georgia",2421,1613,808,66.6253614209,33.3746385791
385,1500000US130311106021,130311106021,"Block Group 1, Census Tract 1106.02, Bulloch County, Georgia",818,495,323,60.5134474328,39.4865525672
386,1500000US130311106022,130311106022,"Block Group 2, Census Tract 1106.02, Bulloch County, Georgia",547,342,205,62.5228519196,37.4771480804
387,1500000US130311106023,130311106023,"Block Group 3, Census Tract 1106.02, Bulloch County, Georgia",2474,1070,1404,43.2497978981,56.7502021019
388,1500000US130311107001,130311107001,"Block Group 1, Census Tract 1107, Bulloch County, Georgia",4051,2138,1913,52.777092076,47.222907924
389,1500000US130311107002,130311107002,"Block Group 2, Census Tract 1107, Bulloch County, Georgia",2314,1558,756,67.3292999136,32.6707000864
390,1500000US130311107003,130311107003,"Block Group 3, Census Tract 1107, Bulloch County, Georgia",1145,881,264,76.943231441,23.056768559
391,1500000US130311107004,130311107004,"Block Group 4, Census Tract 1107, Bulloch County, Georgia",2836,1893,943,66.7489421721,33.2510578279
392,1500000US130311108001,130311108001,"Block Group 1, Census Tract 1108, Bulloch County, Georgia",1601,979,622,61.1492816989,38.8507183011
393,1500000US130311108002,130311108002,"Block Group 2, Census Tract 1108, Bulloch County, Georgia",925,848,77,91.6756756757,8.32432432432
394,1500000US130311109001,130311109001,"Block Group 1, Census Tract 1109, Bulloch County, Georgia",1263,1180,83,93.4283452098,6.57165479018
395,1500000US130311109002,130311109002,"Block Group 2, Census Tract 1109, Bulloch County, Georgia",2398,1942,456,80.9841534612,19.0158465388
396,1500000US130311109003,130311109003,"Block Group 3, Census Tract 1109, Bulloch County, Georgia",2370,2105,265,88.8185654008,11.1814345992
397,1500000US130311109004,130311109004,"Block Group 4, Census Tract 1109, Bulloch County, Georgia",891,604,287,67.7890011223,32.2109988777
398,1500000US130339501001,130339501001,"Block Group 1, Census Tract 9501, Burke County, Georgia",2059,1765,294,85.7212238951,14.2787761049
399,1500000US130339501002,130339501002,"Block Group 2, Census Tract 9501, Burke County, Georgia",3059,2647,412,86.5315462569,13.4684537431
400,1500000US130339502001,130339502001,"Block Group 1, Census Tract 9502, Burke County, Georgia",1097,807,290,73.5642661805,26.4357338195
401,1500000US130339502002,130339502002,"Block Group 2, Census Tract 9502, Burke County, Georgia",1662,1362,300,81.9494584838,18.0505415162
402,1500000US130339504001,130339504001,"Block Group 1, Census Tract 9504, Burke County, Georgia",1723,1150,573,66.7440510737,33.2559489263
403,1500000US130339504002,130339504002,"Block Group 2, Census Tract 9504, Burke County, Georgia",590,215,375,36.4406779661,63.5593220339
404,1500000US130339504003,130339504003,"Block Group 3, Census Tract 9504, Burke County, Georgia",1686,733,953,43.4756820878,56.5243179122
405,1500000US130339504004,130339504004,"Block Group 4, Census Tract 9504, Burke County, Georgia",1129,152,977,13.4632418069,86.5367581931
406,1500000US130339505001,130339505001,"Block Group 1, Census Tract 9505, Burke County, Georgia",1301,1182,119,90.853189854,9.14681014604
407,1500000US130339505002,130339505002,"Block Group 2, Census Tract 9505, Burke County, Georgia",2266,1409,857,62.1800529568,37.8199470432
408,1500000US130339505003,130339505003,"Block Group 3, Census Tract 9505, Burke County, Georgia",1714,1364,350,79.5799299883,20.4200700117
409,1500000US130339507001,130339507001,"Block Group 1, Census Tract 9507, Burke County, Georgia",964,745,219,77.2821576763,22.7178423237
410,1500000US130339507002,130339507002,"Block Group 2, Census Tract 9507, Burke County, Georgia",778,537,241,69.0231362468,30.9768637532
411,1500000US130339507003,130339507003,"Block Group 3, Census Tract 9507, Burke County, Georgia",998,763,235,76.4529058116,23.5470941884
412,1500000US130339509001,130339509001,"Block Group 1, Census Tract 9509, Burke County, Georgia",878,627,251,71.4123006834,28.5876993166
413,1500000US130339509002,130339509002,"Block Group 2, Census Tract 9509, Burke County, Georgia",850,602,248,70.8235294118,29.1764705882
414,1500000US130351501001,130351501001,"Block Group 1, Census Tract 1501, Butts County, Georgia",1519,1391,128,91.573403555,8.42659644503
415,1500000US130351501002,130351501002,"Block Group 2, Census Tract 1501, Butts County, Georgia",1319,1146,173,86.8840030326,13.1159969674
416,1500000US130351501003,130351501003,"Block Group 3, Census Tract 1501, Butts County, Georgia",1774,1574,200,88.726042841,11.273957159
417,1500000US130351501004,130351501004,"Block Group 4, Census Tract 1501, Butts County, Georgia",998,839,159,84.0681362725,15.9318637275
418,1500000US130351501005,130351501005,"Block Group 5, Census Tract 1501, Butts County, Georgia",2298,2228,70,96.953872933,3.04612706701
419,1500000US130351502001,130351502001,"Block Group 1, Census Tract 1502, Butts County, Georgia",2801,1930,871,68.9039628704,31.0960371296
420,1500000US130351502002,130351502002,"Block Group 2, Census Tract 1502, Butts County, Georgia",640,232,408,36.25,63.75
421,1500000US130351502003,130351502003,"Block Group 3, Census Tract 1502, Butts County, Georgia",825,522,303,63.2727272727,36.7272727273
422,1500000US130351502004,130351502004,"Block Group 4, Census Tract 1502, Butts County, Georgia",1154,307,847,26.6031195841,73.3968804159
423,1500000US130351502005,130351502005,"Block Group 5, Census Tract 1502, Butts County, Georgia",2202,1405,797,63.8056312443,36.1943687557
424,1500000US130351503001,130351503001,"Block Group 1, Census Tract 1503, Butts County, Georgia",2611,1156,1455,44.2742244351,55.7257755649
425,1500000US130351503002,130351503002,"Block Group 2, Census Tract 1503, Butts County, Georgia",1019,949,70,93.1305201178,6.86947988224
426,1500000US130351503003,130351503003,"Block Group 3, Census Tract 1503, Butts County, Georgia",894,822,72,91.9463087248,8.05369127517
427,1500000US130351503004,130351503004,"Block Group 4, Census Tract 1503, Butts County, Georgia",928,644,284,69.3965517241,30.6034482759
428,1500000US130379501001,130379501001,"Block Group 1, Census Tract 9501, Calhoun County, Georgia",717,514,203,71.6875871688,28.3124128312
429,1500000US130379501002,130379501002,"Block Group 2, Census Tract 9501, Calhoun County, Georgia",521,379,142,72.7447216891,27.2552783109
430,1500000US130379502001,130379502001,"Block Group 1, Census Tract 9502, Calhoun County, Georgia",553,312,241,56.4195298373,43.5804701627
431,1500000US130379502002,130379502002,"Block Group 2, Census Tract 9502, Calhoun County, Georgia",527,452,75,85.7685009488,14.2314990512
432,1500000US130379502003,130379502003,"Block Group 3, Census Tract 9502, Calhoun County, Georgia",408,258,150,63.2352941176,36.7647058824
433,1500000US130379502004,130379502004,"Block Group 4, Census Tract 9502, Calhoun County, Georgia",1184,638,546,53.8851351351,46.1148648649
434,1500000US130390101001,130390101001,"Block Group 1, Census Tract 101, Camden County, Georgia",956,860,96,89.9581589958,10.0418410042
435,1500000US130390101002,130390101002,"Block Group 2, Census Tract 101, Camden County, Georgia",1589,1221,368,76.840780365,23.159219635
436,1500000US130390102001,130390102001,"Block Group 1, Census Tract 102, Camden County, Georgia",1137,979,158,86.1037818821,13.8962181179
437,1500000US130390102002,130390102002,"Block Group 2, Census Tract 102, Camden County, Georgia",1286,758,528,58.9424572317,41.0575427683
438,1500000US130390102003,130390102003,"Block Group 3, Census Tract 102, Camden County, Georgia",2515,1876,639,74.592445328,25.407554672
439,1500000US130390103011,130390103011,"Block Group 1, Census Tract 103.01, Camden County, Georgia",1832,1004,828,54.8034934498,45.1965065502
440,1500000US130390103012,130390103012,"Block Group 2, Census Tract 103.01, Camden County, Georgia",1871,1438,433,76.8572955639,23.1427044361
441,1500000US130390103013,130390103013,"Block Group 3, Census Tract 103.01, Camden County, Georgia",3639,1923,1716,52.8441879637,47.1558120363
442,1500000US130390103014,130390103014,"Block Group 4, Census Tract 103.01, Camden County, Georgia",1039,766,273,73.7247353224,26.2752646776
443,1500000US130390103021,130390103021,"Block Group 1, Census Tract 103.02, Camden County, Georgia",637,159,478,24.9607535322,75.0392464678
444,1500000US130390103022,130390103022,"Block Group 2, Census Tract 103.02, Camden County, Georgia",2609,1623,986,62.20774243,37.79225757
445,1500000US130390103023,130390103023,"Block Group 3, Census Tract 103.02, Camden County, Georgia",834,750,84,89.928057554,10.071942446
446,1500000US130390104011,130390104011,"Block Group 1, Census Tract 104.01, Camden County, Georgia",5325,2741,2584,51.4741784038,48.5258215962
447,1500000US130390104012,130390104012,"Block Group 2, Census Tract 104.01, Camden County, Georgia",1300,279,1021,21.4615384615,78.5384615385
448,1500000US130390104013,130390104013,"Block Group 3, Census Tract 104.01, Camden County, Georgia",5348,3226,2122,60.3216155572,39.6783844428
449,1500000US130390104021,130390104021,"Block Group 1, Census Tract 104.02, Camden County, Georgia",1484,1155,329,77.8301886792,22.1698113208
450,1500000US130390104022,130390104022,"Block Group 2, Census Tract 104.02, Camden County, Georgia",3712,2660,1052,71.6594827586,28.3405172414
451,1500000US130390104031,130390104031,"Block Group 1, Census Tract 104.03, Camden County, Georgia",4094,3126,968,76.3556424035,23.6443575965
452,1500000US130390105001,130390105001,"Block Group 1, Census Tract 105, Camden County, Georgia",1569,0,1569,0.0,100.0
453,1500000US130390105002,130390105002,"Block Group 2, Census Tract 105, Camden County, Georgia",0,0,0,,
454,1500000US130390106011,130390106011,"Block Group 1, Census Tract 106.01, Camden County, Georgia",1841,625,1216,33.948940793,66.051059207
455,1500000US130390106012,130390106012,"Block Group 2, Census Tract 106.01, Camden County, Georgia",1972,1032,940,52.3326572008,47.6673427992
456,1500000US130390106013,130390106013,"Block Group 3, Census Tract 106.01, Camden County, Georgia",2414,882,1532,36.5368682684,63.4631317316
457,1500000US130390106021,130390106021,"Block Group 1, Census Tract 106.02, Camden County, Georgia",883,587,296,66.4779161948,33.5220838052
458,1500000US130399900000,130399900000,"Block Group 0, Census Tract 9900, Camden County, Georgia",0,0,0,,
459,1500000US130439501001,130439501001,"Block Group 1, Census Tract 9501, Candler County, Georgia",1086,768,318,70.7182320442,29.2817679558
460,1500000US130439501002,130439501002,"Block Group 2, Census Tract 9501, Candler County, Georgia",2153,1222,931,56.7580120762,43.2419879238
461,1500000US130439501003,130439501003,"Block Group 3, Census Tract 9501, Candler County, Georgia",1861,812,1049,43.632455669,56.367544331
462,1500000US130439502001,130439502001,"Block Group 1, Census Tract 9502, Candler County, Georgia",1664,844,820,50.7211538462,49.2788461538
463,1500000US130439502002,130439502002,"Block Group 2, Census Tract 9502, Candler County, Georgia",1203,910,293,75.6442227764,24.3557772236
464,1500000US130439502003,130439502003,"Block Group 3, Census Tract 9502, Candler County, Georgia",678,475,203,70.0589970501,29.9410029499
465,1500000US130439503001,130439503001,"Block Group 1, Census Tract 9503, Candler County, Georgia",982,658,324,67.0061099796,32.9938900204
466,1500000US130439503002,130439503002,"Block Group 2, Census Tract 9503, Candler County, Georgia",1119,637,482,56.9258266309,43.0741733691
467,1500000US130459101011,130459101011,"Block Group 1, Census Tract 9101.01, Carroll County, Georgia",4173,2135,2038,51.1622334052,48.8377665948
468,1500000US130459101012,130459101012,"Block Group 2, Census Tract 9101.01, Carroll County, Georgia",1785,996,789,55.7983193277,44.2016806723
469,1500000US130459101031,130459101031,"Block Group 1, Census Tract 9101.03, Carroll County, Georgia",2744,1535,1209,55.9402332362,44.0597667638
470,1500000US130459101032,130459101032,"Block Group 2, Census Tract 9101.03, Carroll County, Georgia",2188,1814,374,82.9067641682,17.0932358318
471,1500000US130459101041,130459101041,"Block Group 1, Census Tract 9101.04, Carroll County, Georgia",1702,1348,354,79.2009400705,20.7990599295
472,1500000US130459101042,130459101042,"Block Group 2, Census Tract 9101.04, Carroll County, Georgia",5604,4448,1156,79.3718772305,20.6281227695
473,1500000US130459101043,130459101043,"Block Group 3, Census Tract 9101.04, Carroll County, Georgia",1549,917,632,59.1994835378,40.8005164622
474,1500000US130459101044,130459101044,"Block Group 4, Census Tract 9101.04, Carroll County, Georgia",801,547,254,68.2896379526,31.7103620474
475,1500000US130459102001,130459102001,"Block Group 1, Census Tract 9102, Carroll County, Georgia",2963,1918,1045,64.7316908539,35.2683091461
476,1500000US130459102002,130459102002,"Block Group 2, Census Tract 9102, Carroll County, Georgia",5624,4257,1367,75.6934566145,24.3065433855
477,1500000US130459102003,130459102003,"Block Group 3, Census Tract 9102, Carroll County, Georgia",3571,2203,1368,61.6914029684,38.3085970316
478,1500000US130459103001,130459103001,"Block Group 1, Census Tract 9103, Carroll County, Georgia",1238,552,686,44.5880452342,55.4119547658
479,1500000US130459103002,130459103002,"Block Group 2, Census Tract 9103, Carroll County, Georgia",3302,2702,600,81.8291944276,18.1708055724
480,1500000US130459103003,130459103003,"Block Group 3, Census Tract 9103, Carroll County, Georgia",1329,973,356,73.2129420617,26.7870579383
481,1500000US130459104001,130459104001,"Block Group 1, Census Tract 9104, Carroll County, Georgia",1041,899,142,86.3592699328,13.6407300672
482,1500000US130459104002,130459104002,"Block Group 2, Census Tract 9104, Carroll County, Georgia",1301,730,571,56.1106840892,43.8893159108
483,1500000US130459104003,130459104003,"Block Group 3, Census Tract 9104, Carroll County, Georgia",927,599,328,64.6170442287,35.3829557713
484,1500000US130459105011,130459105011,"Block Group 1, Census Tract 9105.01, Carroll County, Georgia",3690,1279,2411,34.6612466125,65.3387533875
485,1500000US130459105012,130459105012,"Block Group 2, Census Tract 9105.01, Carroll County, Georgia",1244,209,1035,16.8006430868,83.1993569132
486,1500000US130459105013,130459105013,"Block Group 3, Census Tract 9105.01, Carroll County, Georgia",1125,525,600,46.6666666667,53.3333333333
487,1500000US130459105014,130459105014,"Block Group 4, Census Tract 9105.01, Carroll County, Georgia",434,0,434,0.0,100.0
488,1500000US130459105021,130459105021,"Block Group 1, Census Tract 9105.02, Carroll County, Georgia",1020,82,938,8.03921568627,91.9607843137
489,1500000US130459105022,130459105022,"Block Group 2, Census Tract 9105.02, Carroll County, Georgia",1155,158,997,13.6796536797,86.3203463203
490,1500000US130459105023,130459105023,"Block Group 3, Census Tract 9105.02, Carroll County, Georgia",787,163,624,20.7115628971,79.2884371029
491,1500000US130459106001,130459106001,"Block Group 1, Census Tract 9106, Carroll County, Georgia",3516,2731,785,77.6734926052,22.3265073948
492,1500000US130459106002,130459106002,"Block Group 2, Census Tract 9106, Carroll County, Georgia",1543,673,870,43.6163318211,56.3836681789
493,1500000US130459106003,130459106003,"Block Group 3, Census Tract 9106, Carroll County, Georgia",819,517,302,63.1257631258,36.8742368742
494,1500000US130459107011,130459107011,"Block Group 1, Census Tract 9107.01, Carroll County, Georgia",3514,2195,1319,62.4644280023,37.5355719977
495,1500000US130459107012,130459107012,"Block Group 2, Census Tract 9107.01, Carroll County, Georgia",1316,396,920,30.0911854103,69.9088145897
496,1500000US130459107013,130459107013,"Block Group 3, Census Tract 9107.01, Carroll County, Georgia",3040,2332,708,76.7105263158,23.2894736842
497,1500000US130459107021,130459107021,"Block Group 1, Census Tract 9107.02, Carroll County, Georgia",2874,2783,91,96.8336812804,3.16631871955
498,1500000US130459107022,130459107022,"Block Group 2, Census Tract 9107.02, Carroll County, Georgia",2319,2173,146,93.7041828374,6.29581716257
499,1500000US130459107023,130459107023,"Block Group 3, Census Tract 9107.02, Carroll County, Georgia",2225,1640,585,73.7078651685,26.2921348315
500,1500000US130459107031,130459107031,"Block Group 1, Census Tract 9107.03, Carroll County, Georgia",1874,1121,753,59.8185699039,40.1814300961
501,1500000US130459107032,130459107032,"Block Group 2, Census Tract 9107.03, Carroll County, Georgia",998,723,275,72.4448897796,27.5551102204
502,1500000US130459107033,130459107033,"Block Group 3, Census Tract 9107.03, Carroll County, Georgia",3470,1694,1776,48.818443804,51.181556196
503,1500000US130459107034,130459107034,"Block Group 4, Census Tract 9107.03, Carroll County, Georgia",2405,1179,1226,49.0228690229,50.9771309771
504,1500000US130459108001,130459108001,"Block Group 1, Census Tract 9108, Carroll County, Georgia",2007,1161,846,57.8475336323,42.1524663677
505,1500000US130459108002,130459108002,"Block Group 2, Census Tract 9108, Carroll County, Georgia",2117,1769,348,83.5616438356,16.4383561644
506,1500000US130459109001,130459109001,"Block Group 1, Census Tract 9109, Carroll County, Georgia",2005,1567,438,78.1546134663,21.8453865337
507,1500000US130459109002,130459109002,"Block Group 2, Census Tract 9109, Carroll County, Georgia",2110,1677,433,79.4786729858,20.5213270142
508,1500000US130459110001,130459110001,"Block Group 1, Census Tract 9110, Carroll County, Georgia",1429,341,1088,23.8628411477,76.1371588523
509,1500000US130459110002,130459110002,"Block Group 2, Census Tract 9110, Carroll County, Georgia",3322,2620,702,78.8681517158,21.1318482842
510,1500000US130459110003,130459110003,"Block Group 3, Census Tract 9110, Carroll County, Georgia",1383,772,611,55.8206796819,44.1793203181
511,1500000US130459111001,130459111001,"Block Group 1, Census Tract 9111, Carroll County, Georgia",1316,851,465,64.6656534954,35.3343465046
512,1500000US130459111002,130459111002,"Block Group 2, Census Tract 9111, Carroll County, Georgia",2146,1147,999,53.4482758621,46.5517241379
513,1500000US130459111003,130459111003,"Block Group 3, Census Tract 9111, Carroll County, Georgia",990,460,530,46.4646464646,53.5353535354
514,1500000US130459111004,130459111004,"Block Group 4, Census Tract 9111, Carroll County, Georgia",2248,1623,625,72.1975088968,27.8024911032
515,1500000US130459111005,130459111005,"Block Group 5, Census Tract 9111, Carroll County, Georgia",844,230,614,27.2511848341,72.7488151659
516,1500000US130459112001,130459112001,"Block Group 1, Census Tract 9112, Carroll County, Georgia",1902,1169,733,61.4616193481,38.5383806519
517,1500000US130459112002,130459112002,"Block Group 2, Census Tract 9112, Carroll County, Georgia",1161,921,240,79.3281653747,20.6718346253
518,1500000US130459112003,130459112003,"Block Group 3, Census Tract 9112, Carroll County, Georgia",1407,855,552,60.7675906183,39.2324093817
519,1500000US130459112004,130459112004,"Block Group 4, Census Tract 9112, Carroll County, Georgia",1211,621,590,51.2799339389,48.7200660611
520,1500000US130470301001,130470301001,"Block Group 1, Census Tract 301, Catoosa County, Georgia",2640,2495,145,94.5075757576,5.49242424242
521,1500000US130470301002,130470301002,"Block Group 2, Census Tract 301, Catoosa County, Georgia",565,404,161,71.5044247788,28.4955752212
522,1500000US130470301003,130470301003,"Block Group 3, Census Tract 301, Catoosa County, Georgia",1322,1027,295,77.6853252648,22.3146747352
523,1500000US130470301004,130470301004,"Block Group 4, Census Tract 301, Catoosa County, Georgia",1949,1187,762,60.9030271934,39.0969728066
524,1500000US130470302011,130470302011,"Block Group 1, Census Tract 302.01, Catoosa County, Georgia",1481,824,657,55.6380823768,44.3619176232
525,1500000US130470302012,130470302012,"Block Group 2, Census Tract 302.01, Catoosa County, Georgia",2879,2313,566,80.3403959708,19.6596040292
526,1500000US130470302021,130470302021,"Block Group 1, Census Tract 302.02, Catoosa County, Georgia",1676,1135,541,67.7207637232,32.2792362768
527,1500000US130470302022,130470302022,"Block Group 2, Census Tract 302.02, Catoosa County, Georgia",1703,1393,310,81.7968291251,18.2031708749
528,1500000US130470302023,130470302023,"Block Group 3, Census Tract 302.02, Catoosa County, Georgia",2888,2516,372,87.1191135734,12.8808864266
529,1500000US130470303011,130470303011,"Block Group 1, Census Tract 303.01, Catoosa County, Georgia",2300,1872,428,81.3913043478,18.6086956522
530,1500000US130470303012,130470303012,"Block Group 2, Census Tract 303.01, Catoosa County, Georgia",2385,2264,121,94.9266247379,5.07337526205
531,1500000US130470303013,130470303013,"Block Group 3, Census Tract 303.01, Catoosa County, Georgia",2823,2285,538,80.9422600071,19.0577399929
532,1500000US130470303031,130470303031,"Block Group 1, Census Tract 303.03, Catoosa County, Georgia",3175,2536,639,79.874015748,20.125984252
533,1500000US130470303041,130470303041,"Block Group 1, Census Tract 303.04, Catoosa County, Georgia",3787,3345,442,88.3284922102,11.6715077898
534,1500000US130470304011,130470304011,"Block Group 1, Census Tract 304.01, Catoosa County, Georgia",1547,1399,148,90.4330963154,9.56690368455
535,1500000US130470304012,130470304012,"Block Group 2, Census Tract 304.01, Catoosa County, Georgia",3012,2850,162,94.6215139442,5.37848605578
536,1500000US130470304013,130470304013,"Block Group 3, Census Tract 304.01, Catoosa County, Georgia",2428,2341,87,96.4168039539,3.58319604613
537,1500000US130470304021,130470304021,"Block Group 1, Census Tract 304.02, Catoosa County, Georgia",1228,953,275,77.6058631922,22.3941368078
538,1500000US130470304022,130470304022,"Block Group 2, Census Tract 304.02, Catoosa County, Georgia",851,725,126,85.1938895417,14.8061104583
539,1500000US130470304023,130470304023,"Block Group 3, Census Tract 304.02, Catoosa County, Georgia",2479,2196,283,88.5841064946,11.4158935054
540,1500000US130470304024,130470304024,"Block Group 4, Census Tract 304.02, Catoosa County, Georgia",1915,1346,569,70.2872062663,29.7127937337
541,1500000US130470305001,130470305001,"Block Group 1, Census Tract 305, Catoosa County, Georgia",3705,1974,1731,53.2793522267,46.7206477733
542,1500000US130470305002,130470305002,"Block Group 2, Census Tract 305, Catoosa County, Georgia",805,711,94,88.3229813665,11.6770186335
543,1500000US130470305003,130470305003,"Block Group 3, Census Tract 305, Catoosa County, Georgia",1596,647,949,40.5388471178,59.4611528822
544,1500000US130470306001,130470306001,"Block Group 1, Census Tract 306, Catoosa County, Georgia",674,529,145,78.4866468843,21.5133531157
545,1500000US130470306002,130470306002,"Block Group 2, Census Tract 306, Catoosa County, Georgia",1667,1345,322,80.6838632274,19.3161367726
546,1500000US130470306003,130470306003,"Block Group 3, Census Tract 306, Catoosa County, Georgia",1282,1000,282,78.0031201248,21.9968798752
547,1500000US130470306004,130470306004,"Block Group 4, Census Tract 306, Catoosa County, Georgia",905,860,45,95.0276243094,4.97237569061
548,1500000US130470306005,130470306005,"Block Group 5, Census Tract 306, Catoosa County, Georgia",1112,676,436,60.7913669065,39.2086330935
549,1500000US130470307001,130470307001,"Block Group 1, Census Tract 307, Catoosa County, Georgia",2569,1475,1094,57.4153367069,42.5846632931
550,1500000US130470307002,130470307002,"Block Group 2, Census Tract 307, Catoosa County, Georgia",954,746,208,78.1970649895,21.8029350105
551,1500000US130470307003,130470307003,"Block Group 3, Census Tract 307, Catoosa County, Georgia",2924,995,1929,34.0287277702,65.9712722298
552,1500000US130470307004,130470307004,"Block Group 4, Census Tract 307, Catoosa County, Georgia",968,829,139,85.6404958678,14.3595041322
553,1500000US130470307005,130470307005,"Block Group 5, Census Tract 307, Catoosa County, Georgia",626,495,131,79.0734824281,20.9265175719
554,1500000US130490101001,130490101001,"Block Group 1, Census Tract 101, Charlton County, Georgia",1448,807,641,55.7320441989,44.2679558011
555,1500000US130490101002,130490101002,"Block Group 2, Census Tract 101, Charlton County, Georgia",1463,1025,438,70.0615174299,29.9384825701
556,1500000US130490101003,130490101003,"Block Group 3, Census Tract 101, Charlton County, Georgia",2244,1989,255,88.6363636364,11.3636363636
557,1500000US130490101004,130490101004,"Block Group 4, Census Tract 101, Charlton County, Georgia",3205,2479,726,77.3478939158,22.6521060842
558,1500000US130490102001,130490102001,"Block Group 1, Census Tract 102, Charlton County, Georgia",1647,1414,233,85.8530661809,14.1469338191
559,1500000US130490102002,130490102002,"Block Group 2, Census Tract 102, Charlton County, Georgia",1706,1573,133,92.203985932,7.796014068
560,1500000US130510001001,130510001001,"Block Group 1, Census Tract 1, Chatham County, Georgia",882,0,882,0.0,100.0
561,1500000US130510003001,130510003001,"Block Group 1, Census Tract 3, Chatham County, Georgia",514,187,327,36.3813229572,63.6186770428
562,1500000US130510003002,130510003002,"Block Group 2, Census Tract 3, Chatham County, Georgia",701,323,378,46.0770328103,53.9229671897
563,1500000US130510006011,130510006011,"Block Group 1, Census Tract 6.01, Chatham County, Georgia",349,117,232,33.5243553009,66.4756446991
564,1500000US130510006012,130510006012,"Block Group 2, Census Tract 6.01, Chatham County, Georgia",481,180,301,37.422037422,62.577962578
565,1500000US130510006013,130510006013,"Block Group 3, Census Tract 6.01, Chatham County, Georgia",774,303,471,39.1472868217,60.8527131783
566,1500000US130510006014,130510006014,"Block Group 4, Census Tract 6.01, Chatham County, Georgia",387,219,168,56.5891472868,43.4108527132
567,1500000US130510006015,130510006015,"Block Group 5, Census Tract 6.01, Chatham County, Georgia",995,381,614,38.2914572864,61.7085427136
568,1500000US130510009001,130510009001,"Block Group 1, Census Tract 9, Chatham County, Georgia",1160,532,628,45.8620689655,54.1379310345
569,1500000US130510011001,130510011001,"Block Group 1, Census Tract 11, Chatham County, Georgia",1075,252,823,23.4418604651,76.5581395349
570,1500000US130510011002,130510011002,"Block Group 2, Census Tract 11, Chatham County, Georgia",997,303,694,30.3911735206,69.6088264794
571,1500000US130510012001,130510012001,"Block Group 1, Census Tract 12, Chatham County, Georgia",1962,176,1786,8.97043832824,91.0295616718
572,1500000US130510015001,130510015001,"Block Group 1, Census Tract 15, Chatham County, Georgia",1411,156,1255,11.0559886605,88.9440113395
573,1500000US130510020001,130510020001,"Block Group 1, Census Tract 20, Chatham County, Georgia",582,183,399,31.4432989691,68.5567010309
574,1500000US130510020002,130510020002,"Block Group 2, Census Tract 20, Chatham County, Georgia",677,352,325,51.9940915805,48.0059084195
575,1500000US130510021001,130510021001,"Block Group 1, Census Tract 21, Chatham County, Georgia",629,262,367,41.653418124,58.346581876
576,1500000US130510021002,130510021002,"Block Group 2, Census Tract 21, Chatham County, Georgia",574,320,254,55.7491289199,44.2508710801
577,1500000US130510021003,130510021003,"Block Group 3, Census Tract 21, Chatham County, Georgia",948,497,451,52.4261603376,47.5738396624
578,1500000US130510022001,130510022001,"Block Group 1, Census Tract 22, Chatham County, Georgia",923,270,653,29.2524377031,70.7475622969
579,1500000US130510022002,130510022002,"Block Group 2, Census Tract 22, Chatham County, Georgia",796,316,480,39.6984924623,60.3015075377
580,1500000US130510022003,130510022003,"Block Group 3, Census Tract 22, Chatham County, Georgia",692,315,377,45.5202312139,54.4797687861
581,1500000US130510022004,130510022004,"Block Group 4, Census Tract 22, Chatham County, Georgia",970,311,659,32.0618556701,67.9381443299
582,1500000US130510022005,130510022005,"Block Group 5, Census Tract 22, Chatham County, Georgia",714,377,337,52.8011204482,47.1988795518
583,1500000US130510023001,130510023001,"Block Group 1, Census Tract 23, Chatham County, Georgia",1287,238,1049,18.4926184926,81.5073815074
584,1500000US130510023002,130510023002,"Block Group 2, Census Tract 23, Chatham County, Georgia",775,306,469,39.4838709677,60.5161290323
585,1500000US130510026001,130510026001,"Block Group 1, Census Tract 26, Chatham County, Georgia",765,271,494,35.4248366013,64.5751633987
586,1500000US130510026002,130510026002,"Block Group 2, Census Tract 26, Chatham County, Georgia",781,361,420,46.2227912932,53.7772087068
587,1500000US130510027001,130510027001,"Block Group 1, Census Tract 27, Chatham County, Georgia",534,318,216,59.5505617978,40.4494382022
588,1500000US130510027002,130510027002,"Block Group 2, Census Tract 27, Chatham County, Georgia",1332,1014,318,76.1261261261,23.8738738739
589,1500000US130510027003,130510027003,"Block Group 3, Census Tract 27, Chatham County, Georgia",696,495,201,71.1206896552,28.8793103448
590,1500000US130510027004,130510027004,"Block Group 4, Census Tract 27, Chatham County, Georgia",406,282,124,69.4581280788,30.5418719212
591,1500000US130510028001,130510028001,"Block Group 1, Census Tract 28, Chatham County, Georgia",643,345,298,53.6547433904,46.3452566096
592,1500000US130510028002,130510028002,"Block Group 2, Census Tract 28, Chatham County, Georgia",570,254,316,44.5614035088,55.4385964912
593,1500000US130510028003,130510028003,"Block Group 3, Census Tract 28, Chatham County, Georgia",780,257,523,32.9487179487,67.0512820513
594,1500000US130510029001,130510029001,"Block Group 1, Census Tract 29, Chatham County, Georgia",1083,881,202,81.3481071099,18.6518928901
595,1500000US130510029002,130510029002,"Block Group 2, Census Tract 29, Chatham County, Georgia",700,550,150,78.5714285714,21.4285714286
596,1500000US130510029003,130510029003,"Block Group 3, Census Tract 29, Chatham County, Georgia",769,555,214,72.1716514954,27.8283485046
597,1500000US130510029004,130510029004,"Block Group 4, Census Tract 29, Chatham County, Georgia",601,408,193,67.8868552413,32.1131447587
598,1500000US130510030001,130510030001,"Block Group 1, Census Tract 30, Chatham County, Georgia",541,367,174,67.8373382625,32.1626617375
599,1500000US130510030002,130510030002,"Block Group 2, Census Tract 30, Chatham County, Georgia",1494,951,543,63.6546184739,36.3453815261
600,1500000US130510033011,130510033011,"Block Group 1, Census Tract 33.01, Chatham County, Georgia",1033,783,250,75.7986447241,24.2013552759
601,1500000US130510033012,130510033012,"Block Group 2, Census Tract 33.01, Chatham County, Georgia",971,246,725,25.3347064882,74.6652935118
602,1500000US130510033021,130510033021,"Block Group 1, Census Tract 33.02, Chatham County, Georgia",768,626,142,81.5104166667,18.4895833333
603,1500000US130510033022,130510033022,"Block Group 2, Census Tract 33.02, Chatham County, Georgia",891,505,386,56.6778900112,43.3221099888
604,1500000US130510034001,130510034001,"Block Group 1, Census Tract 34, Chatham County, Georgia",777,360,417,46.332046332,53.667953668
605,1500000US130510034002,130510034002,"Block Group 2, Census Tract 34, Chatham County, Georgia",714,311,403,43.5574229692,56.4425770308
606,1500000US130510034003,130510034003,"Block Group 3, Census Tract 34, Chatham County, Georgia",525,292,233,55.619047619,44.380952381
607,1500000US130510034004,130510034004,"Block Group 4, Census Tract 34, Chatham County, Georgia",1185,838,347,70.7172995781,29.2827004219
608,1500000US130510034005,130510034005,"Block Group 5, Census Tract 34, Chatham County, Georgia",595,219,376,36.8067226891,63.1932773109
609,1500000US130510035011,130510035011,"Block Group 1, Census Tract 35.01, Chatham County, Georgia",1052,496,556,47.1482889734,52.8517110266
610,1500000US130510035012,130510035012,"Block Group 2, Census Tract 35.01, Chatham County, Georgia",1152,353,799,30.6423611111,69.3576388889
611,1500000US130510035013,130510035013,"Block Group 3, Census Tract 35.01, Chatham County, Georgia",580,168,412,28.9655172414,71.0344827586
612,1500000US130510035021,130510035021,"Block Group 1, Census Tract 35.02, Chatham County, Georgia",561,272,289,48.4848484848,51.5151515152
613,1500000US130510035022,130510035022,"Block Group 2, Census Tract 35.02, Chatham County, Georgia",1220,416,804,34.0983606557,65.9016393443
614,1500000US130510035023,130510035023,"Block Group 3, Census Tract 35.02, Chatham County, Georgia",1107,795,312,71.8157181572,28.1842818428
615,1500000US130510035024,130510035024,"Block Group 4, Census Tract 35.02, Chatham County, Georgia",1268,742,526,58.5173501577,41.4826498423
616,1500000US130510036011,130510036011,"Block Group 1, Census Tract 36.01, Chatham County, Georgia",2310,747,1563,32.3376623377,67.6623376623
617,1500000US130510036012,130510036012,"Block Group 2, Census Tract 36.01, Chatham County, Georgia",707,177,530,25.0353606789,74.9646393211
618,1500000US130510036021,130510036021,"Block Group 1, Census Tract 36.02, Chatham County, Georgia",515,128,387,24.854368932,75.145631068
619,1500000US130510036022,130510036022,"Block Group 2, Census Tract 36.02, Chatham County, Georgia",1039,346,693,33.3012512031,66.6987487969
620,1500000US130510036023,130510036023,"Block Group 3, Census Tract 36.02, Chatham County, Georgia",802,325,477,40.5236907731,59.4763092269
621,1500000US130510036024,130510036024,"Block Group 4, Census Tract 36.02, Chatham County, Georgia",858,582,276,67.8321678322,32.1678321678
622,1500000US130510036025,130510036025,"Block Group 5, Census Tract 36.02, Chatham County, Georgia",1210,575,635,47.520661157,52.479338843
623,1500000US130510037001,130510037001,"Block Group 1, Census Tract 37, Chatham County, Georgia",884,417,467,47.1719457014,52.8280542986
624,1500000US130510037002,130510037002,"Block Group 2, Census Tract 37, Chatham County, Georgia",879,348,531,39.590443686,60.409556314
625,1500000US130510038001,130510038001,"Block Group 1, Census Tract 38, Chatham County, Georgia",1214,836,378,68.863261944,31.136738056
626,1500000US130510038002,130510038002,"Block Group 2, Census Tract 38, Chatham County, Georgia",859,354,505,41.2107101281,58.7892898719
627,1500000US130510039001,130510039001,"Block Group 1, Census Tract 39, Chatham County, Georgia",704,439,265,62.3579545455,37.6420454545
628,1500000US130510039002,130510039002,"Block Group 2, Census Tract 39, Chatham County, Georgia",765,491,274,64.1830065359,35.8169934641
629,1500000US130510039003,130510039003,"Block Group 3, Census Tract 39, Chatham County, Georgia",924,473,451,51.1904761905,48.8095238095
630,1500000US130510039004,130510039004,"Block Group 4, Census Tract 39, Chatham County, Georgia",1202,727,475,60.4825291181,39.5174708819
631,1500000US130510040011,130510040011,"Block Group 1, Census Tract 40.01, Chatham County, Georgia",735,546,189,74.2857142857,25.7142857143
632,1500000US130510040012,130510040012,"Block Group 2, Census Tract 40.01, Chatham County, Georgia",657,557,100,84.7792998478,15.2207001522
633,1500000US130510040013,130510040013,"Block Group 3, Census Tract 40.01, Chatham County, Georgia",1072,676,396,63.0597014925,36.9402985075
634,1500000US130510040014,130510040014,"Block Group 4, Census Tract 40.01, Chatham County, Georgia",749,446,303,59.5460614152,40.4539385848
635,1500000US130510040015,130510040015,"Block Group 5, Census Tract 40.01, Chatham County, Georgia",957,94,863,9.8223615465,90.1776384535
636,1500000US130510040021,130510040021,"Block Group 1, Census Tract 40.02, Chatham County, Georgia",768,492,276,64.0625,35.9375
637,1500000US130510040022,130510040022,"Block Group 2, Census Tract 40.02, Chatham County, Georgia",1279,436,843,34.0891321345,65.9108678655
638,1500000US130510040023,130510040023,"Block Group 3, Census Tract 40.02, Chatham County, Georgia",711,102,609,14.3459915612,85.6540084388
639,1500000US130510040024,130510040024,"Block Group 4, Census Tract 40.02, Chatham County, Georgia",841,471,370,56.0047562426,43.9952437574
640,1500000US130510041001,130510041001,"Block Group 1, Census Tract 41, Chatham County, Georgia",1222,663,559,54.2553191489,45.7446808511
641,1500000US130510041002,130510041002,"Block Group 2, Census Tract 41, Chatham County, Georgia",575,476,99,82.7826086957,17.2173913043
642,1500000US130510042071,130510042071,"Block Group 1, Census Tract 42.07, Chatham County, Georgia",2232,442,1790,19.8028673835,80.1971326165
643,1500000US130510042072,130510042072,"Block Group 2, Census Tract 42.07, Chatham County, Georgia",1144,621,523,54.2832167832,45.7167832168
644,1500000US130510042073,130510042073,"Block Group 3, Census Tract 42.07, Chatham County, Georgia",187,0,187,0.0,100.0
645,1500000US130510042081,130510042081,"Block Group 1, Census Tract 42.08, Chatham County, Georgia",1303,771,532,59.171143515,40.828856485
646,1500000US130510042082,130510042082,"Block Group 2, Census Tract 42.08, Chatham County, Georgia",772,285,487,36.9170984456,63.0829015544
647,1500000US130510042083,130510042083,"Block Group 3, Census Tract 42.08, Chatham County, Georgia",697,353,344,50.6456241033,49.3543758967
648,1500000US130510042084,130510042084,"Block Group 4, Census Tract 42.08, Chatham County, Georgia",1245,367,878,29.4779116466,70.5220883534
649,1500000US130510042085,130510042085,"Block Group 5, Census Tract 42.08, Chatham County, Georgia",1113,0,1113,0.0,100.0
650,1500000US130510042091,130510042091,"Block Group 1, Census Tract 42.09, Chatham County, Georgia",1537,395,1142,25.6994144437,74.3005855563
651,1500000US130510042092,130510042092,"Block Group 2, Census Tract 42.09, Chatham County, Georgia",1280,0,1280,0.0,100.0
652,1500000US130510042093,130510042093,"Block Group 3, Census Tract 42.09, Chatham County, Georgia",564,395,169,70.0354609929,29.9645390071
653,1500000US130510042101,130510042101,"Block Group 1, Census Tract 42.10, Chatham County, Georgia",422,0,422,0.0,100.0
654,1500000US130510042102,130510042102,"Block Group 2, Census Tract 42.10, Chatham County, Georgia",1637,559,1078,34.1478313989,65.8521686011
655,1500000US130510042103,130510042103,"Block Group 3, Census Tract 42.10, Chatham County, Georgia",1481,834,647,56.3133018231,43.6866981769
656,1500000US130510042104,130510042104,"Block Group 4, Census Tract 42.10, Chatham County, Georgia",1462,330,1132,22.5718194254,77.4281805746
657,1500000US130510042111,130510042111,"Block Group 1, Census Tract 42.11, Chatham County, Georgia",773,210,563,27.1668822768,72.8331177232
658,1500000US130510042112,130510042112,"Block Group 2, Census Tract 42.11, Chatham County, Georgia",1737,1242,495,71.5025906736,28.4974093264
659,1500000US130510042113,130510042113,"Block Group 3, Census Tract 42.11, Chatham County, Georgia",1349,967,382,71.6827279466,28.3172720534
660,1500000US130510042114,130510042114,"Block Group 4, Census Tract 42.11, Chatham County, Georgia",1311,1263,48,96.3386727689,3.66132723112
661,1500000US130510042121,130510042121,"Block Group 1, Census Tract 42.12, Chatham County, Georgia",2239,981,1258,43.8142027691,56.1857972309
662,1500000US130510042122,130510042122,"Block Group 2, Census Tract 42.12, Chatham County, Georgia",1434,1209,225,84.309623431,15.690376569
663,1500000US130510042123,130510042123,"Block Group 3, Census Tract 42.12, Chatham County, Georgia",1193,1147,46,96.1441743504,3.85582564962
664,1500000US130510043001,130510043001,"Block Group 1, Census Tract 43, Chatham County, Georgia",2061,0,2061,0.0,100.0
665,1500000US130510044001,130510044001,"Block Group 1, Census Tract 44, Chatham County, Georgia",1232,183,1049,14.8538961039,85.1461038961
666,1500000US130510044002,130510044002,"Block Group 2, Census Tract 44, Chatham County, Georgia",884,390,494,44.1176470588,55.8823529412
667,1500000US130510045001,130510045001,"Block Group 1, Census Tract 45, Chatham County, Georgia",556,189,367,33.9928057554,66.0071942446
668,1500000US130510045002,130510045002,"Block Group 2, Census Tract 45, Chatham County, Georgia",1008,766,242,75.9920634921,24.0079365079
669,1500000US130510045003,130510045003,"Block Group 3, Census Tract 45, Chatham County, Georgia",1498,1053,445,70.2937249666,29.7062750334
670,1500000US130510045004,130510045004,"Block Group 4, Census Tract 45, Chatham County, Georgia",1177,713,464,60.577740017,39.422259983
671,1500000US130510101011,130510101011,"Block Group 1, Census Tract 101.01, Chatham County, Georgia",553,0,553,0.0,100.0
672,1500000US130510101012,130510101012,"Block Group 2, Census Tract 101.01, Chatham County, Georgia",362,323,39,89.226519337,10.773480663
673,1500000US130510101021,130510101021,"Block Group 1, Census Tract 101.02, Chatham County, Georgia",1021,378,643,37.0225269344,62.9774730656
674,1500000US130510101022,130510101022,"Block Group 2, Census Tract 101.02, Chatham County, Georgia",854,324,530,37.9391100703,62.0608899297
675,1500000US130510101023,130510101023,"Block Group 3, Census Tract 101.02, Chatham County, Georgia",1360,848,512,62.3529411765,37.6470588235
676,1500000US130510102001,130510102001,"Block Group 1, Census Tract 102, Chatham County, Georgia",1483,1335,148,90.020229265,9.979770735
677,1500000US130510102002,130510102002,"Block Group 2, Census Tract 102, Chatham County, Georgia",1686,1043,643,61.862396204,38.137603796
678,1500000US130510102003,130510102003,"Block Group 3, Census Tract 102, Chatham County, Georgia",1481,859,622,58.0013504389,41.9986495611
679,1500000US130510105011,130510105011,"Block Group 1, Census Tract 105.01, Chatham County, Georgia",868,181,687,20.8525345622,79.1474654378
680,1500000US130510105012,130510105012,"Block Group 2, Census Tract 105.01, Chatham County, Georgia",901,677,224,75.1387347392,24.8612652608
681,1500000US130510105013,130510105013,"Block Group 3, Census Tract 105.01, Chatham County, Georgia",2383,244,2139,10.2391942929,89.7608057071
682,1500000US130510105014,130510105014,"Block Group 4, Census Tract 105.01, Chatham County, Georgia",536,174,362,32.4626865672,67.5373134328
683,1500000US130510105015,130510105015,"Block Group 5, Census Tract 105.01, Chatham County, Georgia",560,184,376,32.8571428571,67.1428571429
684,1500000US130510105021,130510105021,"Block Group 1, Census Tract 105.02, Chatham County, Georgia",913,44,869,4.81927710843,95.1807228916
685,1500000US130510105022,130510105022,"Block Group 2, Census Tract 105.02, Chatham County, Georgia",2674,1439,1235,53.8145100972,46.1854899028
686,1500000US130510106011,130510106011,"Block Group 1, Census Tract 106.01, Chatham County, Georgia",349,263,86,75.3581661891,24.6418338109
687,1500000US130510106012,130510106012,"Block Group 2, Census Tract 106.01, Chatham County, Georgia",1017,684,333,67.2566371681,32.7433628319
688,1500000US130510106013,130510106013,"Block Group 3, Census Tract 106.01, Chatham County, Georgia",429,187,242,43.5897435897,56.4102564103
689,1500000US130510106014,130510106014,"Block Group 4, Census Tract 106.01, Chatham County, Georgia",784,309,475,39.4132653061,60.5867346939
690,1500000US130510106015,130510106015,"Block Group 5, Census Tract 106.01, Chatham County, Georgia",733,57,676,7.77626193724,92.2237380628
691,1500000US130510106016,130510106016,"Block Group 6, Census Tract 106.01, Chatham County, Georgia",918,120,798,13.0718954248,86.9281045752
692,1500000US130510106031,130510106031,"Block Group 1, Census Tract 106.03, Chatham County, Georgia",1869,523,1346,27.9828785447,72.0171214553
693,1500000US130510106051,130510106051,"Block Group 1, Census Tract 106.05, Chatham County, Georgia",10,0,10,0.0,100.0
694,1500000US130510107001,130510107001,"Block Group 1, Census Tract 107, Chatham County, Georgia",17886,11791,6095,65.9230683216,34.0769316784
695,1500000US130510107002,130510107002,"Block Group 2, Census Tract 107, Chatham County, Georgia",748,579,169,77.4064171123,22.5935828877
696,1500000US130510107003,130510107003,"Block Group 3, Census Tract 107, Chatham County, Georgia",607,411,196,67.7100494234,32.2899505766
697,1500000US130510108011,130510108011,"Block Group 1, Census Tract 108.01, Chatham County, Georgia",1340,933,407,69.6268656716,30.3731343284
698,1500000US130510108012,130510108012,"Block Group 2, Census Tract 108.01, Chatham County, Georgia",1313,835,478,63.5948210206,36.4051789794
699,1500000US130510108021,130510108021,"Block Group 1, Census Tract 108.02, Chatham County, Georgia",7320,4377,2943,59.7950819672,40.2049180328
700,1500000US130510108022,130510108022,"Block Group 2, Census Tract 108.02, Chatham County, Georgia",2052,1768,284,86.1598440546,13.8401559454
701,1500000US130510108031,130510108031,"Block Group 1, Census Tract 108.03, Chatham County, Georgia",1284,1212,72,94.3925233645,5.60747663551
702,1500000US130510108032,130510108032,"Block Group 2, Census Tract 108.03, Chatham County, Georgia",826,561,265,67.9176755448,32.0823244552
703,1500000US130510108033,130510108033,"Block Group 3, Census Tract 108.03, Chatham County, Georgia",4337,2870,1467,66.1747751902,33.8252248098
704,1500000US130510108034,130510108034,"Block Group 4, Census Tract 108.03, Chatham County, Georgia",4685,3912,773,83.5005336179,16.4994663821
705,1500000US130510108061,130510108061,"Block Group 1, Census Tract 108.06, Chatham County, Georgia",2010,1082,928,53.8308457711,46.1691542289
706,1500000US130510108062,130510108062,"Block Group 2, Census Tract 108.06, Chatham County, Georgia",702,439,263,62.5356125356,37.4643874644
707,1500000US130510108063,130510108063,"Block Group 3, Census Tract 108.06, Chatham County, Georgia",1330,726,604,54.5864661654,45.4135338346
708,1500000US130510108064,130510108064,"Block Group 4, Census Tract 108.06, Chatham County, Georgia",2342,502,1840,21.4346712212,78.5653287788
709,1500000US130510108071,130510108071,"Block Group 1, Census Tract 108.07, Chatham County, Georgia",2702,1976,726,73.1310140637,26.8689859363
710,1500000US130510108072,130510108072,"Block Group 2, Census Tract 108.07, Chatham County, Georgia",299,299,0,100.0,0.0
711,1500000US130510108073,130510108073,"Block Group 3, Census Tract 108.07, Chatham County, Georgia",1959,778,1181,39.7141398673,60.2858601327
712,1500000US130510108081,130510108081,"Block Group 1, Census Tract 108.08, Chatham County, Georgia",3843,1742,2101,45.3291699193,54.6708300807
713,1500000US130510108082,130510108082,"Block Group 2, Census Tract 108.08, Chatham County, Georgia",1294,338,956,26.1205564142,73.8794435858
714,1500000US130510108083,130510108083,"Block Group 3, Census Tract 108.08, Chatham County, Georgia",2249,1606,643,71.4095153402,28.5904846598
715,1500000US130510108084,130510108084,"Block Group 4, Census Tract 108.08, Chatham County, Georgia",3335,1848,1487,55.4122938531,44.5877061469
716,1500000US130510108091,130510108091,"Block Group 1, Census Tract 108.09, Chatham County, Georgia",4719,3892,827,82.4751006569,17.5248993431
717,1500000US130510108092,130510108092,"Block Group 2, Census Tract 108.09, Chatham County, Georgia",7053,4461,2592,63.2496809868,36.7503190132
718,1500000US130510109011,130510109011,"Block Group 1, Census Tract 109.01, Chatham County, Georgia",1881,676,1205,35.9383306752,64.0616693248
719,1500000US130510109012,130510109012,"Block Group 2, Census Tract 109.01, Chatham County, Georgia",1366,17,1349,1.24450951684,98.7554904832
720,1500000US130510109013,130510109013,"Block Group 3, Census Tract 109.01, Chatham County, Georgia",809,470,339,58.0964153276,41.9035846724
721,1500000US130510110031,130510110031,"Block Group 1, Census Tract 110.03, Chatham County, Georgia",1996,1763,233,88.3266533066,11.6733466934
722,1500000US130510110032,130510110032,"Block Group 2, Census Tract 110.03, Chatham County, Georgia",1343,802,541,59.7170513775,40.2829486225
723,1500000US130510110033,130510110033,"Block Group 3, Census Tract 110.03, Chatham County, Georgia",1649,1091,558,66.1613098848,33.8386901152
724,1500000US130510110034,130510110034,"Block Group 4, Census Tract 110.03, Chatham County, Georgia",643,369,274,57.3872472784,42.6127527216
725,1500000US130510110035,130510110035,"Block Group 5, Census Tract 110.03, Chatham County, Georgia",909,897,12,98.6798679868,1.3201320132
726,1500000US130510110041,130510110041,"Block Group 1, Census Tract 110.04, Chatham County, Georgia",1729,1715,14,99.1902834008,0.80971659919
727,1500000US130510110042,130510110042,"Block Group 2, Census Tract 110.04, Chatham County, Georgia",1019,820,199,80.4710500491,19.5289499509
728,1500000US130510110043,130510110043,"Block Group 3, Census Tract 110.04, Chatham County, Georgia",756,663,93,87.6984126984,12.3015873016
729,1500000US130510110051,130510110051,"Block Group 1, Census Tract 110.05, Chatham County, Georgia",684,659,25,96.3450292398,3.65497076023
730,1500000US130510110052,130510110052,"Block Group 2, Census Tract 110.05, Chatham County, Georgia",1071,1071,0,100.0,0.0
731,1500000US130510110053,130510110053,"Block Group 3, Census Tract 110.05, Chatham County, Georgia",1156,1156,0,100.0,0.0
732,1500000US130510110054,130510110054,"Block Group 4, Census Tract 110.05, Chatham County, Georgia",1597,1597,0,100.0,0.0
733,1500000US130510110061,130510110061,"Block Group 1, Census Tract 110.06, Chatham County, Georgia",1145,1036,109,90.480349345,9.51965065502
734,1500000US130510110062,130510110062,"Block Group 2, Census Tract 110.06, Chatham County, Georgia",2417,2186,231,90.442697559,9.55730244104
735,1500000US130510111031,130510111031,"Block Group 1, Census Tract 111.03, Chatham County, Georgia",825,639,186,77.4545454545,22.5454545455
736,1500000US130510111032,130510111032,"Block Group 2, Census Tract 111.03, Chatham County, Georgia",841,603,238,71.7003567182,28.2996432818
737,1500000US130510111033,130510111033,"Block Group 3, Census Tract 111.03, Chatham County, Georgia",694,432,262,62.2478386167,37.7521613833
738,1500000US130510111034,130510111034,"Block Group 4, Census Tract 111.03, Chatham County, Georgia",918,481,437,52.3965141612,47.6034858388
739,1500000US130510111041,130510111041,"Block Group 1, Census Tract 111.04, Chatham County, Georgia",1560,795,765,50.9615384615,49.0384615385
740,1500000US130510111042,130510111042,"Block Group 2, Census Tract 111.04, Chatham County, Georgia",2562,2116,446,82.5917252147,17.4082747853
741,1500000US130510111043,130510111043,"Block Group 3, Census Tract 111.04, Chatham County, Georgia",830,717,113,86.3855421687,13.6144578313
742,1500000US130510111061,130510111061,"Block Group 1, Census Tract 111.06, Chatham County, Georgia",2597,1694,903,65.2291105121,34.7708894879
743,1500000US130510111062,130510111062,"Block Group 2, Census Tract 111.06, Chatham County, Georgia",3197,2065,1132,64.591804817,35.408195183
744,1500000US130510111071,130510111071,"Block Group 1, Census Tract 111.07, Chatham County, Georgia",662,617,45,93.2024169184,6.79758308157
745,1500000US130510111072,130510111072,"Block Group 2, Census Tract 111.07, Chatham County, Georgia",1237,1237,0,100.0,0.0
746,1500000US130510111073,130510111073,"Block Group 3, Census Tract 111.07, Chatham County, Georgia",1175,1053,122,89.6170212766,10.3829787234
747,1500000US130510111081,130510111081,"Block Group 1, Census Tract 111.08, Chatham County, Georgia",1488,1283,205,86.2231182796,13.7768817204
748,1500000US130510111082,130510111082,"Block Group 2, Census Tract 111.08, Chatham County, Georgia",1511,1262,249,83.5208471211,16.4791528789
749,1500000US130510111091,130510111091,"Block Group 1, Census Tract 111.09, Chatham County, Georgia",2143,1821,322,84.9743350443,15.0256649557
750,1500000US130510111092,130510111092,"Block Group 2, Census Tract 111.09, Chatham County, Georgia",3031,2266,765,74.7608050148,25.2391949852
751,1500000US130510111093,130510111093,"Block Group 3, Census Tract 111.09, Chatham County, Georgia",962,900,62,93.5550935551,6.44490644491
752,1500000US130510111094,130510111094,"Block Group 4, Census Tract 111.09, Chatham County, Georgia",683,443,240,64.8609077599,35.1390922401
753,1500000US130510112001,130510112001,"Block Group 1, Census Tract 112, Chatham County, Georgia",874,261,613,29.8627002288,70.1372997712
754,1500000US130510112002,130510112002,"Block Group 2, Census Tract 112, Chatham County, Georgia",714,334,380,46.7787114846,53.2212885154
755,1500000US130510113001,130510113001,"Block Group 1, Census Tract 113, Chatham County, Georgia",1181,197,984,16.6807790008,83.3192209992
756,1500000US130510113002,130510113002,"Block Group 2, Census Tract 113, Chatham County, Georgia",1270,245,1025,19.2913385827,80.7086614173
757,1500000US130510114001,130510114001,"Block Group 1, Census Tract 114, Chatham County, Georgia",1262,487,775,38.589540412,61.410459588
758,1500000US130510114002,130510114002,"Block Group 2, Census Tract 114, Chatham County, Georgia",770,132,638,17.1428571429,82.8571428571
759,1500000US130510115001,130510115001,"Block Group 1, Census Tract 115, Chatham County, Georgia",1123,974,149,86.731967943,13.268032057
760,1500000US130510115002,130510115002,"Block Group 2, Census Tract 115, Chatham County, Georgia",1460,1432,28,98.0821917808,1.91780821918
761,1500000US130510116001,130510116001,"Block Group 1, Census Tract 116, Chatham County, Georgia",1028,331,697,32.1984435798,67.8015564202
762,1500000US130510116002,130510116002,"Block Group 2, Census Tract 116, Chatham County, Georgia",1416,380,1036,26.8361581921,73.1638418079
763,1500000US130519800001,130519800001,"Block Group 1, Census Tract 9800, Chatham County, Georgia",0,0,0,,
764,1500000US130519900000,130519900000,"Block Group 0, Census Tract 9900, Chatham County, Georgia",0,0,0,,
765,1500000US130530201001,130530201001,"Block Group 1, Census Tract 201, Chattahoochee County, Georgia",1600,1079,521,67.4375,32.5625
766,1500000US130530201002,130530201002,"Block Group 2, Census Tract 201, Chattahoochee County, Georgia",948,782,166,82.4894514768,17.5105485232
767,1500000US130530202011,130530202011,"Block Group 1, Census Tract 202.01, Chattahoochee County, Georgia",793,0,793,0.0,100.0
768,1500000US130530202012,130530202012,"Block Group 2, Census Tract 202.01, Chattahoochee County, Georgia",241,0,241,0.0,100.0
769,1500000US130530202031,130530202031,"Block Group 1, Census Tract 202.03, Chattahoochee County, Georgia",1818,19,1799,1.04510451045,98.9548954895
770,1500000US130530202032,130530202032,"Block Group 2, Census Tract 202.03, Chattahoochee County, Georgia",182,0,182,0.0,100.0
771,1500000US130530202051,130530202051,"Block Group 1, Census Tract 202.05, Chattahoochee County, Georgia",1341,55,1286,4.10141685309,95.8985831469
772,1500000US130530202052,130530202052,"Block Group 2, Census Tract 202.05, Chattahoochee County, Georgia",458,0,458,0.0,100.0
773,1500000US130530202053,130530202053,"Block Group 3, Census Tract 202.05, Chattahoochee County, Georgia",1039,0,1039,0.0,100.0
774,1500000US130530202061,130530202061,"Block Group 1, Census Tract 202.06, Chattahoochee County, Georgia",0,0,0,,
775,1500000US130550101001,130550101001,"Block Group 1, Census Tract 101, Chattooga County, Georgia",756,652,104,86.2433862434,13.7566137566
776,1500000US130550101002,130550101002,"Block Group 2, Census Tract 101, Chattooga County, Georgia",1233,989,244,80.2108678021,19.7891321979
777,1500000US130550102001,130550102001,"Block Group 1, Census Tract 102, Chattooga County, Georgia",802,551,251,68.7032418953,31.2967581047
778,1500000US130550102002,130550102002,"Block Group 2, Census Tract 102, Chattooga County, Georgia",989,493,496,49.8483316481,50.1516683519
779,1500000US130550102003,130550102003,"Block Group 3, Census Tract 102, Chattooga County, Georgia",862,744,118,86.3109048724,13.6890951276
780,1500000US130550102004,130550102004,"Block Group 4, Census Tract 102, Chattooga County, Georgia",1519,1059,460,69.7169190257,30.2830809743
781,1500000US130550102005,130550102005,"Block Group 5, Census Tract 102, Chattooga County, Georgia",1170,439,731,37.5213675214,62.4786324786
782,1500000US130550102006,130550102006,"Block Group 6, Census Tract 102, Chattooga County, Georgia",978,853,125,87.2188139059,12.7811860941
783,1500000US130550103001,130550103001,"Block Group 1, Census Tract 103, Chattooga County, Georgia",919,531,388,57.7801958651,42.2198041349
784,1500000US130550103002,130550103002,"Block Group 2, Census Tract 103, Chattooga County, Georgia",1074,933,141,86.8715083799,13.1284916201
785,1500000US130550103003,130550103003,"Block Group 3, Census Tract 103, Chattooga County, Georgia",934,544,390,58.244111349,41.755888651
786,1500000US130550104001,130550104001,"Block Group 1, Census Tract 104, Chattooga County, Georgia",2421,1856,565,76.6625361421,23.3374638579
787,1500000US130550104002,130550104002,"Block Group 2, Census Tract 104, Chattooga County, Georgia",1358,629,729,46.3181148748,53.6818851252
788,1500000US130550104003,130550104003,"Block Group 3, Census Tract 104, Chattooga County, Georgia",851,701,150,82.3736780259,17.6263219741
789,1500000US130550104004,130550104004,"Block Group 4, Census Tract 104, Chattooga County, Georgia",644,172,472,26.7080745342,73.2919254658
790,1500000US130550105001,130550105001,"Block Group 1, Census Tract 105, Chattooga County, Georgia",978,547,431,55.9304703476,44.0695296524
791,1500000US130550105002,130550105002,"Block Group 2, Census Tract 105, Chattooga County, Georgia",1029,753,276,73.1778425656,26.8221574344
792,1500000US130550105003,130550105003,"Block Group 3, Census Tract 105, Chattooga County, Georgia",716,479,237,66.8994413408,33.1005586592
793,1500000US130550105004,130550105004,"Block Group 4, Census Tract 105, Chattooga County, Georgia",848,415,433,48.9386792453,51.0613207547
794,1500000US130550105005,130550105005,"Block Group 5, Census Tract 105, Chattooga County, Georgia",741,373,368,50.3373819163,49.6626180837
795,1500000US130550106001,130550106001,"Block Group 1, Census Tract 106, Chattooga County, Georgia",1477,1036,441,70.1421800948,29.8578199052
796,1500000US130550106002,130550106002,"Block Group 2, Census Tract 106, Chattooga County, Georgia",1026,690,336,67.2514619883,32.7485380117
797,1500000US130570901001,130570901001,"Block Group 1, Census Tract 901, Cherokee County, Georgia",999,709,290,70.970970971,29.029029029
798,1500000US130570901002,130570901002,"Block Group 2, Census Tract 901, Cherokee County, Georgia",2904,2626,278,90.4269972452,9.57300275482
799,1500000US130570901003,130570901003,"Block Group 3, Census Tract 901, Cherokee County, Georgia",1649,1302,347,78.9569436022,21.0430563978
800,1500000US130570901004,130570901004,"Block Group 4, Census Tract 901, Cherokee County, Georgia",3378,2602,776,77.0278271166,22.9721728834
801,1500000US130570902001,130570902001,"Block Group 1, Census Tract 902, Cherokee County, Georgia",1549,1468,81,94.7708198838,5.2291801162
802,1500000US130570902002,130570902002,"Block Group 2, Census Tract 902, Cherokee County, Georgia",3132,2617,515,83.5568326948,16.4431673052
803,1500000US130570902003,130570902003,"Block Group 3, Census Tract 902, Cherokee County, Georgia",2926,2473,453,84.5181134655,15.4818865345
804,1500000US130570903001,130570903001,"Block Group 1, Census Tract 903, Cherokee County, Georgia",5042,4211,831,83.5184450615,16.4815549385
805,1500000US130570903002,130570903002,"Block Group 2, Census Tract 903, Cherokee County, Georgia",7346,6439,907,87.6531445685,12.3468554315
806,1500000US130570904001,130570904001,"Block Group 1, Census Tract 904, Cherokee County, Georgia",1121,590,531,52.6315789474,47.3684210526
807,1500000US130570904002,130570904002,"Block Group 2, Census Tract 904, Cherokee County, Georgia",4952,2689,2263,54.3012924071,45.6987075929
808,1500000US130570904003,130570904003,"Block Group 3, Census Tract 904, Cherokee County, Georgia",3660,626,3034,17.1038251366,82.8961748634
809,1500000US130570905011,130570905011,"Block Group 1, Census Tract 905.01, Cherokee County, Georgia",1774,1663,111,93.7429537768,6.25704622322
810,1500000US130570905012,130570905012,"Block Group 2, Census Tract 905.01, Cherokee County, Georgia",4499,3974,525,88.3307401645,11.6692598355
811,1500000US130570905021,130570905021,"Block Group 1, Census Tract 905.02, Cherokee County, Georgia",7231,7096,135,98.1330383073,1.86696169271
812,1500000US130570905022,130570905022,"Block Group 2, Census Tract 905.02, Cherokee County, Georgia",1932,1215,717,62.8881987578,37.1118012422
813,1500000US130570905023,130570905023,"Block Group 3, Census Tract 905.02, Cherokee County, Georgia",3282,3096,186,94.3327239488,5.66727605119
814,1500000US130570905024,130570905024,"Block Group 4, Census Tract 905.02, Cherokee County, Georgia",1470,1290,180,87.7551020408,12.2448979592
815,1500000US130570906011,130570906011,"Block Group 1, Census Tract 906.01, Cherokee County, Georgia",1403,1029,374,73.3428367783,26.6571632217
816,1500000US130570906012,130570906012,"Block Group 2, Census Tract 906.01, Cherokee County, Georgia",3620,1641,1979,45.3314917127,54.6685082873
817,1500000US130570906013,130570906013,"Block Group 3, Census Tract 906.01, Cherokee County, Georgia",2037,410,1627,20.1276386843,79.8723613157
818,1500000US130570906021,130570906021,"Block Group 1, Census Tract 906.02, Cherokee County, Georgia",5100,4411,689,86.4901960784,13.5098039216
819,1500000US130570906022,130570906022,"Block Group 2, Census Tract 906.02, Cherokee County, Georgia",1809,1465,344,80.9839690437,19.0160309563
820,1500000US130570906023,130570906023,"Block Group 3, Census Tract 906.02, Cherokee County, Georgia",1371,345,1026,25.1641137856,74.8358862144
821,1500000US130570907011,130570907011,"Block Group 1, Census Tract 907.01, Cherokee County, Georgia",4068,3550,518,87.2664700098,12.7335299902
822,1500000US130570907012,130570907012,"Block Group 2, Census Tract 907.01, Cherokee County, Georgia",2082,1989,93,95.5331412104,4.46685878963
823,1500000US130570907013,130570907013,"Block Group 3, Census Tract 907.01, Cherokee County, Georgia",5277,4741,536,89.8427136631,10.1572863369
824,1500000US130570907014,130570907014,"Block Group 4, Census Tract 907.01, Cherokee County, Georgia",7376,4452,2924,60.3579175705,39.6420824295
825,1500000US130570907021,130570907021,"Block Group 1, Census Tract 907.02, Cherokee County, Georgia",2742,1757,985,64.0773158279,35.9226841721
826,1500000US130570907022,130570907022,"Block Group 2, Census Tract 907.02, Cherokee County, Georgia",1229,947,282,77.0545158666,22.9454841334
827,1500000US130570907023,130570907023,"Block Group 3, Census Tract 907.02, Cherokee County, Georgia",2197,1572,625,71.5521165225,28.4478834775
828,1500000US130570907024,130570907024,"Block Group 4, Census Tract 907.02, Cherokee County, Georgia",1520,1430,90,94.0789473684,5.92105263158
829,1500000US130570908021,130570908021,"Block Group 1, Census Tract 908.02, Cherokee County, Georgia",1996,1759,237,88.126252505,11.873747495
830,1500000US130570908022,130570908022,"Block Group 2, Census Tract 908.02, Cherokee County, Georgia",1949,1813,136,93.0220625962,6.9779374038
831,1500000US130570908023,130570908023,"Block Group 3, Census Tract 908.02, Cherokee County, Georgia",2983,2267,716,75.9973181361,24.0026818639
832,1500000US130570908031,130570908031,"Block Group 1, Census Tract 908.03, Cherokee County, Georgia",5678,5149,529,90.6833392039,9.31666079605
833,1500000US130570908032,130570908032,"Block Group 2, Census Tract 908.03, Cherokee County, Georgia",2276,2220,56,97.539543058,2.460456942
834,1500000US130570908033,130570908033,"Block Group 3, Census Tract 908.03, Cherokee County, Georgia",2301,2172,129,94.3937418514,5.60625814863
835,1500000US130570908041,130570908041,"Block Group 1, Census Tract 908.04, Cherokee County, Georgia",3220,2735,485,84.9378881988,15.0621118012
836,1500000US130570908042,130570908042,"Block Group 2, Census Tract 908.04, Cherokee County, Georgia",4687,3994,693,85.2144228718,14.7855771282
837,1500000US130570908043,130570908043,"Block Group 3, Census Tract 908.04, Cherokee County, Georgia",1558,1515,43,97.2400513479,2.75994865212
838,1500000US130570909011,130570909011,"Block Group 1, Census Tract 909.01, Cherokee County, Georgia",2676,2555,121,95.4783258595,4.52167414051
839,1500000US130570909012,130570909012,"Block Group 2, Census Tract 909.01, Cherokee County, Georgia",3420,2735,685,79.9707602339,20.0292397661
840,1500000US130570909013,130570909013,"Block Group 3, Census Tract 909.01, Cherokee County, Georgia",1697,1554,143,91.5733647613,8.42663523866
841,1500000US130570909021,130570909021,"Block Group 1, Census Tract 909.02, Cherokee County, Georgia",1603,1357,246,84.6537741734,15.3462258266
842,1500000US130570909022,130570909022,"Block Group 2, Census Tract 909.02, Cherokee County, Georgia",2418,2176,242,89.9917287014,10.0082712986
843,1500000US130570909023,130570909023,"Block Group 3, Census Tract 909.02, Cherokee County, Georgia",6168,4642,1526,75.2594033722,24.7405966278
844,1500000US130570909024,130570909024,"Block Group 4, Census Tract 909.02, Cherokee County, Georgia",2281,1845,436,80.8855765015,19.1144234985
845,1500000US130570909025,130570909025,"Block Group 5, Census Tract 909.02, Cherokee County, Georgia",1969,1969,0,100.0,0.0
846,1500000US130570909041,130570909041,"Block Group 1, Census Tract 909.04, Cherokee County, Georgia",3010,2361,649,78.438538206,21.561461794
847,1500000US130570909042,130570909042,"Block Group 2, Census Tract 909.04, Cherokee County, Georgia",1534,783,751,51.0430247718,48.9569752282
848,1500000US130570909043,130570909043,"Block Group 3, Census Tract 909.04, Cherokee County, Georgia",2562,2423,139,94.5745511319,5.42544886807
849,1500000US130570909044,130570909044,"Block Group 4, Census Tract 909.04, Cherokee County, Georgia",1427,514,913,36.0196215837,63.9803784163
850,1500000US130570909051,130570909051,"Block Group 1, Census Tract 909.05, Cherokee County, Georgia",2048,1775,273,86.669921875,13.330078125
851,1500000US130570909052,130570909052,"Block Group 2, Census Tract 909.05, Cherokee County, Georgia",1524,712,812,46.719160105,53.280839895
852,1500000US130570910011,130570910011,"Block Group 1, Census Tract 910.01, Cherokee County, Georgia",802,199,603,24.812967581,75.187032419
853,1500000US130570910012,130570910012,"Block Group 2, Census Tract 910.01, Cherokee County, Georgia",791,509,282,64.3489254109,35.6510745891
854,1500000US130570910013,130570910013,"Block Group 3, Census Tract 910.01, Cherokee County, Georgia",2704,1193,1511,44.1198224852,55.8801775148
855,1500000US130570910031,130570910031,"Block Group 1, Census Tract 910.03, Cherokee County, Georgia",3000,1505,1495,50.1666666667,49.8333333333
856,1500000US130570910032,130570910032,"Block Group 2, Census Tract 910.03, Cherokee County, Georgia",1585,615,970,38.8012618297,61.1987381703
857,1500000US130570910033,130570910033,"Block Group 3, Census Tract 910.03, Cherokee County, Georgia",2662,1513,1149,56.8369646882,43.1630353118
858,1500000US130570910051,130570910051,"Block Group 1, Census Tract 910.05, Cherokee County, Georgia",2935,1418,1517,48.3134582624,51.6865417376
859,1500000US130570910052,130570910052,"Block Group 2, Census Tract 910.05, Cherokee County, Georgia",779,471,308,60.4621309371,39.5378690629
860,1500000US130570910053,130570910053,"Block Group 3, Census Tract 910.05, Cherokee County, Georgia",2472,1100,1372,44.498381877,55.501618123
861,1500000US130570910054,130570910054,"Block Group 4, Census Tract 910.05, Cherokee County, Georgia",1833,1666,167,90.8892525914,9.11074740862
862,1500000US130570910061,130570910061,"Block Group 1, Census Tract 910.06, Cherokee County, Georgia",2345,1783,562,76.0341151386,23.9658848614
863,1500000US130570910062,130570910062,"Block Group 2, Census Tract 910.06, Cherokee County, Georgia",2549,2444,105,95.8807375441,4.11926245587
864,1500000US130570910071,130570910071,"Block Group 1, Census Tract 910.07, Cherokee County, Georgia",2091,2091,0,100.0,0.0
865,1500000US130570910072,130570910072,"Block Group 2, Census Tract 910.07, Cherokee County, Georgia",2852,2404,448,84.2917251052,15.7082748948
866,1500000US130570910073,130570910073,"Block Group 3, Census Tract 910.07, Cherokee County, Georgia",1657,1548,109,93.4218467109,6.57815328908
867,1500000US130570910081,130570910081,"Block Group 1, Census Tract 910.08, Cherokee County, Georgia",1174,1037,137,88.3304940375,11.6695059625
868,1500000US130570910082,130570910082,"Block Group 2, Census Tract 910.08, Cherokee County, Georgia",1248,1248,0,100.0,0.0
869,1500000US130570910083,130570910083,"Block Group 3, Census Tract 910.08, Cherokee County, Georgia",1876,1876,0,100.0,0.0
870,1500000US130570910084,130570910084,"Block Group 4, Census Tract 910.08, Cherokee County, Georgia",3894,2855,1039,73.3179250128,26.6820749872
871,1500000US130570911011,130570911011,"Block Group 1, Census Tract 911.01, Cherokee County, Georgia",1871,1652,219,88.295029396,11.704970604
872,1500000US130570911012,130570911012,"Block Group 2, Census Tract 911.01, Cherokee County, Georgia",1961,1702,259,86.7924528302,13.2075471698
873,1500000US130570911013,130570911013,"Block Group 3, Census Tract 911.01, Cherokee County, Georgia",2164,1549,615,71.5804066543,28.4195933457
874,1500000US130570911021,130570911021,"Block Group 1, Census Tract 911.02, Cherokee County, Georgia",1965,1329,636,67.6335877863,32.3664122137
875,1500000US130570911022,130570911022,"Block Group 2, Census Tract 911.02, Cherokee County, Georgia",3188,2501,687,78.4504391468,21.5495608532
876,1500000US130570911023,130570911023,"Block Group 3, Census Tract 911.02, Cherokee County, Georgia",1830,1532,298,83.7158469945,16.2841530055
877,1500000US130570911024,130570911024,"Block Group 4, Census Tract 911.02, Cherokee County, Georgia",2004,1278,726,63.7724550898,36.2275449102
878,1500000US130570911031,130570911031,"Block Group 1, Census Tract 911.03, Cherokee County, Georgia",2168,1962,206,90.4981549815,9.50184501845
879,1500000US130570911032,130570911032,"Block Group 2, Census Tract 911.03, Cherokee County, Georgia",2699,1966,733,72.8417932568,27.1582067432
880,1500000US130570911033,130570911033,"Block Group 3, Census Tract 911.03, Cherokee County, Georgia",1395,847,548,60.7168458781,39.2831541219
881,1500000US130570911034,130570911034,"Block Group 4, Census Tract 911.03, Cherokee County, Georgia",2395,1783,612,74.4467640919,25.5532359081
882,1500000US130590001001,130590001001,"Block Group 1, Census Tract 1, Clarke County, Georgia",1705,60,1645,3.51906158358,96.4809384164
883,1500000US130590004011,130590004011,"Block Group 1, Census Tract 4.01, Clarke County, Georgia",1234,24,1210,1.94489465154,98.0551053485
884,1500000US130590004021,130590004021,"Block Group 1, Census Tract 4.02, Clarke County, Georgia",609,0,609,0.0,100.0
885,1500000US130590004022,130590004022,"Block Group 2, Census Tract 4.02, Clarke County, Georgia",106,0,106,0.0,100.0
886,1500000US130590004023,130590004023,"Block Group 3, Census Tract 4.02, Clarke County, Georgia",0,0,0,,
887,1500000US130590006001,130590006001,"Block Group 1, Census Tract 6, Clarke County, Georgia",991,81,910,8.17356205853,91.8264379415
888,1500000US130590006002,130590006002,"Block Group 2, Census Tract 6, Clarke County, Georgia",1316,245,1071,18.6170212766,81.3829787234
889,1500000US130590009001,130590009001,"Block Group 1, Census Tract 9, Clarke County, Georgia",993,161,832,16.2134944612,83.7865055388
890,1500000US130590009002,130590009002,"Block Group 2, Census Tract 9, Clarke County, Georgia",1150,335,815,29.1304347826,70.8695652174
891,1500000US130590009003,130590009003,"Block Group 3, Census Tract 9, Clarke County, Georgia",1029,344,685,33.4305150632,66.5694849368
892,1500000US130590012001,130590012001,"Block Group 1, Census Tract 12, Clarke County, Georgia",1985,707,1278,35.6171284635,64.3828715365
893,1500000US130590012002,130590012002,"Block Group 2, Census Tract 12, Clarke County, Georgia",1050,612,438,58.2857142857,41.7142857143
894,1500000US130590017001,130590017001,"Block Group 1, Census Tract 17, Clarke County, Georgia",2021,1410,611,69.7674418605,30.2325581395
895,1500000US130590018001,130590018001,"Block Group 1, Census Tract 18, Clarke County, Georgia",1040,691,349,66.4423076923,33.5576923077
896,1500000US130590018002,130590018002,"Block Group 2, Census Tract 18, Clarke County, Georgia",158,23,135,14.5569620253,85.4430379747
897,1500000US130590018003,130590018003,"Block Group 3, Census Tract 18, Clarke County, Georgia",1094,511,583,46.7093235832,53.2906764168
898,1500000US130590019001,130590019001,"Block Group 1, Census Tract 19, Clarke County, Georgia",2091,798,1293,38.1635581062,61.8364418938
899,1500000US130590019002,130590019002,"Block Group 2, Census Tract 19, Clarke County, Georgia",2018,221,1797,10.9514370664,89.0485629336
900,1500000US130590020001,130590020001,"Block Group 1, Census Tract 20, Clarke County, Georgia",982,207,775,21.0794297352,78.9205702648
901,1500000US130590020002,130590020002,"Block Group 2, Census Tract 20, Clarke County, Georgia",1069,759,310,71.0009354537,28.9990645463
902,1500000US130590021001,130590021001,"Block Group 1, Census Tract 21, Clarke County, Georgia",1270,273,997,21.4960629921,78.5039370079
903,1500000US130590021002,130590021002,"Block Group 2, Census Tract 21, Clarke County, Georgia",1481,681,800,45.9824442944,54.0175557056
904,1500000US130590022001,130590022001,"Block Group 1, Census Tract 22, Clarke County, Georgia",1064,501,563,47.0864661654,52.9135338346
905,1500000US130590022002,130590022002,"Block Group 2, Census Tract 22, Clarke County, Georgia",1210,176,1034,14.5454545455,85.4545454545
906,1500000US130590301001,130590301001,"Block Group 1, Census Tract 301, Clarke County, Georgia",1902,521,1381,27.3922187171,72.6077812829
907,1500000US130590301002,130590301002,"Block Group 2, Census Tract 301, Clarke County, Georgia",3006,451,2555,15.00332668,84.99667332
908,1500000US130590302001,130590302001,"Block Group 1, Census Tract 302, Clarke County, Georgia",1011,7,1004,0.692383778437,99.3076162216
909,1500000US130590302002,130590302002,"Block Group 2, Census Tract 302, Clarke County, Georgia",1201,352,849,29.3089092423,70.6910907577
910,1500000US130590302003,130590302003,"Block Group 3, Census Tract 302, Clarke County, Georgia",2517,850,1667,33.7703615415,66.2296384585
911,1500000US130591303001,130591303001,"Block Group 1, Census Tract 1303, Clarke County, Georgia",2585,1667,918,64.4874274662,35.5125725338
912,1500000US130591303002,130591303002,"Block Group 2, Census Tract 1303, Clarke County, Georgia",3377,1074,2303,31.8033757773,68.1966242227
913,1500000US130591304001,130591304001,"Block Group 1, Census Tract 1304, Clarke County, Georgia",2554,1907,647,74.6671887236,25.3328112764
914,1500000US130591304002,130591304002,"Block Group 2, Census Tract 1304, Clarke County, Georgia",1736,1184,552,68.202764977,31.797235023
915,1500000US130591304003,130591304003,"Block Group 3, Census Tract 1304, Clarke County, Georgia",1341,669,672,49.8881431767,50.1118568233
916,1500000US130591305001,130591305001,"Block Group 1, Census Tract 1305, Clarke County, Georgia",1245,886,359,71.1646586345,28.8353413655
917,1500000US130591305002,130591305002,"Block Group 2, Census Tract 1305, Clarke County, Georgia",896,688,208,76.7857142857,23.2142857143
918,1500000US130591305003,130591305003,"Block Group 3, Census Tract 1305, Clarke County, Georgia",523,376,147,71.8929254302,28.1070745698
919,1500000US130591306001,130591306001,"Block Group 1, Census Tract 1306, Clarke County, Georgia",1596,1182,414,74.0601503759,25.9398496241
920,1500000US130591306002,130591306002,"Block Group 2, Census Tract 1306, Clarke County, Georgia",2981,1053,1928,35.3237168735,64.6762831265
921,1500000US130591306003,130591306003,"Block Group 3, Census Tract 1306, Clarke County, Georgia",2003,178,1825,8.88666999501,91.113330005
922,1500000US130591307001,130591307001,"Block Group 1, Census Tract 1307, Clarke County, Georgia",2381,561,1820,23.5615287694,76.4384712306
923,1500000US130591307002,130591307002,"Block Group 2, Census Tract 1307, Clarke County, Georgia",1270,1133,137,89.2125984252,10.7874015748
924,1500000US130591307003,130591307003,"Block Group 3, Census Tract 1307, Clarke County, Georgia",1552,351,1201,22.6159793814,77.3840206186
925,1500000US130591403001,130591403001,"Block Group 1, Census Tract 1403, Clarke County, Georgia",1897,578,1319,30.4691618345,69.5308381655
926,1500000US130591403002,130591403002,"Block Group 2, Census Tract 1403, Clarke County, Georgia",1282,376,906,29.3291731669,70.6708268331
927,1500000US130591403003,130591403003,"Block Group 3, Census Tract 1403, Clarke County, Georgia",2034,1402,632,68.9282202557,31.0717797443
928,1500000US130591404001,130591404001,"Block Group 1, Census Tract 1404, Clarke County, Georgia",1190,733,457,61.5966386555,38.4033613445
929,1500000US130591404002,130591404002,"Block Group 2, Census Tract 1404, Clarke County, Georgia",2418,1232,1186,50.9511993383,49.0488006617
930,1500000US130591405001,130591405001,"Block Group 1, Census Tract 1405, Clarke County, Georgia",1794,516,1278,28.762541806,71.237458194
931,1500000US130591406001,130591406001,"Block Group 1, Census Tract 1406, Clarke County, Georgia",672,556,116,82.7380952381,17.2619047619
932,1500000US130591406002,130591406002,"Block Group 2, Census Tract 1406, Clarke County, Georgia",2793,2028,765,72.6100966702,27.3899033298
933,1500000US130591406003,130591406003,"Block Group 3, Census Tract 1406, Clarke County, Georgia",1457,344,1113,23.6101578586,76.3898421414
934,1500000US130591503001,130591503001,"Block Group 1, Census Tract 1503, Clarke County, Georgia",1117,703,414,62.9364368845,37.0635631155
935,1500000US130591503002,130591503002,"Block Group 2, Census Tract 1503, Clarke County, Georgia",956,496,460,51.8828451883,48.1171548117
936,1500000US130591503003,130591503003,"Block Group 3, Census Tract 1503, Clarke County, Georgia",1266,989,277,78.1200631912,21.8799368088
937,1500000US130591504001,130591504001,"Block Group 1, Census Tract 1504, Clarke County, Georgia",2276,100,2176,4.39367311072,95.6063268893
938,1500000US130591504002,130591504002,"Block Group 2, Census Tract 1504, Clarke County, Georgia",1701,257,1444,15.1087595532,84.8912404468
939,1500000US130591504003,130591504003,"Block Group 3, Census Tract 1504, Clarke County, Georgia",961,0,961,0.0,100.0
940,1500000US130591505001,130591505001,"Block Group 1, Census Tract 1505, Clarke County, Georgia",1433,162,1271,11.3049546406,88.6950453594
941,1500000US130591505002,130591505002,"Block Group 2, Census Tract 1505, Clarke County, Georgia",1352,610,742,45.1183431953,54.8816568047
942,1500000US130591505003,130591505003,"Block Group 3, Census Tract 1505, Clarke County, Georgia",1792,107,1685,5.97098214286,94.0290178571
943,1500000US130591506001,130591506001,"Block Group 1, Census Tract 1506, Clarke County, Georgia",1361,113,1248,8.30271858927,91.6972814107
944,1500000US130591506002,130591506002,"Block Group 2, Census Tract 1506, Clarke County, Georgia",1537,265,1272,17.2413793103,82.7586206897
945,1500000US130591507001,130591507001,"Block Group 1, Census Tract 1507, Clarke County, Georgia",1480,732,748,49.4594594595,50.5405405405
946,1500000US130591507002,130591507002,"Block Group 2, Census Tract 1507, Clarke County, Georgia",2959,969,1990,32.7475498479,67.2524501521
947,1500000US130591507003,130591507003,"Block Group 3, Census Tract 1507, Clarke County, Georgia",1215,902,313,74.2386831276,25.7613168724
948,1500000US130591508001,130591508001,"Block Group 1, Census Tract 1508, Clarke County, Georgia",1824,1246,578,68.3114035088,31.6885964912
949,1500000US130591508002,130591508002,"Block Group 2, Census Tract 1508, Clarke County, Georgia",945,181,764,19.1534391534,80.8465608466
950,1500000US130591508003,130591508003,"Block Group 3, Census Tract 1508, Clarke County, Georgia",1318,1041,277,78.9833080425,21.0166919575
951,1500000US130591508004,130591508004,"Block Group 4, Census Tract 1508, Clarke County, Georgia",2027,1507,520,74.3463246177,25.6536753823
952,1500000US130591509001,130591509001,"Block Group 1, Census Tract 1509, Clarke County, Georgia",2170,1390,780,64.0552995392,35.9447004608
953,1500000US130591509002,130591509002,"Block Group 2, Census Tract 1509, Clarke County, Georgia",1984,1086,898,54.7379032258,45.2620967742
954,1500000US130619603001,130619603001,"Block Group 1, Census Tract 9603, Clay County, Georgia",1699,1212,487,71.3360800471,28.6639199529
955,1500000US130619603002,130619603002,"Block Group 2, Census Tract 9603, Clay County, Georgia",609,140,469,22.9885057471,77.0114942529
956,1500000US130619603003,130619603003,"Block Group 3, Census Tract 9603, Clay County, Georgia",738,506,232,68.5636856369,31.4363143631
957,1500000US130630402021,130630402021,"Block Group 1, Census Tract 402.02, Clayton County, Georgia",1350,125,1225,9.25925925926,90.7407407407
958,1500000US130630402022,130630402022,"Block Group 2, Census Tract 402.02, Clayton County, Georgia",1139,609,530,53.4679543459,46.5320456541
959,1500000US130630402031,130630402031,"Block Group 1, Census Tract 402.03, Clayton County, Georgia",763,51,712,6.68414154653,93.3158584535
960,1500000US130630402032,130630402032,"Block Group 2, Census Tract 402.03, Clayton County, Georgia",2434,760,1674,31.2243221035,68.7756778965
961,1500000US130630402041,130630402041,"Block Group 1, Census Tract 402.04, Clayton County, Georgia",1149,421,728,36.6405570061,63.3594429939
962,1500000US130630402042,130630402042,"Block Group 2, Census Tract 402.04, Clayton County, Georgia",877,327,550,37.2862029647,62.7137970353
963,1500000US130630402043,130630402043,"Block Group 3, Census Tract 402.04, Clayton County, Georgia",1554,550,1004,35.3925353925,64.6074646075
964,1500000US130630403021,130630403021,"Block Group 1, Census Tract 403.02, Clayton County, Georgia",1190,253,937,21.2605042017,78.7394957983
965,1500000US130630403022,130630403022,"Block Group 2, Census Tract 403.02, Clayton County, Georgia",1189,496,693,41.7157275021,58.2842724979
966,1500000US130630403023,130630403023,"Block Group 3, Census Tract 403.02, Clayton County, Georgia",1275,309,966,24.2352941176,75.7647058824
967,1500000US130630403024,130630403024,"Block Group 4, Census Tract 403.02, Clayton County, Georgia",1177,926,251,78.6745964316,21.3254035684
968,1500000US130630403031,130630403031,"Block Group 1, Census Tract 403.03, Clayton County, Georgia",1448,1149,299,79.3508287293,20.6491712707
969,1500000US130630403032,130630403032,"Block Group 2, Census Tract 403.03, Clayton County, Georgia",874,413,461,47.2540045767,52.7459954233
970,1500000US130630403033,130630403033,"Block Group 3, Census Tract 403.03, Clayton County, Georgia",784,393,391,50.1275510204,49.8724489796
971,1500000US130630403034,130630403034,"Block Group 4, Census Tract 403.03, Clayton County, Georgia",1160,784,376,67.5862068966,32.4137931034
972,1500000US130630403035,130630403035,"Block Group 5, Census Tract 403.03, Clayton County, Georgia",1048,410,638,39.1221374046,60.8778625954
973,1500000US130630403036,130630403036,"Block Group 6, Census Tract 403.03, Clayton County, Georgia",968,612,356,63.2231404959,36.7768595041
974,1500000US130630403061,130630403061,"Block Group 1, Census Tract 403.06, Clayton County, Georgia",2143,256,1887,11.9458702753,88.0541297247
975,1500000US130630403062,130630403062,"Block Group 2, Census Tract 403.06, Clayton County, Georgia",1914,171,1743,8.934169279,91.065830721
976,1500000US130630403071,130630403071,"Block Group 1, Census Tract 403.07, Clayton County, Georgia",1803,1042,761,57.7925679423,42.2074320577
977,1500000US130630403072,130630403072,"Block Group 2, Census Tract 403.07, Clayton County, Georgia",2753,1888,865,68.5797312023,31.4202687977
978,1500000US130630403081,130630403081,"Block Group 1, Census Tract 403.08, Clayton County, Georgia",1511,229,1282,15.1555261416,84.8444738584
979,1500000US130630403082,130630403082,"Block Group 2, Census Tract 403.08, Clayton County, Georgia",1653,975,678,58.9836660617,41.0163339383
980,1500000US130630403083,130630403083,"Block Group 3, Census Tract 403.08, Clayton County, Georgia",819,427,392,52.1367521368,47.8632478632
981,1500000US130630404071,130630404071,"Block Group 1, Census Tract 404.07, Clayton County, Georgia",1919,1069,850,55.7060969255,44.2939030745
982,1500000US130630404072,130630404072,"Block Group 2, Census Tract 404.07, Clayton County, Georgia",2143,1195,948,55.7629491367,44.2370508633
983,1500000US130630404081,130630404081,"Block Group 1, Census Tract 404.08, Clayton County, Georgia",1674,1310,364,78.2556750299,21.7443249701
984,1500000US130630404082,130630404082,"Block Group 2, Census Tract 404.08, Clayton County, Georgia",3097,380,2717,12.2699386503,87.7300613497
985,1500000US130630404083,130630404083,"Block Group 3, Census Tract 404.08, Clayton County, Georgia",2473,1323,1150,53.4977759806,46.5022240194
986,1500000US130630404091,130630404091,"Block Group 1, Census Tract 404.09, Clayton County, Georgia",2270,1291,979,56.872246696,43.127753304
987,1500000US130630404092,130630404092,"Block Group 2, Census Tract 404.09, Clayton County, Georgia",3613,2612,1001,72.2944921118,27.7055078882
988,1500000US130630404101,130630404101,"Block Group 1, Census Tract 404.10, Clayton County, Georgia",5999,3859,2140,64.327387898,35.672612102
989,1500000US130630404102,130630404102,"Block Group 2, Census Tract 404.10, Clayton County, Georgia",1317,495,822,37.5854214123,62.4145785877
990,1500000US130630404111,130630404111,"Block Group 1, Census Tract 404.11, Clayton County, Georgia",2912,2375,537,81.5590659341,18.4409340659
991,1500000US130630404112,130630404112,"Block Group 2, Census Tract 404.11, Clayton County, Georgia",2873,1842,1031,64.1141663766,35.8858336234
992,1500000US130630404113,130630404113,"Block Group 3, Census Tract 404.11, Clayton County, Georgia",2351,2283,68,97.1076137814,2.89238621863
993,1500000US130630404114,130630404114,"Block Group 4, Census Tract 404.11, Clayton County, Georgia",4860,4039,821,83.1069958848,16.8930041152
994,1500000US130630404121,130630404121,"Block Group 1, Census Tract 404.12, Clayton County, Georgia",2743,1608,1135,58.6219467736,41.3780532264
995,1500000US130630404122,130630404122,"Block Group 2, Census Tract 404.12, Clayton County, Georgia",3161,752,2409,23.7899398924,76.2100601076
996,1500000US130630404123,130630404123,"Block Group 3, Census Tract 404.12, Clayton County, Georgia",2139,1669,470,78.0271154745,21.9728845255
997,1500000US130630404131,130630404131,"Block Group 1, Census Tract 404.13, Clayton County, Georgia",2950,1772,1178,60.0677966102,39.9322033898
998,1500000US130630404132,130630404132,"Block Group 2, Census Tract 404.13, Clayton County, Georgia",4002,3213,789,80.2848575712,19.7151424288
999,1500000US130630404141,130630404141,"Block Group 1, Census Tract 404.14, Clayton County, Georgia",1870,655,1215,35.0267379679,64.9732620321
1000,1500000US130630404151,130630404151,"Block Group 1, Census Tract 404.15, Clayton County, Georgia",1458,712,746,48.8340192044,51.1659807956
1001,1500000US130630404152,130630404152,"Block Group 2, Census Tract 404.15, Clayton County, Georgia",1858,856,1002,46.0710441335,53.9289558665
1002,1500000US130630404153,130630404153,"Block Group 3, Census Tract 404.15, Clayton County, Georgia",689,0,689,0.0,100.0
1003,1500000US130630404154,130630404154,"Block Group 4, Census Tract 404.15, Clayton County, Georgia",1985,57,1928,2.87153652393,97.1284634761
1004,1500000US130630404161,130630404161,"Block Group 1, Census Tract 404.16, Clayton County, Georgia",2180,1246,934,57.1559633028,42.8440366972
1005,1500000US130630404162,130630404162,"Block Group 2, Census Tract 404.16, Clayton County, Georgia",1991,1522,469,76.443997991,23.556002009
1006,1500000US130630404171,130630404171,"Block Group 1, Census Tract 404.17, Clayton County, Georgia",2417,593,1824,24.534546959,75.465453041
1007,1500000US130630404172,130630404172,"Block Group 2, Census Tract 404.17, Clayton County, Georgia",791,419,372,52.9709228824,47.0290771176
1008,1500000US130630404173,130630404173,"Block Group 3, Census Tract 404.17, Clayton County, Georgia",1403,0,1403,0.0,100.0
1009,1500000US130630405091,130630405091,"Block Group 1, Census Tract 405.09, Clayton County, Georgia",1909,1310,599,68.6223153483,31.3776846517
1010,1500000US130630405092,130630405092,"Block Group 2, Census Tract 405.09, Clayton County, Georgia",2795,1578,1217,56.457960644,43.542039356
1011,1500000US130630405101,130630405101,"Block Group 1, Census Tract 405.10, Clayton County, Georgia",1793,1055,738,58.8399330731,41.1600669269
1012,1500000US130630405102,130630405102,"Block Group 2, Census Tract 405.10, Clayton County, Georgia",1530,847,683,55.3594771242,44.6405228758
1013,1500000US130630405121,130630405121,"Block Group 1, Census Tract 405.12, Clayton County, Georgia",2436,787,1649,32.3070607553,67.6929392447
1014,1500000US130630405122,130630405122,"Block Group 2, Census Tract 405.12, Clayton County, Georgia",595,576,19,96.8067226891,3.19327731092
1015,1500000US130630405123,130630405123,"Block Group 3, Census Tract 405.12, Clayton County, Georgia",2331,1264,1067,54.2256542257,45.7743457743
1016,1500000US130630405131,130630405131,"Block Group 1, Census Tract 405.13, Clayton County, Georgia",1690,853,837,50.4733727811,49.5266272189
1017,1500000US130630405132,130630405132,"Block Group 2, Census Tract 405.13, Clayton County, Georgia",985,855,130,86.8020304569,13.1979695431
1018,1500000US130630405133,130630405133,"Block Group 3, Census Tract 405.13, Clayton County, Georgia",2098,1182,916,56.3393708294,43.6606291706
1019,1500000US130630405141,130630405141,"Block Group 1, Census Tract 405.14, Clayton County, Georgia",1231,791,440,64.2567018684,35.7432981316
1020,1500000US130630405142,130630405142,"Block Group 2, Census Tract 405.14, Clayton County, Georgia",1717,1002,715,58.3576004659,41.6423995341
1021,1500000US130630405143,130630405143,"Block Group 3, Census Tract 405.14, Clayton County, Georgia",3965,1558,2407,39.2938209332,60.7061790668
1022,1500000US130630405151,130630405151,"Block Group 1, Census Tract 405.15, Clayton County, Georgia",867,533,334,61.476355248,38.523644752
1023,1500000US130630405152,130630405152,"Block Group 2, Census Tract 405.15, Clayton County, Georgia",2225,1757,468,78.9662921348,21.0337078652
1024,1500000US130630405153,130630405153,"Block Group 3, Census Tract 405.15, Clayton County, Georgia",1670,807,863,48.3233532934,51.6766467066
1025,1500000US130630405154,130630405154,"Block Group 4, Census Tract 405.15, Clayton County, Georgia",3010,994,2016,33.023255814,66.976744186
1026,1500000US130630405161,130630405161,"Block Group 1, Census Tract 405.16, Clayton County, Georgia",3561,2239,1322,62.8755967425,37.1244032575
1027,1500000US130630405162,130630405162,"Block Group 2, Census Tract 405.16, Clayton County, Georgia",1293,600,693,46.403712297,53.596287703
1028,1500000US130630405163,130630405163,"Block Group 3, Census Tract 405.16, Clayton County, Georgia",1178,528,650,44.8217317487,55.1782682513
1029,1500000US130630405181,130630405181,"Block Group 1, Census Tract 405.18, Clayton County, Georgia",698,380,318,54.441260745,45.558739255
1030,1500000US130630405182,130630405182,"Block Group 2, Census Tract 405.18, Clayton County, Georgia",2841,1192,1649,41.9570573742,58.0429426258
1031,1500000US130630405183,130630405183,"Block Group 3, Census Tract 405.18, Clayton County, Georgia",1580,692,888,43.7974683544,56.2025316456
1032,1500000US130630405191,130630405191,"Block Group 1, Census Tract 405.19, Clayton County, Georgia",3414,129,3285,3.77855887522,96.2214411248
1033,1500000US130630405192,130630405192,"Block Group 2, Census Tract 405.19, Clayton County, Georgia",785,0,785,0.0,100.0
1034,1500000US130630405201,130630405201,"Block Group 1, Census Tract 405.20, Clayton County, Georgia",818,100,718,12.2249388753,87.7750611247
1035,1500000US130630405202,130630405202,"Block Group 2, Census Tract 405.20, Clayton County, Georgia",580,19,561,3.27586206897,96.724137931
1036,1500000US130630405203,130630405203,"Block Group 3, Census Tract 405.20, Clayton County, Georgia",2044,700,1344,34.2465753425,65.7534246575
1037,1500000US130630405211,130630405211,"Block Group 1, Census Tract 405.21, Clayton County, Georgia",1977,969,1008,49.0136570561,50.9863429439
1038,1500000US130630405212,130630405212,"Block Group 2, Census Tract 405.21, Clayton County, Georgia",1371,885,486,64.5514223195,35.4485776805
1039,1500000US130630405221,130630405221,"Block Group 1, Census Tract 405.22, Clayton County, Georgia",1824,502,1322,27.5219298246,72.4780701754
1040,1500000US130630405222,130630405222,"Block Group 2, Census Tract 405.22, Clayton County, Georgia",1452,399,1053,27.479338843,72.520661157
1041,1500000US130630405223,130630405223,"Block Group 3, Census Tract 405.22, Clayton County, Georgia",1106,477,629,43.1283905967,56.8716094033
1042,1500000US130630405231,130630405231,"Block Group 1, Census Tract 405.23, Clayton County, Georgia",3106,1727,1379,55.602060528,44.397939472
1043,1500000US130630405241,130630405241,"Block Group 1, Census Tract 405.24, Clayton County, Georgia",2086,916,1170,43.9117929051,56.0882070949
1044,1500000US130630405242,130630405242,"Block Group 2, Census Tract 405.24, Clayton County, Georgia",1966,1027,939,52.2380467955,47.7619532045
1045,1500000US130630405243,130630405243,"Block Group 3, Census Tract 405.24, Clayton County, Georgia",1025,532,493,51.9024390244,48.0975609756
1046,1500000US130630405244,130630405244,"Block Group 4, Census Tract 405.24, Clayton County, Georgia",2123,1233,890,58.0781912388,41.9218087612
1047,1500000US130630405251,130630405251,"Block Group 1, Census Tract 405.25, Clayton County, Georgia",2719,1682,1037,61.8609783008,38.1390216992
1048,1500000US130630405261,130630405261,"Block Group 1, Census Tract 405.26, Clayton County, Georgia",2492,1314,1178,52.7287319422,47.2712680578
1049,1500000US130630405262,130630405262,"Block Group 2, Census Tract 405.26, Clayton County, Georgia",2289,635,1654,27.7413717781,72.2586282219
1050,1500000US130630405263,130630405263,"Block Group 3, Census Tract 405.26, Clayton County, Georgia",1565,603,962,38.5303514377,61.4696485623
1051,1500000US130630406061,130630406061,"Block Group 1, Census Tract 406.06, Clayton County, Georgia",1666,1283,383,77.0108043217,22.9891956783
1052,1500000US130630406062,130630406062,"Block Group 2, Census Tract 406.06, Clayton County, Georgia",1335,636,699,47.6404494382,52.3595505618
1053,1500000US130630406081,130630406081,"Block Group 1, Census Tract 406.08, Clayton County, Georgia",8643,5952,2691,68.8649774384,31.1350225616
1054,1500000US130630406082,130630406082,"Block Group 2, Census Tract 406.08, Clayton County, Georgia",2726,1959,767,71.8635363169,28.1364636831
1055,1500000US130630406091,130630406091,"Block Group 1, Census Tract 406.09, Clayton County, Georgia",1631,1134,497,69.5278969957,30.4721030043
1056,1500000US130630406092,130630406092,"Block Group 2, Census Tract 406.09, Clayton County, Georgia",2267,1451,816,64.0052933392,35.9947066608
1057,1500000US130630406093,130630406093,"Block Group 3, Census Tract 406.09, Clayton County, Georgia",2236,1225,1011,54.7853309481,45.2146690519
1058,1500000US130630406111,130630406111,"Block Group 1, Census Tract 406.11, Clayton County, Georgia",3422,958,2464,27.9953243717,72.0046756283
1059,1500000US130630406112,130630406112,"Block Group 2, Census Tract 406.11, Clayton County, Georgia",762,233,529,30.5774278215,69.4225721785
1060,1500000US130630406113,130630406113,"Block Group 3, Census Tract 406.11, Clayton County, Georgia",2025,551,1474,27.2098765432,72.7901234568
1061,1500000US130630406121,130630406121,"Block Group 1, Census Tract 406.12, Clayton County, Georgia",940,388,552,41.2765957447,58.7234042553
1062,1500000US130630406122,130630406122,"Block Group 2, Census Tract 406.12, Clayton County, Georgia",2979,807,2172,27.0896273917,72.9103726083
1063,1500000US130630406123,130630406123,"Block Group 3, Census Tract 406.12, Clayton County, Georgia",1057,913,144,86.3765373699,13.6234626301
1064,1500000US130630406131,130630406131,"Block Group 1, Census Tract 406.13, Clayton County, Georgia",2696,2270,426,84.1988130564,15.8011869436
1065,1500000US130630406132,130630406132,"Block Group 2, Census Tract 406.13, Clayton County, Georgia",2869,989,1880,34.471941443,65.528058557
1066,1500000US130630406133,130630406133,"Block Group 3, Census Tract 406.13, Clayton County, Georgia",2585,2491,94,96.3636363636,3.63636363636
1067,1500000US130630406141,130630406141,"Block Group 1, Census Tract 406.14, Clayton County, Georgia",1207,812,395,67.2742336371,32.7257663629
1068,1500000US130630406142,130630406142,"Block Group 2, Census Tract 406.14, Clayton County, Georgia",1943,1636,307,84.1996911992,15.8003088008
1069,1500000US130630406143,130630406143,"Block Group 3, Census Tract 406.14, Clayton County, Georgia",1677,1186,491,70.7215265355,29.2784734645
1070,1500000US130630406151,130630406151,"Block Group 1, Census Tract 406.15, Clayton County, Georgia",2102,1364,738,64.8905803996,35.1094196004
1071,1500000US130630406161,130630406161,"Block Group 1, Census Tract 406.16, Clayton County, Georgia",5156,842,4314,16.330488751,83.669511249
1072,1500000US130630406162,130630406162,"Block Group 2, Census Tract 406.16, Clayton County, Georgia",737,659,78,89.4165535957,10.5834464043
1073,1500000US130630406163,130630406163,"Block Group 3, Census Tract 406.16, Clayton County, Georgia",2450,1551,899,63.306122449,36.693877551
1074,1500000US130630406171,130630406171,"Block Group 1, Census Tract 406.17, Clayton County, Georgia",1694,1209,485,71.3695395514,28.6304604486
1075,1500000US130630406191,130630406191,"Block Group 1, Census Tract 406.19, Clayton County, Georgia",3526,2398,1128,68.0090754396,31.9909245604
1076,1500000US130630406201,130630406201,"Block Group 1, Census Tract 406.20, Clayton County, Georgia",3287,2763,524,84.0584119258,15.9415880742
1077,1500000US130630406211,130630406211,"Block Group 1, Census Tract 406.21, Clayton County, Georgia",5776,4388,1388,75.9695290859,24.0304709141
1078,1500000US130630406212,130630406212,"Block Group 2, Census Tract 406.21, Clayton County, Georgia",4622,2606,2016,56.3825183903,43.6174816097
1079,1500000US130630406221,130630406221,"Block Group 1, Census Tract 406.22, Clayton County, Georgia",3455,1496,1959,43.2995658466,56.7004341534
1080,1500000US130630406222,130630406222,"Block Group 2, Census Tract 406.22, Clayton County, Georgia",3382,1920,1462,56.7711413365,43.2288586635
1081,1500000US130630406223,130630406223,"Block Group 3, Census Tract 406.22, Clayton County, Georgia",1651,1058,593,64.0823743186,35.9176256814
1082,1500000US130639800001,130639800001,"Block Group 1, Census Tract 9800, Clayton County, Georgia",0,0,0,,
1083,1500000US130659701001,130659701001,"Block Group 1, Census Tract 9701, Clinch County, Georgia",763,508,255,66.5792922674,33.4207077326
1084,1500000US130659701002,130659701002,"Block Group 2, Census Tract 9701, Clinch County, Georgia",1664,1083,581,65.0841346154,34.9158653846
1085,1500000US130659701003,130659701003,"Block Group 3, Census Tract 9701, Clinch County, Georgia",491,327,164,66.5987780041,33.4012219959
1086,1500000US130659701004,130659701004,"Block Group 4, Census Tract 9701, Clinch County, Georgia",864,575,289,66.5509259259,33.4490740741
1087,1500000US130659701005,130659701005,"Block Group 5, Census Tract 9701, Clinch County, Georgia",1175,917,258,78.0425531915,21.9574468085
1088,1500000US130659702001,130659702001,"Block Group 1, Census Tract 9702, Clinch County, Georgia",653,552,101,84.5329249617,15.4670750383
1089,1500000US130659702002,130659702002,"Block Group 2, Census Tract 9702, Clinch County, Georgia",824,331,493,40.1699029126,59.8300970874
1090,1500000US130670301011,130670301011,"Block Group 1, Census Tract 301.01, Cobb County, Georgia",1402,1152,250,82.1683309558,17.8316690442
1091,1500000US130670301012,130670301012,"Block Group 2, Census Tract 301.01, Cobb County, Georgia",1858,1203,655,64.7470398278,35.2529601722
1092,1500000US130670301013,130670301013,"Block Group 3, Census Tract 301.01, Cobb County, Georgia",2656,1962,694,73.8704819277,26.1295180723
1093,1500000US130670301014,130670301014,"Block Group 4, Census Tract 301.01, Cobb County, Georgia",1883,1573,310,83.5369091875,16.4630908125
1094,1500000US130670301031,130670301031,"Block Group 1, Census Tract 301.03, Cobb County, Georgia",2252,1203,1049,53.4191829485,46.5808170515
1095,1500000US130670301032,130670301032,"Block Group 2, Census Tract 301.03, Cobb County, Georgia",2769,2091,678,75.5146262189,24.4853737811
1096,1500000US130670301033,130670301033,"Block Group 3, Census Tract 301.03, Cobb County, Georgia",4074,3248,826,79.7250859107,20.2749140893
1097,1500000US130670301041,130670301041,"Block Group 1, Census Tract 301.04, Cobb County, Georgia",951,298,653,31.3354363828,68.6645636172
1098,1500000US130670301042,130670301042,"Block Group 2, Census Tract 301.04, Cobb County, Georgia",2695,1714,981,63.599257885,36.400742115
1099,1500000US130670301061,130670301061,"Block Group 1, Census Tract 301.06, Cobb County, Georgia",2365,2047,318,86.5539112051,13.4460887949
1100,1500000US130670301062,130670301062,"Block Group 2, Census Tract 301.06, Cobb County, Georgia",2241,1907,334,85.0959393128,14.9040606872
1101,1500000US130670301063,130670301063,"Block Group 3, Census Tract 301.06, Cobb County, Georgia",3234,931,2303,28.7878787879,71.2121212121
1102,1500000US130670301071,130670301071,"Block Group 1, Census Tract 301.07, Cobb County, Georgia",1813,1622,191,89.4649751793,10.5350248207
1103,1500000US130670301072,130670301072,"Block Group 2, Census Tract 301.07, Cobb County, Georgia",3006,2576,430,85.6952761144,14.3047238856
1104,1500000US130670302091,130670302091,"Block Group 1, Census Tract 302.09, Cobb County, Georgia",1727,1607,120,93.0515344528,6.94846554719
1105,1500000US130670302092,130670302092,"Block Group 2, Census Tract 302.09, Cobb County, Georgia",1980,1902,78,96.0606060606,3.93939393939
1106,1500000US130670302093,130670302093,"Block Group 3, Census Tract 302.09, Cobb County, Georgia",2961,2787,174,94.1236068896,5.87639311044
1107,1500000US130670302141,130670302141,"Block Group 1, Census Tract 302.14, Cobb County, Georgia",2945,2687,258,91.2393887946,8.76061120543
1108,1500000US130670302142,130670302142,"Block Group 2, Census Tract 302.14, Cobb County, Georgia",2324,1619,705,69.6643717728,30.3356282272
1109,1500000US130670302143,130670302143,"Block Group 3, Census Tract 302.14, Cobb County, Georgia",2921,2571,350,88.0178021226,11.9821978774
1110,1500000US130670302151,130670302151,"Block Group 1, Census Tract 302.15, Cobb County, Georgia",2687,2439,248,90.7703758839,9.22962411611
1111,1500000US130670302152,130670302152,"Block Group 2, Census Tract 302.15, Cobb County, Georgia",2212,1464,748,66.1844484629,33.8155515371
1112,1500000US130670302153,130670302153,"Block Group 3, Census Tract 302.15, Cobb County, Georgia",1559,1036,523,66.4528543938,33.5471456062
1113,1500000US130670302154,130670302154,"Block Group 4, Census Tract 302.15, Cobb County, Georgia",2968,2595,373,87.4326145553,12.5673854447
1114,1500000US130670302181,130670302181,"Block Group 1, Census Tract 302.18, Cobb County, Georgia",2864,2668,196,93.156424581,6.84357541899
1115,1500000US130670302182,130670302182,"Block Group 2, Census Tract 302.18, Cobb County, Georgia",2777,2434,343,87.6485415916,12.3514584084
1116,1500000US130670302191,130670302191,"Block Group 1, Census Tract 302.19, Cobb County, Georgia",2257,1988,269,88.0815241471,11.9184758529
1117,1500000US130670302192,130670302192,"Block Group 2, Census Tract 302.19, Cobb County, Georgia",2357,2215,142,93.975392448,6.02460755197
1118,1500000US130670302193,130670302193,"Block Group 3, Census Tract 302.19, Cobb County, Georgia",2215,2202,13,99.4130925508,0.58690744921
1119,1500000US130670302194,130670302194,"Block Group 4, Census Tract 302.19, Cobb County, Georgia",2406,2296,110,95.4280964256,4.5719035744
1120,1500000US130670302201,130670302201,"Block Group 1, Census Tract 302.20, Cobb County, Georgia",1866,1418,448,75.9914255091,24.0085744909
1121,1500000US130670302221,130670302221,"Block Group 1, Census Tract 302.22, Cobb County, Georgia",2660,2502,158,94.0601503759,5.93984962406
1122,1500000US130670302222,130670302222,"Block Group 2, Census Tract 302.22, Cobb County, Georgia",2365,2033,332,85.9619450317,14.0380549683
1123,1500000US130670302223,130670302223,"Block Group 3, Census Tract 302.22, Cobb County, Georgia",860,778,82,90.4651162791,9.53488372093
1124,1500000US130670302231,130670302231,"Block Group 1, Census Tract 302.23, Cobb County, Georgia",3135,1985,1150,63.31738437,36.68261563
1125,1500000US130670302232,130670302232,"Block Group 2, Census Tract 302.23, Cobb County, Georgia",2132,872,1260,40.9005628518,59.0994371482
1126,1500000US130670302233,130670302233,"Block Group 3, Census Tract 302.23, Cobb County, Georgia",650,650,0,100.0,0.0
1127,1500000US130670302241,130670302241,"Block Group 1, Census Tract 302.24, Cobb County, Georgia",5609,4276,1333,76.2346229274,23.7653770726
1128,1500000US130670302242,130670302242,"Block Group 2, Census Tract 302.24, Cobb County, Georgia",1040,618,422,59.4230769231,40.5769230769
1129,1500000US130670302261,130670302261,"Block Group 1, Census Tract 302.26, Cobb County, Georgia",4182,2402,1780,57.4366331899,42.5633668101
1130,1500000US130670302262,130670302262,"Block Group 2, Census Tract 302.26, Cobb County, Georgia",1749,1339,410,76.5580331618,23.4419668382
1131,1500000US130670302263,130670302263,"Block Group 3, Census Tract 302.26, Cobb County, Georgia",2959,2801,158,94.6603582291,5.33964177087
1132,1500000US130670302271,130670302271,"Block Group 1, Census Tract 302.27, Cobb County, Georgia",2002,1028,974,51.3486513487,48.6513486513
1133,1500000US130670302272,130670302272,"Block Group 2, Census Tract 302.27, Cobb County, Georgia",3512,1950,1562,55.5239179954,44.4760820046
1134,1500000US130670302273,130670302273,"Block Group 3, Census Tract 302.27, Cobb County, Georgia",2367,1377,990,58.174904943,41.825095057
1135,1500000US130670302281,130670302281,"Block Group 1, Census Tract 302.28, Cobb County, Georgia",2369,294,2075,12.4102997045,87.5897002955
1136,1500000US130670302282,130670302282,"Block Group 2, Census Tract 302.28, Cobb County, Georgia",1212,79,1133,6.51815181518,93.4818481848
1137,1500000US130670302283,130670302283,"Block Group 3, Census Tract 302.28, Cobb County, Georgia",2131,1681,450,78.8831534491,21.1168465509
1138,1500000US130670302284,130670302284,"Block Group 4, Census Tract 302.28, Cobb County, Georgia",1377,333,1044,24.1830065359,75.8169934641
1139,1500000US130670302291,130670302291,"Block Group 1, Census Tract 302.29, Cobb County, Georgia",171,43,128,25.1461988304,74.8538011696
1140,1500000US130670302292,130670302292,"Block Group 2, Census Tract 302.29, Cobb County, Georgia",2514,1426,1088,56.722354813,43.277645187
1141,1500000US130670302301,130670302301,"Block Group 1, Census Tract 302.30, Cobb County, Georgia",7425,3749,3676,50.4915824916,49.5084175084
1142,1500000US130670302302,130670302302,"Block Group 2, Census Tract 302.30, Cobb County, Georgia",5400,3525,1875,65.2777777778,34.7222222222
1143,1500000US130670302311,130670302311,"Block Group 1, Census Tract 302.31, Cobb County, Georgia",827,708,119,85.6106408706,14.3893591294
1144,1500000US130670302312,130670302312,"Block Group 2, Census Tract 302.31, Cobb County, Georgia",1777,1610,167,90.6021384356,9.39786156443
1145,1500000US130670302313,130670302313,"Block Group 3, Census Tract 302.31, Cobb County, Georgia",1750,1622,128,92.6857142857,7.31428571429
1146,1500000US130670302314,130670302314,"Block Group 4, Census Tract 302.31, Cobb County, Georgia",2838,2744,94,96.6878083157,3.31219168428
1147,1500000US130670302321,130670302321,"Block Group 1, Census Tract 302.32, Cobb County, Georgia",2481,2299,182,92.664248287,7.33575171302
1148,1500000US130670302322,130670302322,"Block Group 2, Census Tract 302.32, Cobb County, Georgia",3201,2524,677,78.8503592627,21.1496407373
1149,1500000US130670302331,130670302331,"Block Group 1, Census Tract 302.33, Cobb County, Georgia",1411,1123,288,79.5889440113,20.4110559887
1150,1500000US130670302332,130670302332,"Block Group 2, Census Tract 302.33, Cobb County, Georgia",2830,2681,149,94.7349823322,5.26501766784
1151,1500000US130670302341,130670302341,"Block Group 1, Census Tract 302.34, Cobb County, Georgia",3140,3110,30,99.0445859873,0.955414012739
1152,1500000US130670302342,130670302342,"Block Group 2, Census Tract 302.34, Cobb County, Georgia",2959,2762,197,93.342345387,6.65765461304
1153,1500000US130670302351,130670302351,"Block Group 1, Census Tract 302.35, Cobb County, Georgia",1696,1647,49,97.1108490566,2.8891509434
1154,1500000US130670302352,130670302352,"Block Group 2, Census Tract 302.35, Cobb County, Georgia",3184,2934,250,92.148241206,7.85175879397
1155,1500000US130670302361,130670302361,"Block Group 1, Census Tract 302.36, Cobb County, Georgia",2306,2207,99,95.7068516912,4.29314830876
1156,1500000US130670302362,130670302362,"Block Group 2, Census Tract 302.36, Cobb County, Georgia",2451,2310,141,94.247246022,5.75275397797
1157,1500000US130670302381,130670302381,"Block Group 1, Census Tract 302.38, Cobb County, Georgia",3335,3335,0,100.0,0.0
1158,1500000US130670302382,130670302382,"Block Group 2, Census Tract 302.38, Cobb County, Georgia",3376,2688,688,79.6208530806,20.3791469194
1159,1500000US130670302391,130670302391,"Block Group 1, Census Tract 302.39, Cobb County, Georgia",1978,1738,240,87.8665318504,12.1334681496
1160,1500000US130670302392,130670302392,"Block Group 2, Census Tract 302.39, Cobb County, Georgia",3033,2846,187,93.8344873063,6.1655126937
1161,1500000US130670302393,130670302393,"Block Group 3, Census Tract 302.39, Cobb County, Georgia",3453,3421,32,99.0732696206,0.92673037938
1162,1500000US130670303101,130670303101,"Block Group 1, Census Tract 303.10, Cobb County, Georgia",1495,783,712,52.3745819398,47.6254180602
1163,1500000US130670303102,130670303102,"Block Group 2, Census Tract 303.10, Cobb County, Georgia",2526,1899,627,75.1781472684,24.8218527316
1164,1500000US130670303103,130670303103,"Block Group 3, Census Tract 303.10, Cobb County, Georgia",687,687,0,100.0,0.0
1165,1500000US130670303104,130670303104,"Block Group 4, Census Tract 303.10, Cobb County, Georgia",1998,1280,718,64.0640640641,35.9359359359
1166,1500000US130670303105,130670303105,"Block Group 5, Census Tract 303.10, Cobb County, Georgia",1415,896,519,63.3215547703,36.6784452297
1167,1500000US130670303111,130670303111,"Block Group 1, Census Tract 303.11, Cobb County, Georgia",1687,1415,272,83.8767042087,16.1232957913
1168,1500000US130670303112,130670303112,"Block Group 2, Census Tract 303.11, Cobb County, Georgia",1137,1117,20,98.2409850484,1.75901495163
1169,1500000US130670303113,130670303113,"Block Group 3, Census Tract 303.11, Cobb County, Georgia",973,921,52,94.6557040082,5.34429599178
1170,1500000US130670303114,130670303114,"Block Group 4, Census Tract 303.11, Cobb County, Georgia",2066,1326,740,64.1819941917,35.8180058083
1171,1500000US130670303121,130670303121,"Block Group 1, Census Tract 303.12, Cobb County, Georgia",2622,2390,232,91.1517925248,8.84820747521
1172,1500000US130670303122,130670303122,"Block Group 2, Census Tract 303.12, Cobb County, Georgia",1380,1001,379,72.5362318841,27.4637681159
1173,1500000US130670303123,130670303123,"Block Group 3, Census Tract 303.12, Cobb County, Georgia",1373,1237,136,90.0946831755,9.90531682447
1174,1500000US130670303124,130670303124,"Block Group 4, Census Tract 303.12, Cobb County, Georgia",686,538,148,78.4256559767,21.5743440233
1175,1500000US130670303131,130670303131,"Block Group 1, Census Tract 303.13, Cobb County, Georgia",1697,1455,242,85.7395403654,14.2604596346
1176,1500000US130670303132,130670303132,"Block Group 2, Census Tract 303.13, Cobb County, Georgia",679,359,320,52.8718703976,47.1281296024
1177,1500000US130670303133,130670303133,"Block Group 3, Census Tract 303.13, Cobb County, Georgia",1109,853,256,76.9161406673,23.0838593327
1178,1500000US130670303134,130670303134,"Block Group 4, Census Tract 303.13, Cobb County, Georgia",1751,1347,404,76.9274700171,23.0725299829
1179,1500000US130670303135,130670303135,"Block Group 5, Census Tract 303.13, Cobb County, Georgia",3156,2421,735,76.711026616,23.288973384
1180,1500000US130670303141,130670303141,"Block Group 1, Census Tract 303.14, Cobb County, Georgia",2244,2159,85,96.2121212121,3.78787878788
1181,1500000US130670303142,130670303142,"Block Group 2, Census Tract 303.14, Cobb County, Georgia",2243,2135,108,95.1850200624,4.81497993758
1182,1500000US130670303143,130670303143,"Block Group 3, Census Tract 303.14, Cobb County, Georgia",3414,2931,483,85.8523725835,14.1476274165
1183,1500000US130670303181,130670303181,"Block Group 1, Census Tract 303.18, Cobb County, Georgia",2577,2457,120,95.3434225844,4.6565774156
1184,1500000US130670303182,130670303182,"Block Group 2, Census Tract 303.18, Cobb County, Georgia",2733,2647,86,96.8532747896,3.14672521039
1185,1500000US130670303183,130670303183,"Block Group 3, Census Tract 303.18, Cobb County, Georgia",2677,2299,378,85.8797161001,14.1202838999
1186,1500000US130670303191,130670303191,"Block Group 1, Census Tract 303.19, Cobb County, Georgia",1896,1611,285,84.9683544304,15.0316455696
1187,1500000US130670303192,130670303192,"Block Group 2, Census Tract 303.19, Cobb County, Georgia",2369,2110,259,89.067116927,10.932883073
1188,1500000US130670303201,130670303201,"Block Group 1, Census Tract 303.20, Cobb County, Georgia",2908,1478,1430,50.8253094911,49.1746905089
1189,1500000US130670303202,130670303202,"Block Group 2, Census Tract 303.20, Cobb County, Georgia",2757,2464,293,89.3725063475,10.6274936525
1190,1500000US130670303203,130670303203,"Block Group 3, Census Tract 303.20, Cobb County, Georgia",2206,858,1348,38.8939256573,61.1060743427
1191,1500000US130670303221,130670303221,"Block Group 1, Census Tract 303.22, Cobb County, Georgia",1312,1076,236,82.012195122,17.987804878
1192,1500000US130670303222,130670303222,"Block Group 2, Census Tract 303.22, Cobb County, Georgia",2101,1999,102,95.1451689672,4.85483103284
1193,1500000US130670303241,130670303241,"Block Group 1, Census Tract 303.24, Cobb County, Georgia",1801,1732,69,96.1687951138,3.83120488617
1194,1500000US130670303242,130670303242,"Block Group 2, Census Tract 303.24, Cobb County, Georgia",1718,1314,404,76.4842840512,23.5157159488
1195,1500000US130670303261,130670303261,"Block Group 1, Census Tract 303.26, Cobb County, Georgia",1566,1529,37,97.6372924649,2.36270753512
1196,1500000US130670303262,130670303262,"Block Group 2, Census Tract 303.26, Cobb County, Georgia",1978,1978,0,100.0,0.0
1197,1500000US130670303263,130670303263,"Block Group 3, Census Tract 303.26, Cobb County, Georgia",1102,735,367,66.6969147005,33.3030852995
1198,1500000US130670303271,130670303271,"Block Group 1, Census Tract 303.27, Cobb County, Georgia",3082,2658,424,86.2426995457,13.7573004543
1199,1500000US130670303272,130670303272,"Block Group 2, Census Tract 303.27, Cobb County, Georgia",1328,1168,160,87.9518072289,12.0481927711
1200,1500000US130670303281,130670303281,"Block Group 1, Census Tract 303.28, Cobb County, Georgia",1867,1634,233,87.520085699,12.479914301
1201,1500000US130670303282,130670303282,"Block Group 2, Census Tract 303.28, Cobb County, Georgia",2539,2277,262,89.6809767625,10.3190232375
1202,1500000US130670303283,130670303283,"Block Group 3, Census Tract 303.28, Cobb County, Georgia",2001,2001,0,100.0,0.0
1203,1500000US130670303291,130670303291,"Block Group 1, Census Tract 303.29, Cobb County, Georgia",2809,2479,330,88.2520469918,11.7479530082
1204,1500000US130670303292,130670303292,"Block Group 2, Census Tract 303.29, Cobb County, Georgia",1498,1442,56,96.261682243,3.73831775701
1205,1500000US130670303301,130670303301,"Block Group 1, Census Tract 303.30, Cobb County, Georgia",1756,1547,209,88.0979498861,11.9020501139
1206,1500000US130670303302,130670303302,"Block Group 2, Census Tract 303.30, Cobb County, Georgia",2447,2294,153,93.7474458521,6.25255414794
1207,1500000US130670303303,130670303303,"Block Group 3, Census Tract 303.30, Cobb County, Georgia",1654,1580,74,95.5259975816,4.47400241838
1208,1500000US130670303311,130670303311,"Block Group 1, Census Tract 303.31, Cobb County, Georgia",2412,2193,219,90.92039801,9.07960199005
1209,1500000US130670303312,130670303312,"Block Group 2, Census Tract 303.31, Cobb County, Georgia",2250,2000,250,88.8888888889,11.1111111111
1210,1500000US130670303313,130670303313,"Block Group 3, Census Tract 303.31, Cobb County, Georgia",1031,873,158,84.6750727449,15.3249272551
1211,1500000US130670303321,130670303321,"Block Group 1, Census Tract 303.32, Cobb County, Georgia",1527,1426,101,93.3857236411,6.61427635887
1212,1500000US130670303322,130670303322,"Block Group 2, Census Tract 303.32, Cobb County, Georgia",1892,1727,165,91.2790697674,8.72093023256
1213,1500000US130670303331,130670303331,"Block Group 1, Census Tract 303.33, Cobb County, Georgia",2782,2490,292,89.5039539899,10.4960460101
1214,1500000US130670303332,130670303332,"Block Group 2, Census Tract 303.33, Cobb County, Georgia",1857,1771,86,95.3688745288,4.63112547119
1215,1500000US130670303333,130670303333,"Block Group 3, Census Tract 303.33, Cobb County, Georgia",1273,1168,105,91.7517674784,8.2482325216
1216,1500000US130670303341,130670303341,"Block Group 1, Census Tract 303.34, Cobb County, Georgia",1385,1330,55,96.0288808664,3.97111913357
1217,1500000US130670303342,130670303342,"Block Group 2, Census Tract 303.34, Cobb County, Georgia",1894,1495,399,78.9334741288,21.0665258712
1218,1500000US130670303351,130670303351,"Block Group 1, Census Tract 303.35, Cobb County, Georgia",2471,2254,217,91.2181303116,8.78186968839
1219,1500000US130670303352,130670303352,"Block Group 2, Census Tract 303.35, Cobb County, Georgia",2101,2061,40,98.096144693,1.903855307
1220,1500000US130670303361,130670303361,"Block Group 1, Census Tract 303.36, Cobb County, Georgia",1946,1917,29,98.5097636177,1.49023638232
1221,1500000US130670303362,130670303362,"Block Group 2, Census Tract 303.36, Cobb County, Georgia",1556,1338,218,85.9897172237,14.0102827763
1222,1500000US130670303363,130670303363,"Block Group 3, Census Tract 303.36, Cobb County, Georgia",2336,2227,109,95.3339041096,4.66609589041
1223,1500000US130670303364,130670303364,"Block Group 4, Census Tract 303.36, Cobb County, Georgia",1468,1393,75,94.8910081744,5.10899182561
1224,1500000US130670303371,130670303371,"Block Group 1, Census Tract 303.37, Cobb County, Georgia",1521,1472,49,96.77843524,3.22156476003
1225,1500000US130670303372,130670303372,"Block Group 2, Census Tract 303.37, Cobb County, Georgia",1902,1708,194,89.8002103049,10.1997896951
1226,1500000US130670303373,130670303373,"Block Group 3, Census Tract 303.37, Cobb County, Georgia",994,973,21,97.8873239437,2.11267605634
1227,1500000US130670303391,130670303391,"Block Group 1, Census Tract 303.39, Cobb County, Georgia",1439,13,1426,0.90340514246,99.0965948575
1228,1500000US130670303392,130670303392,"Block Group 2, Census Tract 303.39, Cobb County, Georgia",4423,754,3669,17.0472529957,82.9527470043
1229,1500000US130670303401,130670303401,"Block Group 1, Census Tract 303.40, Cobb County, Georgia",1802,1673,129,92.8412874584,7.15871254162
1230,1500000US130670303402,130670303402,"Block Group 2, Census Tract 303.40, Cobb County, Georgia",2141,2141,0,100.0,0.0
1231,1500000US130670303411,130670303411,"Block Group 1, Census Tract 303.41, Cobb County, Georgia",2154,2007,147,93.1754874652,6.82451253482
1232,1500000US130670303412,130670303412,"Block Group 2, Census Tract 303.41, Cobb County, Georgia",2283,1705,578,74.682435392,25.317564608
1233,1500000US130670303421,130670303421,"Block Group 1, Census Tract 303.42, Cobb County, Georgia",1801,1503,298,83.4536368684,16.5463631316
1234,1500000US130670303422,130670303422,"Block Group 2, Census Tract 303.42, Cobb County, Georgia",2935,2659,276,90.5962521295,9.40374787053
1235,1500000US130670303431,130670303431,"Block Group 1, Census Tract 303.43, Cobb County, Georgia",1734,1630,104,94.0023068051,5.99769319493
1236,1500000US130670303432,130670303432,"Block Group 2, Census Tract 303.43, Cobb County, Georgia",1722,1652,70,95.9349593496,4.06504065041
1237,1500000US130670303433,130670303433,"Block Group 3, Census Tract 303.43, Cobb County, Georgia",1137,1114,23,97.9771328056,2.02286719437
1238,1500000US130670303441,130670303441,"Block Group 1, Census Tract 303.44, Cobb County, Georgia",2402,446,1956,18.5678601166,81.4321398834
1239,1500000US130670303442,130670303442,"Block Group 2, Census Tract 303.44, Cobb County, Georgia",732,0,732,0.0,100.0
1240,1500000US130670303443,130670303443,"Block Group 3, Census Tract 303.44, Cobb County, Georgia",474,0,474,0.0,100.0
1241,1500000US130670303451,130670303451,"Block Group 1, Census Tract 303.45, Cobb County, Georgia",2693,462,2231,17.1555885629,82.8444114371
1242,1500000US130670303452,130670303452,"Block Group 2, Census Tract 303.45, Cobb County, Georgia",347,0,347,0.0,100.0
1243,1500000US130670303453,130670303453,"Block Group 3, Census Tract 303.45, Cobb County, Georgia",1912,38,1874,1.98744769874,98.0125523013
1244,1500000US130670304051,130670304051,"Block Group 1, Census Tract 304.05, Cobb County, Georgia",2611,782,1829,29.9502106473,70.0497893527
1245,1500000US130670304052,130670304052,"Block Group 2, Census Tract 304.05, Cobb County, Georgia",1169,984,185,84.1745081266,15.8254918734
1246,1500000US130670304053,130670304053,"Block Group 3, Census Tract 304.05, Cobb County, Georgia",1829,187,1642,10.224166211,89.775833789
1247,1500000US130670304054,130670304054,"Block Group 4, Census Tract 304.05, Cobb County, Georgia",575,225,350,39.1304347826,60.8695652174
1248,1500000US130670304071,130670304071,"Block Group 1, Census Tract 304.07, Cobb County, Georgia",1900,1786,114,94.0,6.0
1249,1500000US130670304072,130670304072,"Block Group 2, Census Tract 304.07, Cobb County, Georgia",1451,859,592,59.2005513439,40.7994486561
1250,1500000US130670304073,130670304073,"Block Group 3, Census Tract 304.07, Cobb County, Georgia",1491,925,566,62.0389000671,37.9610999329
1251,1500000US130670304081,130670304081,"Block Group 1, Census Tract 304.08, Cobb County, Georgia",1557,645,912,41.4258188825,58.5741811175
1252,1500000US130670304082,130670304082,"Block Group 2, Census Tract 304.08, Cobb County, Georgia",1577,1042,535,66.0748256183,33.9251743817
1253,1500000US130670304091,130670304091,"Block Group 1, Census Tract 304.09, Cobb County, Georgia",2000,1685,315,84.25,15.75
1254,1500000US130670304092,130670304092,"Block Group 2, Census Tract 304.09, Cobb County, Georgia",1576,1481,95,93.9720812183,6.02791878173
1255,1500000US130670304101,130670304101,"Block Group 1, Census Tract 304.10, Cobb County, Georgia",2587,1376,1211,53.1890220332,46.8109779668
1256,1500000US130670304102,130670304102,"Block Group 2, Census Tract 304.10, Cobb County, Georgia",2242,689,1553,30.7314897413,69.2685102587
1257,1500000US130670304111,130670304111,"Block Group 1, Census Tract 304.11, Cobb County, Georgia",1014,0,1014,0.0,100.0
1258,1500000US130670304112,130670304112,"Block Group 2, Census Tract 304.11, Cobb County, Georgia",1009,239,770,23.6868186323,76.3131813677
1259,1500000US130670304113,130670304113,"Block Group 3, Census Tract 304.11, Cobb County, Georgia",1566,0,1566,0.0,100.0
1260,1500000US130670304121,130670304121,"Block Group 1, Census Tract 304.12, Cobb County, Georgia",401,145,256,36.1596009975,63.8403990025
1261,1500000US130670304122,130670304122,"Block Group 2, Census Tract 304.12, Cobb County, Georgia",3313,159,3154,4.79927558104,95.200724419
1262,1500000US130670304123,130670304123,"Block Group 3, Census Tract 304.12, Cobb County, Georgia",398,245,153,61.5577889447,38.4422110553
1263,1500000US130670304124,130670304124,"Block Group 4, Census Tract 304.12, Cobb County, Georgia",356,0,356,0.0,100.0
1264,1500000US130670304131,130670304131,"Block Group 1, Census Tract 304.13, Cobb County, Georgia",1861,191,1670,10.2632993015,89.7367006985
1265,1500000US130670304132,130670304132,"Block Group 2, Census Tract 304.13, Cobb County, Georgia",2109,99,2010,4.69416785206,95.3058321479
1266,1500000US130670304133,130670304133,"Block Group 3, Census Tract 304.13, Cobb County, Georgia",2073,340,1733,16.4013506995,83.5986493005
1267,1500000US130670304141,130670304141,"Block Group 1, Census Tract 304.14, Cobb County, Georgia",2038,0,2038,0.0,100.0
1268,1500000US130670304142,130670304142,"Block Group 2, Census Tract 304.14, Cobb County, Georgia",912,0,912,0.0,100.0
1269,1500000US130670305021,130670305021,"Block Group 1, Census Tract 305.02, Cobb County, Georgia",3077,2519,558,81.8654533637,18.1345466363
1270,1500000US130670305022,130670305022,"Block Group 2, Census Tract 305.02, Cobb County, Georgia",2437,1706,731,70.0041034058,29.9958965942
1271,1500000US130670305023,130670305023,"Block Group 3, Census Tract 305.02, Cobb County, Georgia",1184,1071,113,90.4560810811,9.54391891892
1272,1500000US130670305041,130670305041,"Block Group 1, Census Tract 305.04, Cobb County, Georgia",3454,3075,379,89.0272148234,10.9727851766
1273,1500000US130670305042,130670305042,"Block Group 2, Census Tract 305.04, Cobb County, Georgia",1124,948,176,84.3416370107,15.6583629893
1274,1500000US130670305043,130670305043,"Block Group 3, Census Tract 305.04, Cobb County, Georgia",1769,479,1290,27.0774448841,72.9225551159
1275,1500000US130670305044,130670305044,"Block Group 4, Census Tract 305.04, Cobb County, Georgia",457,210,247,45.9518599562,54.0481400438
1276,1500000US130670305051,130670305051,"Block Group 1, Census Tract 305.05, Cobb County, Georgia",1707,516,1191,30.2284710018,69.7715289982
1277,1500000US130670305052,130670305052,"Block Group 2, Census Tract 305.05, Cobb County, Georgia",1801,210,1591,11.660188784,88.339811216
1278,1500000US130670305053,130670305053,"Block Group 3, Census Tract 305.05, Cobb County, Georgia",1514,0,1514,0.0,100.0
1279,1500000US130670305054,130670305054,"Block Group 4, Census Tract 305.05, Cobb County, Georgia",2037,844,1193,41.4334806087,58.5665193913
1280,1500000US130670305061,130670305061,"Block Group 1, Census Tract 305.06, Cobb County, Georgia",2354,852,1502,36.1937128292,63.8062871708
1281,1500000US130670305062,130670305062,"Block Group 2, Census Tract 305.06, Cobb County, Georgia",1822,1498,324,82.2173435785,17.7826564215
1282,1500000US130670305071,130670305071,"Block Group 1, Census Tract 305.07, Cobb County, Georgia",3123,2177,946,69.7086135126,30.2913864874
1283,1500000US130670305072,130670305072,"Block Group 2, Census Tract 305.07, Cobb County, Georgia",1899,1557,342,81.990521327,18.009478673
1284,1500000US130670306011,130670306011,"Block Group 1, Census Tract 306.01, Cobb County, Georgia",3225,616,2609,19.1007751938,80.8992248062
1285,1500000US130670306012,130670306012,"Block Group 2, Census Tract 306.01, Cobb County, Georgia",1345,786,559,58.43866171,41.56133829
1286,1500000US130670306013,130670306013,"Block Group 3, Census Tract 306.01, Cobb County, Georgia",4539,1462,3077,32.2097378277,67.7902621723
1287,1500000US130670306021,130670306021,"Block Group 1, Census Tract 306.02, Cobb County, Georgia",2745,2381,364,86.7395264117,13.2604735883
1288,1500000US130670306022,130670306022,"Block Group 2, Census Tract 306.02, Cobb County, Georgia",113,11,102,9.73451327434,90.2654867257
1289,1500000US130670306023,130670306023,"Block Group 3, Census Tract 306.02, Cobb County, Georgia",2316,1054,1262,45.5094991364,54.4905008636
1290,1500000US130670306024,130670306024,"Block Group 4, Census Tract 306.02, Cobb County, Georgia",975,468,507,48.0,52.0
1291,1500000US130670307001,130670307001,"Block Group 1, Census Tract 307, Cobb County, Georgia",1382,192,1190,13.8929088278,86.1070911722
1292,1500000US130670307002,130670307002,"Block Group 2, Census Tract 307, Cobb County, Georgia",1004,717,287,71.4143426295,28.5856573705
1293,1500000US130670307003,130670307003,"Block Group 3, Census Tract 307, Cobb County, Georgia",797,409,388,51.3174404015,48.6825595985
1294,1500000US130670307004,130670307004,"Block Group 4, Census Tract 307, Cobb County, Georgia",641,338,303,52.7301092044,47.2698907956
1295,1500000US130670308001,130670308001,"Block Group 1, Census Tract 308, Cobb County, Georgia",1187,154,1033,12.9738837405,87.0261162595
1296,1500000US130670308002,130670308002,"Block Group 2, Census Tract 308, Cobb County, Georgia",1384,154,1230,11.1271676301,88.8728323699
1297,1500000US130670308003,130670308003,"Block Group 3, Census Tract 308, Cobb County, Georgia",1113,462,651,41.5094339623,58.4905660377
1298,1500000US130670309011,130670309011,"Block Group 1, Census Tract 309.01, Cobb County, Georgia",589,585,4,99.3208828523,0.679117147708
1299,1500000US130670309012,130670309012,"Block Group 2, Census Tract 309.01, Cobb County, Georgia",1134,1119,15,98.6772486772,1.32275132275
1300,1500000US130670309013,130670309013,"Block Group 3, Census Tract 309.01, Cobb County, Georgia",1759,363,1396,20.6367254122,79.3632745878
1301,1500000US130670309014,130670309014,"Block Group 4, Census Tract 309.01, Cobb County, Georgia",1229,1190,39,96.8266883645,3.17331163548
1302,1500000US130670309015,130670309015,"Block Group 5, Census Tract 309.01, Cobb County, Georgia",2742,1364,1378,49.7447118891,50.2552881109
1303,1500000US130670309021,130670309021,"Block Group 1, Census Tract 309.02, Cobb County, Georgia",1287,385,902,29.9145299145,70.0854700855
1304,1500000US130670309022,130670309022,"Block Group 2, Census Tract 309.02, Cobb County, Georgia",2287,625,1662,27.3283777875,72.6716222125
1305,1500000US130670309023,130670309023,"Block Group 3, Census Tract 309.02, Cobb County, Georgia",1354,1107,247,81.7577548006,18.2422451994
1306,1500000US130670309024,130670309024,"Block Group 4, Census Tract 309.02, Cobb County, Georgia",840,510,330,60.7142857143,39.2857142857
1307,1500000US130670309041,130670309041,"Block Group 1, Census Tract 309.04, Cobb County, Georgia",1529,597,932,39.0451275343,60.9548724657
1308,1500000US130670309042,130670309042,"Block Group 2, Census Tract 309.04, Cobb County, Georgia",1723,662,1061,38.4213580963,61.5786419037
1309,1500000US130670309043,130670309043,"Block Group 3, Census Tract 309.04, Cobb County, Georgia",1679,354,1325,21.0839785587,78.9160214413
1310,1500000US130670309044,130670309044,"Block Group 4, Census Tract 309.04, Cobb County, Georgia",1615,542,1073,33.560371517,66.439628483
1311,1500000US130670309051,130670309051,"Block Group 1, Census Tract 309.05, Cobb County, Georgia",474,377,97,79.5358649789,20.4641350211
1312,1500000US130670309052,130670309052,"Block Group 2, Census Tract 309.05, Cobb County, Georgia",833,514,319,61.7046818727,38.2953181273
1313,1500000US130670309053,130670309053,"Block Group 3, Census Tract 309.05, Cobb County, Georgia",3511,2476,1035,70.5212190259,29.4787809741
1314,1500000US130670309054,130670309054,"Block Group 4, Census Tract 309.05, Cobb County, Georgia",930,882,48,94.8387096774,5.16129032258
1315,1500000US130670310011,130670310011,"Block Group 1, Census Tract 310.01, Cobb County, Georgia",1634,611,1023,37.3929008568,62.6070991432
1316,1500000US130670310012,130670310012,"Block Group 2, Census Tract 310.01, Cobb County, Georgia",918,259,659,28.2135076253,71.7864923747
1317,1500000US130670310013,130670310013,"Block Group 3, Census Tract 310.01, Cobb County, Georgia",2987,898,2089,30.0636089722,69.9363910278
1318,1500000US130670310021,130670310021,"Block Group 1, Census Tract 310.02, Cobb County, Georgia",3636,1202,2434,33.0583058306,66.9416941694
1319,1500000US130670310022,130670310022,"Block Group 2, Census Tract 310.02, Cobb County, Georgia",1848,124,1724,6.70995670996,93.29004329
1320,1500000US130670310023,130670310023,"Block Group 3, Census Tract 310.02, Cobb County, Georgia",1960,717,1243,36.5816326531,63.4183673469
1321,1500000US130670310024,130670310024,"Block Group 4, Census Tract 310.02, Cobb County, Georgia",2023,689,1334,34.058329214,65.941670786
1322,1500000US130670310041,130670310041,"Block Group 1, Census Tract 310.04, Cobb County, Georgia",2770,1380,1390,49.8194945848,50.1805054152
1323,1500000US130670310042,130670310042,"Block Group 2, Census Tract 310.04, Cobb County, Georgia",1088,420,668,38.6029411765,61.3970588235
1324,1500000US130670310043,130670310043,"Block Group 3, Census Tract 310.04, Cobb County, Georgia",2414,754,1660,31.2344656172,68.7655343828
1325,1500000US130670310044,130670310044,"Block Group 4, Census Tract 310.04, Cobb County, Georgia",1269,355,914,27.9747832939,72.0252167061
1326,1500000US130670310051,130670310051,"Block Group 1, Census Tract 310.05, Cobb County, Georgia",2988,2270,718,75.9705488621,24.0294511379
1327,1500000US130670310052,130670310052,"Block Group 2, Census Tract 310.05, Cobb County, Georgia",2538,1950,588,76.8321513002,23.1678486998
1328,1500000US130670311011,130670311011,"Block Group 1, Census Tract 311.01, Cobb County, Georgia",2148,694,1454,32.3091247672,67.6908752328
1329,1500000US130670311012,130670311012,"Block Group 2, Census Tract 311.01, Cobb County, Georgia",1268,409,859,32.2555205047,67.7444794953
1330,1500000US130670311013,130670311013,"Block Group 3, Census Tract 311.01, Cobb County, Georgia",1236,353,883,28.5598705502,71.4401294498
1331,1500000US130670311061,130670311061,"Block Group 1, Census Tract 311.06, Cobb County, Georgia",1400,1083,317,77.3571428571,22.6428571429
1332,1500000US130670311062,130670311062,"Block Group 2, Census Tract 311.06, Cobb County, Georgia",2734,2231,503,81.6020482809,18.3979517191
1333,1500000US130670311063,130670311063,"Block Group 3, Census Tract 311.06, Cobb County, Georgia",1777,1585,192,89.1952729319,10.8047270681
1334,1500000US130670311064,130670311064,"Block Group 4, Census Tract 311.06, Cobb County, Georgia",2923,1281,1642,43.8248374957,56.1751625043
1335,1500000US130670311081,130670311081,"Block Group 1, Census Tract 311.08, Cobb County, Georgia",591,206,385,34.8561759729,65.1438240271
1336,1500000US130670311082,130670311082,"Block Group 2, Census Tract 311.08, Cobb County, Georgia",539,470,69,87.1985157699,12.8014842301
1337,1500000US130670311083,130670311083,"Block Group 3, Census Tract 311.08, Cobb County, Georgia",2725,658,2067,24.1467889908,75.8532110092
1338,1500000US130670311084,130670311084,"Block Group 4, Census Tract 311.08, Cobb County, Georgia",1452,525,927,36.1570247934,63.8429752066
1339,1500000US130670311101,130670311101,"Block Group 1, Census Tract 311.10, Cobb County, Georgia",2521,819,1702,32.4871082904,67.5128917096
1340,1500000US130670311102,130670311102,"Block Group 2, Census Tract 311.10, Cobb County, Georgia",1017,739,278,72.6647000983,27.3352999017
1341,1500000US130670311111,130670311111,"Block Group 1, Census Tract 311.11, Cobb County, Georgia",1976,1533,443,77.5809716599,22.4190283401
1342,1500000US130670311112,130670311112,"Block Group 2, Census Tract 311.11, Cobb County, Georgia",1457,747,710,51.2697323267,48.7302676733
1343,1500000US130670311121,130670311121,"Block Group 1, Census Tract 311.12, Cobb County, Georgia",711,636,75,89.4514767932,10.5485232068
1344,1500000US130670311122,130670311122,"Block Group 2, Census Tract 311.12, Cobb County, Georgia",1930,649,1281,33.6269430052,66.3730569948
1345,1500000US130670311123,130670311123,"Block Group 3, Census Tract 311.12, Cobb County, Georgia",2662,2541,121,95.4545454545,4.54545454545
1346,1500000US130670311131,130670311131,"Block Group 1, Census Tract 311.13, Cobb County, Georgia",942,45,897,4.77707006369,95.2229299363
1347,1500000US130670311141,130670311141,"Block Group 1, Census Tract 311.14, Cobb County, Georgia",3471,860,2611,24.7767214059,75.2232785941
1348,1500000US130670311142,130670311142,"Block Group 2, Census Tract 311.14, Cobb County, Georgia",1893,104,1789,5.49392498679,94.5060750132
1349,1500000US130670311143,130670311143,"Block Group 3, Census Tract 311.14, Cobb County, Georgia",1560,424,1136,27.1794871795,72.8205128205
1350,1500000US130670311144,130670311144,"Block Group 4, Census Tract 311.14, Cobb County, Georgia",529,0,529,0.0,100.0
1351,1500000US130670311151,130670311151,"Block Group 1, Census Tract 311.15, Cobb County, Georgia",2238,516,1722,23.0563002681,76.9436997319
1352,1500000US130670311152,130670311152,"Block Group 2, Census Tract 311.15, Cobb County, Georgia",2721,1742,979,64.0205806689,35.9794193311
1353,1500000US130670311161,130670311161,"Block Group 1, Census Tract 311.16, Cobb County, Georgia",2319,845,1474,36.4381198793,63.5618801207
1354,1500000US130670311162,130670311162,"Block Group 2, Census Tract 311.16, Cobb County, Georgia",1681,1372,309,81.6180844735,18.3819155265
1355,1500000US130670311163,130670311163,"Block Group 3, Census Tract 311.16, Cobb County, Georgia",169,0,169,0.0,100.0
1356,1500000US130670311171,130670311171,"Block Group 1, Census Tract 311.17, Cobb County, Georgia",2685,1871,814,69.6834264432,30.3165735568
1357,1500000US130670311172,130670311172,"Block Group 2, Census Tract 311.17, Cobb County, Georgia",1763,1667,96,94.554736245,5.44526375496
1358,1500000US130670311173,130670311173,"Block Group 3, Census Tract 311.17, Cobb County, Georgia",844,671,173,79.5023696682,20.4976303318
1359,1500000US130670311181,130670311181,"Block Group 1, Census Tract 311.18, Cobb County, Georgia",1471,1106,365,75.1869476547,24.8130523453
1360,1500000US130670311182,130670311182,"Block Group 2, Census Tract 311.18, Cobb County, Georgia",2089,1790,299,85.6869315462,14.3130684538
1361,1500000US130670311183,130670311183,"Block Group 3, Census Tract 311.18, Cobb County, Georgia",2040,1067,973,52.3039215686,47.6960784314
1362,1500000US130670312051,130670312051,"Block Group 1, Census Tract 312.05, Cobb County, Georgia",1450,677,773,46.6896551724,53.3103448276
1363,1500000US130670312052,130670312052,"Block Group 2, Census Tract 312.05, Cobb County, Georgia",2256,1227,1029,54.3882978723,45.6117021277
1364,1500000US130670312053,130670312053,"Block Group 3, Census Tract 312.05, Cobb County, Georgia",2103,833,1270,39.6100808369,60.3899191631
1365,1500000US130670312061,130670312061,"Block Group 1, Census Tract 312.06, Cobb County, Georgia",5457,3563,1894,65.2922851384,34.7077148616
1366,1500000US130670312062,130670312062,"Block Group 2, Census Tract 312.06, Cobb County, Georgia",602,0,602,0.0,100.0
1367,1500000US130670312063,130670312063,"Block Group 3, Census Tract 312.06, Cobb County, Georgia",3971,1360,2611,34.2483001763,65.7516998237
1368,1500000US130670312071,130670312071,"Block Group 1, Census Tract 312.07, Cobb County, Georgia",1033,428,605,41.4327202323,58.5672797677
1369,1500000US130670312072,130670312072,"Block Group 2, Census Tract 312.07, Cobb County, Georgia",2058,209,1849,10.1554907677,89.8445092323
1370,1500000US130670312073,130670312073,"Block Group 3, Census Tract 312.07, Cobb County, Georgia",877,298,579,33.9794754846,66.0205245154
1371,1500000US130670312081,130670312081,"Block Group 1, Census Tract 312.08, Cobb County, Georgia",556,239,317,42.9856115108,57.0143884892
1372,1500000US130670312082,130670312082,"Block Group 2, Census Tract 312.08, Cobb County, Georgia",1953,393,1560,20.1228878648,79.8771121352
1373,1500000US130670312083,130670312083,"Block Group 3, Census Tract 312.08, Cobb County, Georgia",3833,609,3224,15.8883381164,84.1116618836
1374,1500000US130670312091,130670312091,"Block Group 1, Census Tract 312.09, Cobb County, Georgia",2794,2502,292,89.5490336435,10.4509663565
1375,1500000US130670312092,130670312092,"Block Group 2, Census Tract 312.09, Cobb County, Georgia",1378,1264,114,91.7271407837,8.27285921626
1376,1500000US130670312111,130670312111,"Block Group 1, Census Tract 312.11, Cobb County, Georgia",360,0,360,0.0,100.0
1377,1500000US130670312112,130670312112,"Block Group 2, Census Tract 312.11, Cobb County, Georgia",3065,517,2548,16.867862969,83.132137031
1378,1500000US130670312113,130670312113,"Block Group 3, Census Tract 312.11, Cobb County, Georgia",525,0,525,0.0,100.0
1379,1500000US130670312121,130670312121,"Block Group 1, Census Tract 312.12, Cobb County, Georgia",2476,2373,103,95.8400646204,4.15993537964
1380,1500000US130670313061,130670313061,"Block Group 1, Census Tract 313.06, Cobb County, Georgia",2480,1409,1071,56.814516129,43.185483871
1381,1500000US130670313062,130670313062,"Block Group 2, Census Tract 313.06, Cobb County, Georgia",1495,1232,263,82.4080267559,17.5919732441
1382,1500000US130670313071,130670313071,"Block Group 1, Census Tract 313.07, Cobb County, Georgia",925,811,114,87.6756756757,12.3243243243
1383,1500000US130670313072,130670313072,"Block Group 2, Census Tract 313.07, Cobb County, Georgia",2368,1504,864,63.5135135135,36.4864864865
1384,1500000US130670313073,130670313073,"Block Group 3, Census Tract 313.07, Cobb County, Georgia",2311,1640,671,70.964950238,29.035049762
1385,1500000US130670313081,130670313081,"Block Group 1, Census Tract 313.08, Cobb County, Georgia",917,459,458,50.054525627,49.945474373
1386,1500000US130670313082,130670313082,"Block Group 2, Census Tract 313.08, Cobb County, Georgia",2190,848,1342,38.7214611872,61.2785388128
1387,1500000US130670313083,130670313083,"Block Group 3, Census Tract 313.08, Cobb County, Georgia",2394,1299,1095,54.2606516291,45.7393483709
1388,1500000US130670313091,130670313091,"Block Group 1, Census Tract 313.09, Cobb County, Georgia",1510,1025,485,67.880794702,32.119205298
1389,1500000US130670313092,130670313092,"Block Group 2, Census Tract 313.09, Cobb County, Georgia",1859,1544,315,83.0554061323,16.9445938677
1390,1500000US130670313093,130670313093,"Block Group 3, Census Tract 313.09, Cobb County, Georgia",2941,2258,683,76.7766065964,23.2233934036
1391,1500000US130670313094,130670313094,"Block Group 4, Census Tract 313.09, Cobb County, Georgia",2025,1751,274,86.4691358025,13.5308641975
1392,1500000US130670313101,130670313101,"Block Group 1, Census Tract 313.10, Cobb County, Georgia",1687,388,1299,22.9994072318,77.0005927682
1393,1500000US130670313102,130670313102,"Block Group 2, Census Tract 313.10, Cobb County, Georgia",3504,1274,2230,36.3584474886,63.6415525114
1394,1500000US130670313103,130670313103,"Block Group 3, Census Tract 313.10, Cobb County, Georgia",2440,258,2182,10.5737704918,89.4262295082
1395,1500000US130670313111,130670313111,"Block Group 1, Census Tract 313.11, Cobb County, Georgia",3783,1558,2225,41.184245308,58.815754692
1396,1500000US130670313112,130670313112,"Block Group 2, Census Tract 313.11, Cobb County, Georgia",2728,1147,1581,42.0454545455,57.9545454545
1397,1500000US130670313113,130670313113,"Block Group 3, Census Tract 313.11, Cobb County, Georgia",2887,943,1944,32.6636647038,67.3363352962
1398,1500000US130670313121,130670313121,"Block Group 1, Census Tract 313.12, Cobb County, Georgia",1343,602,741,44.825018615,55.174981385
1399,1500000US130670313122,130670313122,"Block Group 2, Census Tract 313.12, Cobb County, Georgia",557,445,112,79.8922800718,20.1077199282
1400,1500000US130670313123,130670313123,"Block Group 3, Census Tract 313.12, Cobb County, Georgia",4775,3997,778,83.7068062827,16.2931937173
1401,1500000US130670313124,130670313124,"Block Group 4, Census Tract 313.12, Cobb County, Georgia",2872,2224,648,77.4373259053,22.5626740947
1402,1500000US130670313131,130670313131,"Block Group 1, Census Tract 313.13, Cobb County, Georgia",7154,5795,1359,81.0036343304,18.9963656696
1403,1500000US130670313132,130670313132,"Block Group 2, Census Tract 313.13, Cobb County, Georgia",3171,2575,596,81.2046672974,18.7953327026
1404,1500000US130670314041,130670314041,"Block Group 1, Census Tract 314.04, Cobb County, Georgia",1000,1000,0,100.0,0.0
1405,1500000US130670314042,130670314042,"Block Group 2, Census Tract 314.04, Cobb County, Georgia",2996,2098,898,70.0267022697,29.9732977303
1406,1500000US130670314043,130670314043,"Block Group 3, Census Tract 314.04, Cobb County, Georgia",1281,998,283,77.9078844653,22.0921155347
1407,1500000US130670314044,130670314044,"Block Group 4, Census Tract 314.04, Cobb County, Georgia",458,296,162,64.6288209607,35.3711790393
1408,1500000US130670314051,130670314051,"Block Group 1, Census Tract 314.05, Cobb County, Georgia",1690,1095,595,64.7928994083,35.2071005917
1409,1500000US130670314052,130670314052,"Block Group 2, Census Tract 314.05, Cobb County, Georgia",2892,2440,452,84.3706777317,15.6293222683
1410,1500000US130670314053,130670314053,"Block Group 3, Census Tract 314.05, Cobb County, Georgia",1181,656,525,55.5461473328,44.4538526672
1411,1500000US130670314054,130670314054,"Block Group 4, Census Tract 314.05, Cobb County, Georgia",1504,1052,452,69.9468085106,30.0531914894
1412,1500000US130670314055,130670314055,"Block Group 5, Census Tract 314.05, Cobb County, Georgia",1093,420,673,38.4263494968,61.5736505032
1413,1500000US130670314061,130670314061,"Block Group 1, Census Tract 314.06, Cobb County, Georgia",1025,274,751,26.7317073171,73.2682926829
1414,1500000US130670314062,130670314062,"Block Group 2, Census Tract 314.06, Cobb County, Georgia",2725,772,1953,28.3302752294,71.6697247706
1415,1500000US130670314063,130670314063,"Block Group 3, Census Tract 314.06, Cobb County, Georgia",3415,1062,2353,31.0980966325,68.9019033675
1416,1500000US130670314081,130670314081,"Block Group 1, Census Tract 314.08, Cobb County, Georgia",838,373,465,44.5107398568,55.4892601432
1417,1500000US130670314082,130670314082,"Block Group 2, Census Tract 314.08, Cobb County, Georgia",3634,2558,1076,70.3907539901,29.6092460099
1418,1500000US130670314083,130670314083,"Block Group 3, Census Tract 314.08, Cobb County, Georgia",1156,545,611,47.1453287197,52.8546712803
1419,1500000US130670314091,130670314091,"Block Group 1, Census Tract 314.09, Cobb County, Georgia",2805,1984,821,70.7308377897,29.2691622103
1420,1500000US130670314092,130670314092,"Block Group 2, Census Tract 314.09, Cobb County, Georgia",2175,1296,879,59.5862068966,40.4137931034
1421,1500000US130670315031,130670315031,"Block Group 1, Census Tract 315.03, Cobb County, Georgia",1408,1158,250,82.2443181818,17.7556818182
1422,1500000US130670315032,130670315032,"Block Group 2, Census Tract 315.03, Cobb County, Georgia",3049,2459,590,80.6493932437,19.3506067563
1423,1500000US130670315033,130670315033,"Block Group 3, Census Tract 315.03, Cobb County, Georgia",3445,2258,1187,65.5442670537,34.4557329463
1424,1500000US130670315034,130670315034,"Block Group 4, Census Tract 315.03, Cobb County, Georgia",2159,1786,373,82.723483094,17.276516906
1425,1500000US130670315051,130670315051,"Block Group 1, Census Tract 315.05, Cobb County, Georgia",2435,1111,1324,45.6262833676,54.3737166324
1426,1500000US130670315052,130670315052,"Block Group 2, Census Tract 315.05, Cobb County, Georgia",1647,1240,407,75.2884031573,24.7115968427
1427,1500000US130670315053,130670315053,"Block Group 3, Census Tract 315.05, Cobb County, Georgia",1853,1628,225,87.8575283324,12.1424716676
1428,1500000US130670315061,130670315061,"Block Group 1, Census Tract 315.06, Cobb County, Georgia",2092,1669,423,79.7801147228,20.2198852772
1429,1500000US130670315062,130670315062,"Block Group 2, Census Tract 315.06, Cobb County, Georgia",1885,1454,431,77.1352785146,22.8647214854
1430,1500000US130670315063,130670315063,"Block Group 3, Census Tract 315.06, Cobb County, Georgia",627,381,246,60.7655502392,39.2344497608
1431,1500000US130670315071,130670315071,"Block Group 1, Census Tract 315.07, Cobb County, Georgia",2251,1728,523,76.7658818303,23.2341181697
1432,1500000US130670315072,130670315072,"Block Group 2, Census Tract 315.07, Cobb County, Georgia",1274,809,465,63.5007849294,36.4992150706
1433,1500000US130670315081,130670315081,"Block Group 1, Census Tract 315.08, Cobb County, Georgia",1651,1087,564,65.8388855239,34.1611144761
1434,1500000US130670315082,130670315082,"Block Group 2, Census Tract 315.08, Cobb County, Georgia",3422,3072,350,89.772063121,10.227936879
1435,1500000US130670315091,130670315091,"Block Group 1, Census Tract 315.09, Cobb County, Georgia",2360,2203,157,93.3474576271,6.65254237288
1436,1500000US130670315092,130670315092,"Block Group 2, Census Tract 315.09, Cobb County, Georgia",1958,1755,203,89.6322778345,10.3677221655
1437,1500000US130670315093,130670315093,"Block Group 3, Census Tract 315.09, Cobb County, Georgia",1698,1183,515,69.6702002356,30.3297997644
1438,1500000US130670315094,130670315094,"Block Group 4, Census Tract 315.09, Cobb County, Georgia",2097,1634,463,77.9208392942,22.0791607058
1439,1500000US130670315095,130670315095,"Block Group 5, Census Tract 315.09, Cobb County, Georgia",2018,1965,53,97.3736372646,2.62636273538
1440,1500000US130690101001,130690101001,"Block Group 1, Census Tract 101, Coffee County, Georgia",811,545,266,67.2009864365,32.7990135635
1441,1500000US130690101002,130690101002,"Block Group 2, Census Tract 101, Coffee County, Georgia",708,565,143,79.802259887,20.197740113
1442,1500000US130690101003,130690101003,"Block Group 3, Census Tract 101, Coffee County, Georgia",1917,1520,397,79.2905581638,20.7094418362
1443,1500000US130690102001,130690102001,"Block Group 1, Census Tract 102, Coffee County, Georgia",1884,1825,59,96.8683651805,3.13163481953
1444,1500000US130690102002,130690102002,"Block Group 2, Census Tract 102, Coffee County, Georgia",1033,929,104,89.9322362052,10.0677637948
1445,1500000US130690103001,130690103001,"Block Group 1, Census Tract 103, Coffee County, Georgia",1624,1266,358,77.9556650246,22.0443349754
1446,1500000US130690103002,130690103002,"Block Group 2, Census Tract 103, Coffee County, Georgia",1420,1033,387,72.7464788732,27.2535211268
1447,1500000US130690104001,130690104001,"Block Group 1, Census Tract 104, Coffee County, Georgia",2172,1098,1074,50.5524861878,49.4475138122
1448,1500000US130690104002,130690104002,"Block Group 2, Census Tract 104, Coffee County, Georgia",386,226,160,58.5492227979,41.4507772021
1449,1500000US130690104003,130690104003,"Block Group 3, Census Tract 104, Coffee County, Georgia",706,588,118,83.2861189802,16.7138810198
1450,1500000US130690104004,130690104004,"Block Group 4, Census Tract 104, Coffee County, Georgia",1134,573,561,50.5291005291,49.4708994709
1451,1500000US130690105001,130690105001,"Block Group 1, Census Tract 105, Coffee County, Georgia",731,441,290,60.3283173735,39.6716826265
1452,1500000US130690105002,130690105002,"Block Group 2, Census Tract 105, Coffee County, Georgia",691,292,399,42.2575976845,57.7424023155
1453,1500000US130690105003,130690105003,"Block Group 3, Census Tract 105, Coffee County, Georgia",1889,897,992,47.4854420328,52.5145579672
1454,1500000US130690106001,130690106001,"Block Group 1, Census Tract 106, Coffee County, Georgia",2806,2632,174,93.7990021383,6.20099786172
1455,1500000US130690106002,130690106002,"Block Group 2, Census Tract 106, Coffee County, Georgia",1371,887,484,64.69730124,35.30269876
1456,1500000US130690106003,130690106003,"Block Group 3, Census Tract 106, Coffee County, Georgia",1474,1304,170,88.4667571235,11.5332428765
1457,1500000US130690107001,130690107001,"Block Group 1, Census Tract 107, Coffee County, Georgia",1431,1123,308,78.4765897973,21.5234102027
1458,1500000US130690107002,130690107002,"Block Group 2, Census Tract 107, Coffee County, Georgia",811,511,300,63.0086313194,36.9913686806
1459,1500000US130690107003,130690107003,"Block Group 3, Census Tract 107, Coffee County, Georgia",750,175,575,23.3333333333,76.6666666667
1460,1500000US130690107004,130690107004,"Block Group 4, Census Tract 107, Coffee County, Georgia",3138,1614,1524,51.4340344168,48.5659655832
1461,1500000US130690108011,130690108011,"Block Group 1, Census Tract 108.01, Coffee County, Georgia",2158,1849,309,85.6811862836,14.3188137164
1462,1500000US130690108012,130690108012,"Block Group 2, Census Tract 108.01, Coffee County, Georgia",2695,1790,905,66.4192949907,33.5807050093
1463,1500000US130690108013,130690108013,"Block Group 3, Census Tract 108.01, Coffee County, Georgia",827,187,640,22.6118500605,77.3881499395
1464,1500000US130690108021,130690108021,"Block Group 1, Census Tract 108.02, Coffee County, Georgia",1004,682,322,67.9282868526,32.0717131474
1465,1500000US130690108022,130690108022,"Block Group 2, Census Tract 108.02, Coffee County, Georgia",1980,735,1245,37.1212121212,62.8787878788
1466,1500000US130690108023,130690108023,"Block Group 3, Census Tract 108.02, Coffee County, Georgia",1515,744,771,49.1089108911,50.8910891089
1467,1500000US130719701001,130719701001,"Block Group 1, Census Tract 9701, Colquitt County, Georgia",2317,1807,510,77.988778593,22.011221407
1468,1500000US130719701002,130719701002,"Block Group 2, Census Tract 9701, Colquitt County, Georgia",2955,1883,1072,63.7225042301,36.2774957699
1469,1500000US130719702001,130719702001,"Block Group 1, Census Tract 9702, Colquitt County, Georgia",1554,984,570,63.3204633205,36.6795366795
1470,1500000US130719702002,130719702002,"Block Group 2, Census Tract 9702, Colquitt County, Georgia",1366,1088,278,79.6486090776,20.3513909224
1471,1500000US130719703001,130719703001,"Block Group 1, Census Tract 9703, Colquitt County, Georgia",1294,1016,278,78.5162287481,21.4837712519
1472,1500000US130719703002,130719703002,"Block Group 2, Census Tract 9703, Colquitt County, Georgia",1406,770,636,54.7652916074,45.2347083926
1473,1500000US130719703003,130719703003,"Block Group 3, Census Tract 9703, Colquitt County, Georgia",819,66,753,8.05860805861,91.9413919414
1474,1500000US130719703004,130719703004,"Block Group 4, Census Tract 9703, Colquitt County, Georgia",521,103,418,19.7696737044,80.2303262956
1475,1500000US130719703005,130719703005,"Block Group 5, Census Tract 9703, Colquitt County, Georgia",1095,454,641,41.4611872146,58.5388127854
1476,1500000US130719704001,130719704001,"Block Group 1, Census Tract 9704, Colquitt County, Georgia",1313,855,458,65.1180502666,34.8819497334
1477,1500000US130719704002,130719704002,"Block Group 2, Census Tract 9704, Colquitt County, Georgia",1059,648,411,61.1898016997,38.8101983003
1478,1500000US130719704003,130719704003,"Block Group 3, Census Tract 9704, Colquitt County, Georgia",743,285,458,38.3580080754,61.6419919246
1479,1500000US130719705001,130719705001,"Block Group 1, Census Tract 9705, Colquitt County, Georgia",1524,1282,242,84.1207349081,15.8792650919
1480,1500000US130719705002,130719705002,"Block Group 2, Census Tract 9705, Colquitt County, Georgia",1651,1366,285,82.7377347062,17.2622652938
1481,1500000US130719706001,130719706001,"Block Group 1, Census Tract 9706, Colquitt County, Georgia",2115,1952,163,92.293144208,7.70685579196
1482,1500000US130719706002,130719706002,"Block Group 2, Census Tract 9706, Colquitt County, Georgia",2078,1747,331,84.0712223292,15.9287776708
1483,1500000US130719706003,130719706003,"Block Group 3, Census Tract 9706, Colquitt County, Georgia",2252,2030,222,90.1420959147,9.85790408526
1484,1500000US130719707011,130719707011,"Block Group 1, Census Tract 9707.01, Colquitt County, Georgia",1252,596,656,47.6038338658,52.3961661342
1485,1500000US130719707012,130719707012,"Block Group 2, Census Tract 9707.01, Colquitt County, Georgia",1338,911,427,68.086696562,31.913303438
1486,1500000US130719707013,130719707013,"Block Group 3, Census Tract 9707.01, Colquitt County, Georgia",3028,1843,1185,60.8652575958,39.1347424042
1487,1500000US130719707014,130719707014,"Block Group 4, Census Tract 9707.01, Colquitt County, Georgia",1121,158,963,14.09455843,85.90544157
1488,1500000US130719707021,130719707021,"Block Group 1, Census Tract 9707.02, Colquitt County, Georgia",2282,860,1422,37.6862401402,62.3137598598
1489,1500000US130719708001,130719708001,"Block Group 1, Census Tract 9708, Colquitt County, Georgia",1650,1023,627,62.0,38.0
1490,1500000US130719708002,130719708002,"Block Group 2, Census Tract 9708, Colquitt County, Georgia",763,412,351,53.997378768,46.002621232
1491,1500000US130719708003,130719708003,"Block Group 3, Census Tract 9708, Colquitt County, Georgia",475,77,398,16.2105263158,83.7894736842
1492,1500000US130719708004,130719708004,"Block Group 4, Census Tract 9708, Colquitt County, Georgia",368,168,200,45.652173913,54.347826087
1493,1500000US130719709001,130719709001,"Block Group 1, Census Tract 9709, Colquitt County, Georgia",1962,1353,609,68.9602446483,31.0397553517
1494,1500000US130719709002,130719709002,"Block Group 2, Census Tract 9709, Colquitt County, Georgia",1177,1119,58,95.0722175021,4.92778249788
1495,1500000US130719709003,130719709003,"Block Group 3, Census Tract 9709, Colquitt County, Georgia",2146,1339,807,62.3951537745,37.6048462255
1496,1500000US130719709004,130719709004,"Block Group 4, Census Tract 9709, Colquitt County, Georgia",1387,1198,189,86.3734679164,13.6265320836
1497,1500000US130730301021,130730301021,"Block Group 1, Census Tract 301.02, Columbia County, Georgia",965,965,0,100.0,0.0
1498,1500000US130730301022,130730301022,"Block Group 2, Census Tract 301.02, Columbia County, Georgia",2139,1951,188,91.2108461898,8.78915381019
1499,1500000US130730301023,130730301023,"Block Group 3, Census Tract 301.02, Columbia County, Georgia",2195,2059,136,93.8041002278,6.19589977221
1500,1500000US130730301024,130730301024,"Block Group 4, Census Tract 301.02, Columbia County, Georgia",2591,2591,0,100.0,0.0
1501,1500000US130730301025,130730301025,"Block Group 5, Census Tract 301.02, Columbia County, Georgia",2036,1572,464,77.21021611,22.78978389
1502,1500000US130730301031,130730301031,"Block Group 1, Census Tract 301.03, Columbia County, Georgia",3362,2765,597,82.242712671,17.757287329
1503,1500000US130730301051,130730301051,"Block Group 1, Census Tract 301.05, Columbia County, Georgia",1554,1225,329,78.8288288288,21.1711711712
1504,1500000US130730301052,130730301052,"Block Group 2, Census Tract 301.05, Columbia County, Georgia",3243,1996,1247,61.5479494295,38.4520505705
1505,1500000US130730301053,130730301053,"Block Group 3, Census Tract 301.05, Columbia County, Georgia",727,602,125,82.8060522696,17.1939477304
1506,1500000US130730301061,130730301061,"Block Group 1, Census Tract 301.06, Columbia County, Georgia",2572,1724,848,67.0295489891,32.9704510109
1507,1500000US130730301062,130730301062,"Block Group 2, Census Tract 301.06, Columbia County, Georgia",1270,862,408,67.874015748,32.125984252
1508,1500000US130730302011,130730302011,"Block Group 1, Census Tract 302.01, Columbia County, Georgia",2202,1632,570,74.1144414169,25.8855585831
1509,1500000US130730302012,130730302012,"Block Group 2, Census Tract 302.01, Columbia County, Georgia",3312,2889,423,87.2282608696,12.7717391304
1510,1500000US130730302013,130730302013,"Block Group 3, Census Tract 302.01, Columbia County, Georgia",615,359,256,58.3739837398,41.6260162602
1511,1500000US130730302021,130730302021,"Block Group 1, Census Tract 302.02, Columbia County, Georgia",3245,2138,1107,65.8859784284,34.1140215716
1512,1500000US130730302031,130730302031,"Block Group 1, Census Tract 302.03, Columbia County, Georgia",1456,1415,41,97.1840659341,2.81593406593
1513,1500000US130730302032,130730302032,"Block Group 2, Census Tract 302.03, Columbia County, Georgia",1417,1208,209,85.2505292872,14.7494707128
1514,1500000US130730302033,130730302033,"Block Group 3, Census Tract 302.03, Columbia County, Georgia",778,45,733,5.78406169666,94.2159383033
1515,1500000US130730302034,130730302034,"Block Group 4, Census Tract 302.03, Columbia County, Georgia",2665,2183,482,81.91369606,18.08630394
1516,1500000US130730303021,130730303021,"Block Group 1, Census Tract 303.02, Columbia County, Georgia",1299,1093,206,84.1416474211,15.8583525789
1517,1500000US130730303022,130730303022,"Block Group 2, Census Tract 303.02, Columbia County, Georgia",3518,2829,689,80.4150085276,19.5849914724
1518,1500000US130730303023,130730303023,"Block Group 3, Census Tract 303.02, Columbia County, Georgia",941,896,45,95.2178533475,4.7821466525
1519,1500000US130730303024,130730303024,"Block Group 4, Census Tract 303.02, Columbia County, Georgia",1758,1758,0,100.0,0.0
1520,1500000US130730303025,130730303025,"Block Group 5, Census Tract 303.02, Columbia County, Georgia",3007,2346,661,78.0179580978,21.9820419022
1521,1500000US130730303041,130730303041,"Block Group 1, Census Tract 303.04, Columbia County, Georgia",1724,1374,350,79.6983758701,20.3016241299
1522,1500000US130730303042,130730303042,"Block Group 2, Census Tract 303.04, Columbia County, Georgia",5469,4712,757,86.158347047,13.841652953
1523,1500000US130730303061,130730303061,"Block Group 1, Census Tract 303.06, Columbia County, Georgia",3610,3107,503,86.0664819945,13.9335180055
1524,1500000US130730303062,130730303062,"Block Group 2, Census Tract 303.06, Columbia County, Georgia",1977,1382,595,69.9038947901,30.0961052099
1525,1500000US130730303071,130730303071,"Block Group 1, Census Tract 303.07, Columbia County, Georgia",1432,1263,169,88.1983240223,11.8016759777
1526,1500000US130730303072,130730303072,"Block Group 2, Census Tract 303.07, Columbia County, Georgia",1556,1524,32,97.9434447301,2.05655526992
1527,1500000US130730303073,130730303073,"Block Group 3, Census Tract 303.07, Columbia County, Georgia",2619,2591,28,98.9308896525,1.06911034746
1528,1500000US130730303074,130730303074,"Block Group 4, Census Tract 303.07, Columbia County, Georgia",1316,568,748,43.1610942249,56.8389057751
1529,1500000US130730303081,130730303081,"Block Group 1, Census Tract 303.08, Columbia County, Georgia",3320,3071,249,92.5,7.5
1530,1500000US130730303082,130730303082,"Block Group 2, Census Tract 303.08, Columbia County, Georgia",6402,5128,1274,80.0999687598,19.9000312402
1531,1500000US130730303091,130730303091,"Block Group 1, Census Tract 303.09, Columbia County, Georgia",4409,3330,1079,75.5273304604,24.4726695396
1532,1500000US130730303092,130730303092,"Block Group 2, Census Tract 303.09, Columbia County, Georgia",1740,1177,563,67.6436781609,32.3563218391
1533,1500000US130730303093,130730303093,"Block Group 3, Census Tract 303.09, Columbia County, Georgia",2061,1065,996,51.673944687,48.326055313
1534,1500000US130730303094,130730303094,"Block Group 4, Census Tract 303.09, Columbia County, Georgia",2780,2606,174,93.7410071942,6.25899280576
1535,1500000US130730304011,130730304011,"Block Group 1, Census Tract 304.01, Columbia County, Georgia",1267,941,326,74.2699289661,25.7300710339
1536,1500000US130730304012,130730304012,"Block Group 2, Census Tract 304.01, Columbia County, Georgia",934,895,39,95.8244111349,4.1755888651
1537,1500000US130730304021,130730304021,"Block Group 1, Census Tract 304.02, Columbia County, Georgia",1935,1810,125,93.5400516796,6.45994832041
1538,1500000US130730304022,130730304022,"Block Group 2, Census Tract 304.02, Columbia County, Georgia",5668,4045,1623,71.3655610445,28.6344389555
1539,1500000US130730304023,130730304023,"Block Group 3, Census Tract 304.02, Columbia County, Georgia",2060,1614,446,78.3495145631,21.6504854369
1540,1500000US130730305031,130730305031,"Block Group 1, Census Tract 305.03, Columbia County, Georgia",2541,2009,532,79.0633608815,20.9366391185
1541,1500000US130730305032,130730305032,"Block Group 2, Census Tract 305.03, Columbia County, Georgia",2419,1420,999,58.7019429516,41.2980570484
1542,1500000US130730305033,130730305033,"Block Group 3, Census Tract 305.03, Columbia County, Georgia",2805,2516,289,89.696969697,10.303030303
1543,1500000US130730305041,130730305041,"Block Group 1, Census Tract 305.04, Columbia County, Georgia",2141,1648,493,76.9733769267,23.0266230733
1544,1500000US130730305042,130730305042,"Block Group 2, Census Tract 305.04, Columbia County, Georgia",1184,1113,71,94.0033783784,5.99662162162
1545,1500000US130730305051,130730305051,"Block Group 1, Census Tract 305.05, Columbia County, Georgia",6922,4771,2151,68.925166137,31.074833863
1546,1500000US130730305061,130730305061,"Block Group 1, Census Tract 305.06, Columbia County, Georgia",4864,4332,532,89.0625,10.9375
1547,1500000US130730305062,130730305062,"Block Group 2, Census Tract 305.06, Columbia County, Georgia",975,395,580,40.5128205128,59.4871794872
1548,1500000US130730305063,130730305063,"Block Group 3, Census Tract 305.06, Columbia County, Georgia",2516,1437,1079,57.1144674086,42.8855325914
1549,1500000US130730305064,130730305064,"Block Group 4, Census Tract 305.06, Columbia County, Georgia",3166,2299,867,72.6152874289,27.3847125711
1550,1500000US130730306031,130730306031,"Block Group 1, Census Tract 306.03, Columbia County, Georgia",2791,1844,947,66.0695091365,33.9304908635
1551,1500000US130730306032,130730306032,"Block Group 2, Census Tract 306.03, Columbia County, Georgia",2219,688,1531,31.0049571879,68.9950428121
1552,1500000US130759601001,130759601001,"Block Group 1, Census Tract 9601, Cook County, Georgia",1359,953,406,70.1250919794,29.8749080206
1553,1500000US130759601002,130759601002,"Block Group 2, Census Tract 9601, Cook County, Georgia",776,694,82,89.4329896907,10.5670103093
1554,1500000US130759602001,130759602001,"Block Group 1, Census Tract 9602, Cook County, Georgia",538,374,164,69.5167286245,30.4832713755
1555,1500000US130759602002,130759602002,"Block Group 2, Census Tract 9602, Cook County, Georgia",1137,742,395,65.2594547054,34.7405452946
1556,1500000US130759602003,130759602003,"Block Group 3, Census Tract 9602, Cook County, Georgia",865,518,347,59.8843930636,40.1156069364
1557,1500000US130759602004,130759602004,"Block Group 4, Census Tract 9602, Cook County, Georgia",730,250,480,34.2465753425,65.7534246575
1558,1500000US130759602005,130759602005,"Block Group 5, Census Tract 9602, Cook County, Georgia",601,235,366,39.1014975042,60.8985024958
1559,1500000US130759603001,130759603001,"Block Group 1, Census Tract 9603, Cook County, Georgia",1633,1063,570,65.0949173301,34.9050826699
1560,1500000US130759603002,130759603002,"Block Group 2, Census Tract 9603, Cook County, Georgia",1317,1203,114,91.3439635535,8.65603644647
1561,1500000US130759603003,130759603003,"Block Group 3, Census Tract 9603, Cook County, Georgia",1435,1054,381,73.4494773519,26.5505226481
1562,1500000US130759603004,130759603004,"Block Group 4, Census Tract 9603, Cook County, Georgia",764,459,305,60.0785340314,39.9214659686
1563,1500000US130759603005,130759603005,"Block Group 5, Census Tract 9603, Cook County, Georgia",775,411,364,53.0322580645,46.9677419355
1564,1500000US130759604001,130759604001,"Block Group 1, Census Tract 9604, Cook County, Georgia",2415,1588,827,65.7556935818,34.2443064182
1565,1500000US130759604002,130759604002,"Block Group 2, Census Tract 9604, Cook County, Georgia",1748,1160,588,66.3615560641,33.6384439359
1566,1500000US130759604003,130759604003,"Block Group 3, Census Tract 9604, Cook County, Georgia",775,364,411,46.9677419355,53.0322580645
1567,1500000US130771701001,130771701001,"Block Group 1, Census Tract 1701, Coweta County, Georgia",2152,1523,629,70.7713754647,29.2286245353
1568,1500000US130771701002,130771701002,"Block Group 2, Census Tract 1701, Coweta County, Georgia",3769,2738,1031,72.6452639958,27.3547360042
1569,1500000US130771701003,130771701003,"Block Group 3, Census Tract 1701, Coweta County, Georgia",1695,1504,191,88.7315634218,11.2684365782
1570,1500000US130771702001,130771702001,"Block Group 1, Census Tract 1702, Coweta County, Georgia",3404,2560,844,75.205640423,24.794359577
1571,1500000US130771702002,130771702002,"Block Group 2, Census Tract 1702, Coweta County, Georgia",1389,917,472,66.0187185025,33.9812814975
1572,1500000US130771702003,130771702003,"Block Group 3, Census Tract 1702, Coweta County, Georgia",685,318,367,46.4233576642,53.5766423358
1573,1500000US130771702004,130771702004,"Block Group 4, Census Tract 1702, Coweta County, Georgia",1483,1020,463,68.7795010115,31.2204989885
1574,1500000US130771703031,130771703031,"Block Group 1, Census Tract 1703.03, Coweta County, Georgia",5214,4965,249,95.2243958573,4.77560414269
1575,1500000US130771703041,130771703041,"Block Group 1, Census Tract 1703.04, Coweta County, Georgia",1248,961,287,77.0032051282,22.9967948718
1576,1500000US130771703042,130771703042,"Block Group 2, Census Tract 1703.04, Coweta County, Georgia",3378,2002,1376,59.2658377738,40.7341622262
1577,1500000US130771703043,130771703043,"Block Group 3, Census Tract 1703.04, Coweta County, Georgia",2056,1491,565,72.5194552529,27.4805447471
1578,1500000US130771703051,130771703051,"Block Group 1, Census Tract 1703.05, Coweta County, Georgia",2920,991,1929,33.9383561644,66.0616438356
1579,1500000US130771703052,130771703052,"Block Group 2, Census Tract 1703.05, Coweta County, Georgia",5466,984,4482,18.0021953897,81.9978046103
1580,1500000US130771703053,130771703053,"Block Group 3, Census Tract 1703.05, Coweta County, Georgia",1878,1515,363,80.6709265176,19.3290734824
1581,1500000US130771703061,130771703061,"Block Group 1, Census Tract 1703.06, Coweta County, Georgia",578,534,44,92.3875432526,7.6124567474
1582,1500000US130771703062,130771703062,"Block Group 2, Census Tract 1703.06, Coweta County, Georgia",3631,2552,1079,70.2836684109,29.7163315891
1583,1500000US130771703063,130771703063,"Block Group 3, Census Tract 1703.06, Coweta County, Georgia",3968,1938,2030,48.8407258065,51.1592741935
1584,1500000US130771704021,130771704021,"Block Group 1, Census Tract 1704.02, Coweta County, Georgia",1623,951,672,58.595194085,41.404805915
1585,1500000US130771704022,130771704022,"Block Group 2, Census Tract 1704.02, Coweta County, Georgia",4600,3982,618,86.5652173913,13.4347826087
1586,1500000US130771704023,130771704023,"Block Group 3, Census Tract 1704.02, Coweta County, Georgia",3554,2918,636,82.1046707935,17.8953292065
1587,1500000US130771704031,130771704031,"Block Group 1, Census Tract 1704.03, Coweta County, Georgia",1065,976,89,91.6431924883,8.35680751174
1588,1500000US130771704032,130771704032,"Block Group 2, Census Tract 1704.03, Coweta County, Georgia",3407,3011,396,88.3768711476,11.6231288524
1589,1500000US130771704041,130771704041,"Block Group 1, Census Tract 1704.04, Coweta County, Georgia",2130,2054,76,96.4319248826,3.56807511737
1590,1500000US130771704042,130771704042,"Block Group 2, Census Tract 1704.04, Coweta County, Georgia",2216,1950,266,87.9963898917,12.0036101083
1591,1500000US130771704043,130771704043,"Block Group 3, Census Tract 1704.04, Coweta County, Georgia",1485,1427,58,96.0942760943,3.90572390572
1592,1500000US130771704051,130771704051,"Block Group 1, Census Tract 1704.05, Coweta County, Georgia",2765,2555,210,92.4050632911,7.59493670886
1593,1500000US130771704052,130771704052,"Block Group 2, Census Tract 1704.05, Coweta County, Georgia",2384,2231,153,93.5822147651,6.4177852349
1594,1500000US130771704053,130771704053,"Block Group 3, Census Tract 1704.05, Coweta County, Georgia",2219,1317,902,59.3510590356,40.6489409644
1595,1500000US130771704061,130771704061,"Block Group 1, Census Tract 1704.06, Coweta County, Georgia",3634,3358,276,92.4050632911,7.59493670886
1596,1500000US130771705011,130771705011,"Block Group 1, Census Tract 1705.01, Coweta County, Georgia",2426,1836,590,75.6801319044,24.3198680956
1597,1500000US130771705012,130771705012,"Block Group 2, Census Tract 1705.01, Coweta County, Georgia",2025,1737,288,85.7777777778,14.2222222222
1598,1500000US130771705013,130771705013,"Block Group 3, Census Tract 1705.01, Coweta County, Georgia",2462,2241,221,91.0235580829,8.97644191714
1599,1500000US130771705021,130771705021,"Block Group 1, Census Tract 1705.02, Coweta County, Georgia",2313,1844,469,79.7233030696,20.2766969304
1600,1500000US130771705022,130771705022,"Block Group 2, Census Tract 1705.02, Coweta County, Georgia",2286,2020,266,88.3639545057,11.6360454943
1601,1500000US130771705023,130771705023,"Block Group 3, Census Tract 1705.02, Coweta County, Georgia",1407,1308,99,92.9637526652,7.03624733475
1602,1500000US130771705031,130771705031,"Block Group 1, Census Tract 1705.03, Coweta County, Georgia",1994,1442,552,72.3169508526,27.6830491474
1603,1500000US130771705032,130771705032,"Block Group 2, Census Tract 1705.03, Coweta County, Georgia",2212,1795,417,81.1482820976,18.8517179024
1604,1500000US130771705033,130771705033,"Block Group 3, Census Tract 1705.03, Coweta County, Georgia",1609,1193,416,74.1454319453,25.8545680547
1605,1500000US130771706011,130771706011,"Block Group 1, Census Tract 1706.01, Coweta County, Georgia",2644,879,1765,33.2450832073,66.7549167927
1606,1500000US130771706012,130771706012,"Block Group 2, Census Tract 1706.01, Coweta County, Georgia",1453,735,718,50.5849965588,49.4150034412
1607,1500000US130771706013,130771706013,"Block Group 3, Census Tract 1706.01, Coweta County, Georgia",1981,288,1693,14.5381120646,85.4618879354
1608,1500000US130771706014,130771706014,"Block Group 4, Census Tract 1706.01, Coweta County, Georgia",1420,836,584,58.8732394366,41.1267605634
1609,1500000US130771706021,130771706021,"Block Group 1, Census Tract 1706.02, Coweta County, Georgia",2349,1938,411,82.503192848,17.496807152
1610,1500000US130771706022,130771706022,"Block Group 2, Census Tract 1706.02, Coweta County, Georgia",2006,1848,158,92.1236291127,7.87637088734
1611,1500000US130771706023,130771706023,"Block Group 3, Census Tract 1706.02, Coweta County, Georgia",2936,2334,602,79.4959128065,20.5040871935
1612,1500000US130771706024,130771706024,"Block Group 4, Census Tract 1706.02, Coweta County, Georgia",1442,1189,253,82.4549237171,17.5450762829
1613,1500000US130771706031,130771706031,"Block Group 1, Census Tract 1706.03, Coweta County, Georgia",1235,1043,192,84.4534412955,15.5465587045
1614,1500000US130771706032,130771706032,"Block Group 2, Census Tract 1706.03, Coweta County, Georgia",3889,3394,495,87.2717922345,12.7282077655
1615,1500000US130771707001,130771707001,"Block Group 1, Census Tract 1707, Coweta County, Georgia",1315,819,496,62.2813688213,37.7186311787
1616,1500000US130771707002,130771707002,"Block Group 2, Census Tract 1707, Coweta County, Georgia",2069,1603,466,77.4770420493,22.5229579507
1617,1500000US130771707003,130771707003,"Block Group 3, Census Tract 1707, Coweta County, Georgia",2032,1084,948,53.3464566929,46.6535433071
1618,1500000US130771707004,130771707004,"Block Group 4, Census Tract 1707, Coweta County, Georgia",843,334,509,39.6204033215,60.3795966785
1619,1500000US130771707005,130771707005,"Block Group 5, Census Tract 1707, Coweta County, Georgia",573,302,271,52.705061082,47.294938918
1620,1500000US130771708011,130771708011,"Block Group 1, Census Tract 1708.01, Coweta County, Georgia",2524,2113,411,83.7163232964,16.2836767036
1621,1500000US130771708012,130771708012,"Block Group 2, Census Tract 1708.01, Coweta County, Georgia",3074,1841,1233,59.8893949252,40.1106050748
1622,1500000US130771708021,130771708021,"Block Group 1, Census Tract 1708.02, Coweta County, Georgia",1798,1546,252,85.9844271413,14.0155728587
1623,1500000US130771708022,130771708022,"Block Group 2, Census Tract 1708.02, Coweta County, Georgia",2625,2062,563,78.5523809524,21.4476190476
1624,1500000US130790701001,130790701001,"Block Group 1, Census Tract 701, Crawford County, Georgia",1532,1209,323,78.9164490862,21.0835509138
1625,1500000US130790701002,130790701002,"Block Group 2, Census Tract 701, Crawford County, Georgia",1323,1060,263,80.1209372638,19.8790627362
1626,1500000US130790701003,130790701003,"Block Group 3, Census Tract 701, Crawford County, Georgia",1027,751,276,73.1256085686,26.8743914314
1627,1500000US130790702011,130790702011,"Block Group 1, Census Tract 702.01, Crawford County, Georgia",1423,1238,185,86.9992972593,13.0007027407
1628,1500000US130790702012,130790702012,"Block Group 2, Census Tract 702.01, Crawford County, Georgia",1276,987,289,77.3510971787,22.6489028213
1629,1500000US130790702013,130790702013,"Block Group 3, Census Tract 702.01, Crawford County, Georgia",2501,1720,781,68.7724910036,31.2275089964
1630,1500000US130790702021,130790702021,"Block Group 1, Census Tract 702.02, Crawford County, Georgia",1587,1460,127,91.9974795211,8.00252047889
1631,1500000US130790702022,130790702022,"Block Group 2, Census Tract 702.02, Crawford County, Georgia",1692,1491,201,88.1205673759,11.8794326241
1632,1500000US130810101001,130810101001,"Block Group 1, Census Tract 101, Crisp County, Georgia",1765,1458,307,82.6062322946,17.3937677054
1633,1500000US130810101002,130810101002,"Block Group 2, Census Tract 101, Crisp County, Georgia",1612,470,1142,29.1563275434,70.8436724566
1634,1500000US130810101003,130810101003,"Block Group 3, Census Tract 101, Crisp County, Georgia",1040,240,800,23.0769230769,76.9230769231
1635,1500000US130810102011,130810102011,"Block Group 1, Census Tract 102.01, Crisp County, Georgia",1820,1557,263,85.5494505495,14.4505494505
1636,1500000US130810102012,130810102012,"Block Group 2, Census Tract 102.01, Crisp County, Georgia",861,699,162,81.1846689895,18.8153310105
1637,1500000US130810102013,130810102013,"Block Group 3, Census Tract 102.01, Crisp County, Georgia",872,431,441,49.4266055046,50.5733944954
1638,1500000US130810102014,130810102014,"Block Group 4, Census Tract 102.01, Crisp County, Georgia",1126,214,912,19.0053285968,80.9946714032
1639,1500000US130810102021,130810102021,"Block Group 1, Census Tract 102.02, Crisp County, Georgia",1238,1018,220,82.2294022617,17.7705977383
1640,1500000US130810102022,130810102022,"Block Group 2, Census Tract 102.02, Crisp County, Georgia",967,198,769,20.4756980352,79.5243019648
1641,1500000US130810102023,130810102023,"Block Group 3, Census Tract 102.02, Crisp County, Georgia",596,101,495,16.9463087248,83.0536912752
1642,1500000US130810103001,130810103001,"Block Group 1, Census Tract 103, Crisp County, Georgia",1049,515,534,49.0943755958,50.9056244042
1643,1500000US130810103002,130810103002,"Block Group 2, Census Tract 103, Crisp County, Georgia",2056,1592,464,77.4319066148,22.5680933852
1644,1500000US130810103003,130810103003,"Block Group 3, Census Tract 103, Crisp County, Georgia",827,83,744,10.0362756953,89.9637243047
1645,1500000US130810104001,130810104001,"Block Group 1, Census Tract 104, Crisp County, Georgia",1449,823,626,56.7977915804,43.2022084196
1646,1500000US130810104002,130810104002,"Block Group 2, Census Tract 104, Crisp County, Georgia",995,413,582,41.5075376884,58.4924623116
1647,1500000US130810104003,130810104003,"Block Group 3, Census Tract 104, Crisp County, Georgia",712,239,473,33.5674157303,66.4325842697
1648,1500000US130810104004,130810104004,"Block Group 4, Census Tract 104, Crisp County, Georgia",1726,1202,524,69.640787949,30.359212051
1649,1500000US130810104005,130810104005,"Block Group 5, Census Tract 104, Crisp County, Georgia",592,216,376,36.4864864865,63.5135135135
1650,1500000US130810105001,130810105001,"Block Group 1, Census Tract 105, Crisp County, Georgia",874,685,189,78.3752860412,21.6247139588
1651,1500000US130810105002,130810105002,"Block Group 2, Census Tract 105, Crisp County, Georgia",669,459,210,68.6098654709,31.3901345291
1652,1500000US130830401011,130830401011,"Block Group 1, Census Tract 401.01, Dade County, Georgia",2484,2128,356,85.6682769726,14.3317230274
1653,1500000US130830401012,130830401012,"Block Group 2, Census Tract 401.01, Dade County, Georgia",1996,1510,486,75.6513026052,24.3486973948
1654,1500000US130830401021,130830401021,"Block Group 1, Census Tract 401.02, Dade County, Georgia",1006,400,606,39.7614314115,60.2385685885
1655,1500000US130830401022,130830401022,"Block Group 2, Census Tract 401.02, Dade County, Georgia",2511,2014,497,80.2070888092,19.7929111908
1656,1500000US130830402001,130830402001,"Block Group 1, Census Tract 402, Dade County, Georgia",1964,1661,303,84.5723014257,15.4276985743
1657,1500000US130830402002,130830402002,"Block Group 2, Census Tract 402, Dade County, Georgia",2146,1730,416,80.6150978565,19.3849021435
1658,1500000US130830403001,130830403001,"Block Group 1, Census Tract 403, Dade County, Georgia",1293,1167,126,90.2552204176,9.74477958237
1659,1500000US130830403002,130830403002,"Block Group 2, Census Tract 403, Dade County, Georgia",1786,1447,339,81.0190369541,18.9809630459
1660,1500000US130859701001,130859701001,"Block Group 1, Census Tract 9701, Dawson County, Georgia",2698,1865,833,69.1252779837,30.8747220163
1661,1500000US130859701002,130859701002,"Block Group 2, Census Tract 9701, Dawson County, Georgia",3236,2304,932,71.1990111248,28.8009888752
1662,1500000US130859701003,130859701003,"Block Group 3, Census Tract 9701, Dawson County, Georgia",1846,1755,91,95.0704225352,4.92957746479
1663,1500000US130859702011,130859702011,"Block Group 1, Census Tract 9702.01, Dawson County, Georgia",1571,1089,482,69.318905156,30.681094844
1664,1500000US130859702012,130859702012,"Block Group 2, Census Tract 9702.01, Dawson County, Georgia",2246,1457,789,64.8708815672,35.1291184328
1665,1500000US130859702013,130859702013,"Block Group 3, Census Tract 9702.01, Dawson County, Georgia",1124,370,754,32.9181494662,67.0818505338
1666,1500000US130859702014,130859702014,"Block Group 4, Census Tract 9702.01, Dawson County, Georgia",2240,1835,405,81.9196428571,18.0803571429
1667,1500000US130859702021,130859702021,"Block Group 1, Census Tract 9702.02, Dawson County, Georgia",2750,1681,1069,61.1272727273,38.8727272727
1668,1500000US130859702022,130859702022,"Block Group 2, Census Tract 9702.02, Dawson County, Georgia",1277,1080,197,84.5732184808,15.4267815192
1669,1500000US130859702023,130859702023,"Block Group 3, Census Tract 9702.02, Dawson County, Georgia",3492,2622,870,75.0859106529,24.9140893471
1670,1500000US130879701001,130879701001,"Block Group 1, Census Tract 9701, Decatur County, Georgia",588,501,87,85.2040816327,14.7959183673
1671,1500000US130879701002,130879701002,"Block Group 2, Census Tract 9701, Decatur County, Georgia",1429,1189,240,83.2050384885,16.7949615115
1672,1500000US130879701003,130879701003,"Block Group 3, Census Tract 9701, Decatur County, Georgia",1398,1286,112,91.9885550787,8.01144492132
1673,1500000US130879702001,130879702001,"Block Group 1, Census Tract 9702, Decatur County, Georgia",1239,679,560,54.802259887,45.197740113
1674,1500000US130879702002,130879702002,"Block Group 2, Census Tract 9702, Decatur County, Georgia",1648,802,846,48.6650485437,51.3349514563
1675,1500000US130879703001,130879703001,"Block Group 1, Census Tract 9703, Decatur County, Georgia",1383,836,547,60.4483007954,39.5516992046
1676,1500000US130879703002,130879703002,"Block Group 2, Census Tract 9703, Decatur County, Georgia",1710,1072,638,62.6900584795,37.3099415205
1677,1500000US130879703003,130879703003,"Block Group 3, Census Tract 9703, Decatur County, Georgia",1381,349,1032,25.2715423606,74.7284576394
1678,1500000US130879703004,130879703004,"Block Group 4, Census Tract 9703, Decatur County, Georgia",1185,840,345,70.8860759494,29.1139240506
1679,1500000US130879704001,130879704001,"Block Group 1, Census Tract 9704, Decatur County, Georgia",1186,478,708,40.3035413153,59.6964586847
1680,1500000US130879704002,130879704002,"Block Group 2, Census Tract 9704, Decatur County, Georgia",937,663,274,70.75773746,29.24226254
1681,1500000US130879704003,130879704003,"Block Group 3, Census Tract 9704, Decatur County, Georgia",1481,623,858,42.0661715057,57.9338284943
1682,1500000US130879704004,130879704004,"Block Group 4, Census Tract 9704, Decatur County, Georgia",1063,336,727,31.6086547507,68.3913452493
1683,1500000US130879706001,130879706001,"Block Group 1, Census Tract 9706, Decatur County, Georgia",458,352,106,76.8558951965,23.1441048035
1684,1500000US130879706002,130879706002,"Block Group 2, Census Tract 9706, Decatur County, Georgia",757,251,506,33.1571994716,66.8428005284
1685,1500000US130879706003,130879706003,"Block Group 3, Census Tract 9706, Decatur County, Georgia",1731,443,1288,25.5921432698,74.4078567302
1686,1500000US130879706004,130879706004,"Block Group 4, Census Tract 9706, Decatur County, Georgia",1969,1769,200,89.842559675,10.157440325
1687,1500000US130879707001,130879707001,"Block Group 1, Census Tract 9707, Decatur County, Georgia",1154,696,458,60.3119584055,39.6880415945
1688,1500000US130879707002,130879707002,"Block Group 2, Census Tract 9707, Decatur County, Georgia",651,534,117,82.0276497696,17.9723502304
1689,1500000US130879708001,130879708001,"Block Group 1, Census Tract 9708, Decatur County, Georgia",1497,1114,383,74.415497662,25.584502338
1690,1500000US130879708002,130879708002,"Block Group 2, Census Tract 9708, Decatur County, Georgia",1244,608,636,48.8745980707,51.1254019293
1691,1500000US130890201001,130890201001,"Block Group 1, Census Tract 201, DeKalb County, Georgia",1908,1531,377,80.2410901468,19.7589098532
1692,1500000US130890202001,130890202001,"Block Group 1, Census Tract 202, DeKalb County, Georgia",901,800,101,88.7902330744,11.2097669256
1693,1500000US130890202002,130890202002,"Block Group 2, Census Tract 202, DeKalb County, Georgia",1152,508,644,44.0972222222,55.9027777778
1694,1500000US130890203001,130890203001,"Block Group 1, Census Tract 203, DeKalb County, Georgia",840,660,180,78.5714285714,21.4285714286
1695,1500000US130890203002,130890203002,"Block Group 2, Census Tract 203, DeKalb County, Georgia",1049,707,342,67.397521449,32.602478551
1696,1500000US130890203003,130890203003,"Block Group 3, Census Tract 203, DeKalb County, Georgia",1883,1310,573,69.5698353691,30.4301646309
1697,1500000US130890204001,130890204001,"Block Group 1, Census Tract 204, DeKalb County, Georgia",1684,1018,666,60.4513064133,39.5486935867
1698,1500000US130890204002,130890204002,"Block Group 2, Census Tract 204, DeKalb County, Georgia",901,673,228,74.6947835738,25.3052164262
1699,1500000US130890205001,130890205001,"Block Group 1, Census Tract 205, DeKalb County, Georgia",1193,604,589,50.6286672255,49.3713327745
1700,1500000US130890205002,130890205002,"Block Group 2, Census Tract 205, DeKalb County, Georgia",1704,1074,630,63.0281690141,36.9718309859
1701,1500000US130890206001,130890206001,"Block Group 1, Census Tract 206, DeKalb County, Georgia",616,346,270,56.1688311688,43.8311688312
1702,1500000US130890206002,130890206002,"Block Group 2, Census Tract 206, DeKalb County, Georgia",1433,509,924,35.5198883461,64.4801116539
1703,1500000US130890207001,130890207001,"Block Group 1, Census Tract 207, DeKalb County, Georgia",1717,963,754,56.086196855,43.913803145
1704,1500000US130890207002,130890207002,"Block Group 2, Census Tract 207, DeKalb County, Georgia",528,386,142,73.1060606061,26.8939393939
1705,1500000US130890208011,130890208011,"Block Group 1, Census Tract 208.01, DeKalb County, Georgia",1041,938,103,90.1056676273,9.89433237272
1706,1500000US130890208012,130890208012,"Block Group 2, Census Tract 208.01, DeKalb County, Georgia",1544,1383,161,89.5725388601,10.4274611399
1707,1500000US130890208021,130890208021,"Block Group 1, Census Tract 208.02, DeKalb County, Georgia",713,635,78,89.0603085554,10.9396914446
1708,1500000US130890208022,130890208022,"Block Group 2, Census Tract 208.02, DeKalb County, Georgia",1720,707,1013,41.1046511628,58.8953488372
1709,1500000US130890208023,130890208023,"Block Group 3, Census Tract 208.02, DeKalb County, Georgia",951,787,164,82.7549947424,17.2450052576
1710,1500000US130890208024,130890208024,"Block Group 4, Census Tract 208.02, DeKalb County, Georgia",867,699,168,80.6228373702,19.3771626298
1711,1500000US130890209001,130890209001,"Block Group 1, Census Tract 209, DeKalb County, Georgia",1525,1222,303,80.131147541,19.868852459
1712,1500000US130890209002,130890209002,"Block Group 2, Census Tract 209, DeKalb County, Georgia",1235,850,385,68.8259109312,31.1740890688
1713,1500000US130890209003,130890209003,"Block Group 3, Census Tract 209, DeKalb County, Georgia",1776,995,781,56.0247747748,43.9752252252
1714,1500000US130890209004,130890209004,"Block Group 4, Census Tract 209, DeKalb County, Georgia",1164,621,543,53.3505154639,46.6494845361
1715,1500000US130890211011,130890211011,"Block Group 1, Census Tract 211.01, DeKalb County, Georgia",3779,3441,338,91.055834877,8.94416512305
1716,1500000US130890211021,130890211021,"Block Group 1, Census Tract 211.02, DeKalb County, Georgia",209,0,209,0.0,100.0
1717,1500000US130890211022,130890211022,"Block Group 2, Census Tract 211.02, DeKalb County, Georgia",1757,1693,64,96.3574274331,3.64257256688
1718,1500000US130890211023,130890211023,"Block Group 3, Census Tract 211.02, DeKalb County, Georgia",527,49,478,9.29791271347,90.7020872865
1719,1500000US130890211024,130890211024,"Block Group 4, Census Tract 211.02, DeKalb County, Georgia",2203,1069,1134,48.5247389923,51.4752610077
1720,1500000US130890212021,130890212021,"Block Group 1, Census Tract 212.02, DeKalb County, Georgia",3004,2421,583,80.5925432756,19.4074567244
1721,1500000US130890212022,130890212022,"Block Group 2, Census Tract 212.02, DeKalb County, Georgia",1914,1776,138,92.789968652,7.21003134796
1722,1500000US130890212023,130890212023,"Block Group 3, Census Tract 212.02, DeKalb County, Georgia",2240,1843,397,82.2767857143,17.7232142857
1723,1500000US130890212041,130890212041,"Block Group 1, Census Tract 212.04, DeKalb County, Georgia",1253,0,1253,0.0,100.0
1724,1500000US130890212042,130890212042,"Block Group 2, Census Tract 212.04, DeKalb County, Georgia",1763,42,1721,2.3823028928,97.6176971072
1725,1500000US130890212043,130890212043,"Block Group 3, Census Tract 212.04, DeKalb County, Georgia",989,120,869,12.1334681496,87.8665318504
1726,1500000US130890212081,130890212081,"Block Group 1, Census Tract 212.08, DeKalb County, Georgia",2432,930,1502,38.2401315789,61.7598684211
1727,1500000US130890212082,130890212082,"Block Group 2, Census Tract 212.08, DeKalb County, Georgia",1600,1354,246,84.625,15.375
1728,1500000US130890212091,130890212091,"Block Group 1, Census Tract 212.09, DeKalb County, Georgia",1167,303,864,25.9640102828,74.0359897172
1729,1500000US130890212092,130890212092,"Block Group 2, Census Tract 212.09, DeKalb County, Georgia",1516,729,787,48.0870712401,51.9129287599
1730,1500000US130890212093,130890212093,"Block Group 3, Census Tract 212.09, DeKalb County, Georgia",1901,1069,832,56.2335612835,43.7664387165
1731,1500000US130890212094,130890212094,"Block Group 4, Census Tract 212.09, DeKalb County, Georgia",1173,969,204,82.6086956522,17.3913043478
1732,1500000US130890212101,130890212101,"Block Group 1, Census Tract 212.10, DeKalb County, Georgia",1813,1537,276,84.776613348,15.223386652
1733,1500000US130890212102,130890212102,"Block Group 2, Census Tract 212.10, DeKalb County, Georgia",1207,1175,32,97.3487986744,2.6512013256
1734,1500000US130890212103,130890212103,"Block Group 3, Census Tract 212.10, DeKalb County, Georgia",2493,2453,40,98.3955074208,1.60449257922
1735,1500000US130890212111,130890212111,"Block Group 1, Census Tract 212.11, DeKalb County, Georgia",1323,1247,76,94.2554799698,5.74452003023
1736,1500000US130890212112,130890212112,"Block Group 2, Census Tract 212.11, DeKalb County, Georgia",2110,1963,147,93.0331753555,6.96682464455
1737,1500000US130890212113,130890212113,"Block Group 3, Census Tract 212.11, DeKalb County, Georgia",1349,1269,80,94.0696812454,5.93031875463
1738,1500000US130890212131,130890212131,"Block Group 1, Census Tract 212.13, DeKalb County, Georgia",1076,1010,66,93.8661710037,6.13382899628
1739,1500000US130890212132,130890212132,"Block Group 2, Census Tract 212.13, DeKalb County, Georgia",2379,2269,110,95.376208491,4.62379150904
1740,1500000US130890212141,130890212141,"Block Group 1, Census Tract 212.14, DeKalb County, Georgia",1801,1571,230,87.2293170461,12.7706829539
1741,1500000US130890212142,130890212142,"Block Group 2, Census Tract 212.14, DeKalb County, Georgia",3002,2898,104,96.5356429047,3.46435709527
1742,1500000US130890212143,130890212143,"Block Group 3, Census Tract 212.14, DeKalb County, Georgia",1529,1461,68,95.5526487901,4.44735120994
1743,1500000US130890212151,130890212151,"Block Group 1, Census Tract 212.15, DeKalb County, Georgia",3401,1024,2377,30.1087915319,69.8912084681
1744,1500000US130890212152,130890212152,"Block Group 2, Census Tract 212.15, DeKalb County, Georgia",2544,636,1908,25.0,75.0
1745,1500000US130890212161,130890212161,"Block Group 1, Census Tract 212.16, DeKalb County, Georgia",1876,1876,0,100.0,0.0
1746,1500000US130890212162,130890212162,"Block Group 2, Census Tract 212.16, DeKalb County, Georgia",3807,844,2963,22.1696874179,77.8303125821
1747,1500000US130890212163,130890212163,"Block Group 3, Census Tract 212.16, DeKalb County, Georgia",2728,240,2488,8.79765395894,91.2023460411
1748,1500000US130890212171,130890212171,"Block Group 1, Census Tract 212.17, DeKalb County, Georgia",2466,1836,630,74.4525547445,25.5474452555
1749,1500000US130890212181,130890212181,"Block Group 1, Census Tract 212.18, DeKalb County, Georgia",1266,105,1161,8.29383886256,91.7061611374
1750,1500000US130890212182,130890212182,"Block Group 2, Census Tract 212.18, DeKalb County, Georgia",2239,429,1810,19.1603394372,80.8396605628
1751,1500000US130890212183,130890212183,"Block Group 3, Census Tract 212.18, DeKalb County, Georgia",1319,763,556,57.846853677,42.153146323
1752,1500000US130890213011,130890213011,"Block Group 1, Census Tract 213.01, DeKalb County, Georgia",1084,232,852,21.4022140221,78.5977859779
1753,1500000US130890213012,130890213012,"Block Group 2, Census Tract 213.01, DeKalb County, Georgia",2898,514,2384,17.7363699103,82.2636300897
1754,1500000US130890213031,130890213031,"Block Group 1, Census Tract 213.03, DeKalb County, Georgia",3051,1280,1771,41.9534578827,58.0465421173
1755,1500000US130890213032,130890213032,"Block Group 2, Census Tract 213.03, DeKalb County, Georgia",1314,717,597,54.5662100457,45.4337899543
1756,1500000US130890213033,130890213033,"Block Group 3, Census Tract 213.03, DeKalb County, Georgia",2131,227,1904,10.6522759268,89.3477240732
1757,1500000US130890213051,130890213051,"Block Group 1, Census Tract 213.05, DeKalb County, Georgia",928,739,189,79.6336206897,20.3663793103
1758,1500000US130890213052,130890213052,"Block Group 2, Census Tract 213.05, DeKalb County, Georgia",4256,750,3506,17.6221804511,82.3778195489
1759,1500000US130890213061,130890213061,"Block Group 1, Census Tract 213.06, DeKalb County, Georgia",2570,874,1696,34.0077821012,65.9922178988
1760,1500000US130890213062,130890213062,"Block Group 2, Census Tract 213.06, DeKalb County, Georgia",667,382,285,57.2713643178,42.7286356822
1761,1500000US130890213063,130890213063,"Block Group 3, Census Tract 213.06, DeKalb County, Georgia",1885,112,1773,5.94164456233,94.0583554377
1762,1500000US130890213071,130890213071,"Block Group 1, Census Tract 213.07, DeKalb County, Georgia",1430,875,555,61.1888111888,38.8111888112
1763,1500000US130890213072,130890213072,"Block Group 2, Census Tract 213.07, DeKalb County, Georgia",2946,1285,1661,43.6184657162,56.3815342838
1764,1500000US130890213081,130890213081,"Block Group 1, Census Tract 213.08, DeKalb County, Georgia",1643,853,790,51.9172245892,48.0827754108
1765,1500000US130890213082,130890213082,"Block Group 2, Census Tract 213.08, DeKalb County, Georgia",525,486,39,92.5714285714,7.42857142857
1766,1500000US130890213083,130890213083,"Block Group 3, Census Tract 213.08, DeKalb County, Georgia",1926,439,1487,22.7933541018,77.2066458982
1767,1500000US130890214051,130890214051,"Block Group 1, Census Tract 214.05, DeKalb County, Georgia",1029,773,256,75.1214771623,24.8785228377
1768,1500000US130890214052,130890214052,"Block Group 2, Census Tract 214.05, DeKalb County, Georgia",1850,980,870,52.972972973,47.027027027
1769,1500000US130890214053,130890214053,"Block Group 3, Census Tract 214.05, DeKalb County, Georgia",1367,1193,174,87.2713972202,12.7286027798
1770,1500000US130890214091,130890214091,"Block Group 1, Census Tract 214.09, DeKalb County, Georgia",2694,37,2657,1.37342242019,98.6265775798
1771,1500000US130890214092,130890214092,"Block Group 2, Census Tract 214.09, DeKalb County, Georgia",975,211,764,21.641025641,78.358974359
1772,1500000US130890214101,130890214101,"Block Group 1, Census Tract 214.10, DeKalb County, Georgia",1964,663,1301,33.7576374745,66.2423625255
1773,1500000US130890214102,130890214102,"Block Group 2, Census Tract 214.10, DeKalb County, Georgia",1757,8,1749,0.455321570859,99.5446784291
1774,1500000US130890214103,130890214103,"Block Group 3, Census Tract 214.10, DeKalb County, Georgia",1633,639,994,39.1304347826,60.8695652174
1775,1500000US130890214111,130890214111,"Block Group 1, Census Tract 214.11, DeKalb County, Georgia",1832,971,861,53.0021834061,46.9978165939
1776,1500000US130890214112,130890214112,"Block Group 2, Census Tract 214.11, DeKalb County, Georgia",1718,538,1180,31.3154831199,68.6845168801
1777,1500000US130890214121,130890214121,"Block Group 1, Census Tract 214.12, DeKalb County, Georgia",1167,1073,94,91.9451585261,8.05484147386
1778,1500000US130890214122,130890214122,"Block Group 2, Census Tract 214.12, DeKalb County, Georgia",1480,807,673,54.527027027,45.472972973
1779,1500000US130890214123,130890214123,"Block Group 3, Census Tract 214.12, DeKalb County, Georgia",1227,815,412,66.4221678892,33.5778321108
1780,1500000US130890214131,130890214131,"Block Group 1, Census Tract 214.13, DeKalb County, Georgia",3030,489,2541,16.1386138614,83.8613861386
1781,1500000US130890214132,130890214132,"Block Group 2, Census Tract 214.13, DeKalb County, Georgia",1451,141,1310,9.71743625086,90.2825637491
1782,1500000US130890214141,130890214141,"Block Group 1, Census Tract 214.14, DeKalb County, Georgia",3022,62,2960,2.05162144275,97.9483785572
1783,1500000US130890214142,130890214142,"Block Group 2, Census Tract 214.14, DeKalb County, Georgia",947,110,837,11.6156282999,88.3843717001
1784,1500000US130890214151,130890214151,"Block Group 1, Census Tract 214.15, DeKalb County, Georgia",1082,600,482,55.4528650647,44.5471349353
1785,1500000US130890214152,130890214152,"Block Group 2, Census Tract 214.15, DeKalb County, Georgia",1229,442,787,35.9641985354,64.0358014646
1786,1500000US130890214153,130890214153,"Block Group 3, Census Tract 214.15, DeKalb County, Georgia",1846,1026,820,55.579631636,44.420368364
1787,1500000US130890214161,130890214161,"Block Group 1, Census Tract 214.16, DeKalb County, Georgia",1978,541,1437,27.350859454,72.649140546
1788,1500000US130890214162,130890214162,"Block Group 2, Census Tract 214.16, DeKalb County, Georgia",614,410,204,66.7752442997,33.2247557003
1789,1500000US130890214171,130890214171,"Block Group 1, Census Tract 214.17, DeKalb County, Georgia",1117,289,828,25.872873769,74.127126231
1790,1500000US130890214172,130890214172,"Block Group 2, Census Tract 214.17, DeKalb County, Georgia",1231,138,1093,11.2103980504,88.7896019496
1791,1500000US130890214173,130890214173,"Block Group 3, Census Tract 214.17, DeKalb County, Georgia",2793,198,2595,7.08915145005,92.9108485499
1792,1500000US130890215021,130890215021,"Block Group 1, Census Tract 215.02, DeKalb County, Georgia",1298,358,940,27.5808936826,72.4191063174
1793,1500000US130890215022,130890215022,"Block Group 2, Census Tract 215.02, DeKalb County, Georgia",1445,1045,400,72.3183391003,27.6816608997
1794,1500000US130890215023,130890215023,"Block Group 3, Census Tract 215.02, DeKalb County, Georgia",1839,1284,555,69.8205546493,30.1794453507
1795,1500000US130890215031,130890215031,"Block Group 1, Census Tract 215.03, DeKalb County, Georgia",1478,734,744,49.6617050068,50.3382949932
1796,1500000US130890215032,130890215032,"Block Group 2, Census Tract 215.03, DeKalb County, Georgia",908,601,307,66.1894273128,33.8105726872
1797,1500000US130890215033,130890215033,"Block Group 3, Census Tract 215.03, DeKalb County, Georgia",1741,75,1666,4.30786904078,95.6921309592
1798,1500000US130890215041,130890215041,"Block Group 1, Census Tract 215.04, DeKalb County, Georgia",1619,307,1312,18.9623224212,81.0376775788
1799,1500000US130890215042,130890215042,"Block Group 2, Census Tract 215.04, DeKalb County, Georgia",1952,739,1213,37.8586065574,62.1413934426
1800,1500000US130890215043,130890215043,"Block Group 3, Census Tract 215.04, DeKalb County, Georgia",1190,561,629,47.1428571429,52.8571428571
1801,1500000US130890216021,130890216021,"Block Group 1, Census Tract 216.02, DeKalb County, Georgia",1605,217,1388,13.5202492212,86.4797507788
1802,1500000US130890216022,130890216022,"Block Group 2, Census Tract 216.02, DeKalb County, Georgia",2399,2224,175,92.7052938724,7.29470612755
1803,1500000US130890216031,130890216031,"Block Group 1, Census Tract 216.03, DeKalb County, Georgia",1665,920,745,55.2552552553,44.7447447447
1804,1500000US130890216032,130890216032,"Block Group 2, Census Tract 216.03, DeKalb County, Georgia",1653,667,986,40.350877193,59.649122807
1805,1500000US130890216033,130890216033,"Block Group 3, Census Tract 216.03, DeKalb County, Georgia",1200,319,881,26.5833333333,73.4166666667
1806,1500000US130890216041,130890216041,"Block Group 1, Census Tract 216.04, DeKalb County, Georgia",2046,1915,131,93.5972629521,6.4027370479
1807,1500000US130890216042,130890216042,"Block Group 2, Census Tract 216.04, DeKalb County, Georgia",1091,1030,61,94.4087992667,5.59120073327
1808,1500000US130890216051,130890216051,"Block Group 1, Census Tract 216.05, DeKalb County, Georgia",1652,1351,301,81.7796610169,18.2203389831
1809,1500000US130890216052,130890216052,"Block Group 2, Census Tract 216.05, DeKalb County, Georgia",1035,956,79,92.3671497585,7.63285024155
1810,1500000US130890216053,130890216053,"Block Group 3, Census Tract 216.05, DeKalb County, Georgia",2805,175,2630,6.23885918004,93.76114082
1811,1500000US130890217031,130890217031,"Block Group 1, Census Tract 217.03, DeKalb County, Georgia",2305,2136,169,92.6681127983,7.33188720174
1812,1500000US130890217032,130890217032,"Block Group 2, Census Tract 217.03, DeKalb County, Georgia",2479,2425,54,97.8217022993,2.17829770069
1813,1500000US130890217041,130890217041,"Block Group 1, Census Tract 217.04, DeKalb County, Georgia",1577,948,629,60.1141407736,39.8858592264
1814,1500000US130890217042,130890217042,"Block Group 2, Census Tract 217.04, DeKalb County, Georgia",1118,544,574,48.6583184258,51.3416815742
1815,1500000US130890217043,130890217043,"Block Group 3, Census Tract 217.04, DeKalb County, Georgia",2877,2812,65,97.7407021203,2.25929787974
1816,1500000US130890217051,130890217051,"Block Group 1, Census Tract 217.05, DeKalb County, Georgia",2147,674,1473,31.3926408943,68.6073591057
1817,1500000US130890217052,130890217052,"Block Group 2, Census Tract 217.05, DeKalb County, Georgia",1262,659,603,52.2187004754,47.7812995246
1818,1500000US130890217053,130890217053,"Block Group 3, Census Tract 217.05, DeKalb County, Georgia",1152,173,979,15.0173611111,84.9826388889
1819,1500000US130890217061,130890217061,"Block Group 1, Census Tract 217.06, DeKalb County, Georgia",787,774,13,98.3481575604,1.65184243964
1820,1500000US130890217062,130890217062,"Block Group 2, Census Tract 217.06, DeKalb County, Georgia",2192,863,1329,39.3704379562,60.6295620438
1821,1500000US130890217063,130890217063,"Block Group 3, Census Tract 217.06, DeKalb County, Georgia",1065,977,88,91.7370892019,8.26291079812
1822,1500000US130890217064,130890217064,"Block Group 4, Census Tract 217.06, DeKalb County, Georgia",1530,1275,255,83.3333333333,16.6666666667
1823,1500000US130890218051,130890218051,"Block Group 1, Census Tract 218.05, DeKalb County, Georgia",1831,1652,179,90.2239213545,9.77607864555
1824,1500000US130890218052,130890218052,"Block Group 2, Census Tract 218.05, DeKalb County, Georgia",1876,980,896,52.2388059701,47.7611940299
1825,1500000US130890218053,130890218053,"Block Group 3, Census Tract 218.05, DeKalb County, Georgia",2665,1544,1121,57.9362101313,42.0637898687
1826,1500000US130890218061,130890218061,"Block Group 1, Census Tract 218.06, DeKalb County, Georgia",2374,454,1920,19.1238416175,80.8761583825
1827,1500000US130890218062,130890218062,"Block Group 2, Census Tract 218.06, DeKalb County, Georgia",1074,990,84,92.1787709497,7.82122905028
1828,1500000US130890218063,130890218063,"Block Group 3, Census Tract 218.06, DeKalb County, Georgia",2228,718,1510,32.2262118492,67.7737881508
1829,1500000US130890218081,130890218081,"Block Group 1, Census Tract 218.08, DeKalb County, Georgia",1706,1332,374,78.0773739742,21.9226260258
1830,1500000US130890218082,130890218082,"Block Group 2, Census Tract 218.08, DeKalb County, Georgia",3293,1760,1533,53.4467051321,46.5532948679
1831,1500000US130890218091,130890218091,"Block Group 1, Census Tract 218.09, DeKalb County, Georgia",532,514,18,96.6165413534,3.38345864662
1832,1500000US130890218092,130890218092,"Block Group 2, Census Tract 218.09, DeKalb County, Georgia",1678,1629,49,97.0798569726,2.92014302741
1833,1500000US130890218093,130890218093,"Block Group 3, Census Tract 218.09, DeKalb County, Georgia",1888,1850,38,97.9872881356,2.01271186441
1834,1500000US130890218094,130890218094,"Block Group 4, Census Tract 218.09, DeKalb County, Georgia",1206,886,320,73.4660033167,26.5339966833
1835,1500000US130890218095,130890218095,"Block Group 5, Census Tract 218.09, DeKalb County, Georgia",1210,1200,10,99.173553719,0.826446280992
1836,1500000US130890218101,130890218101,"Block Group 1, Census Tract 218.10, DeKalb County, Georgia",2190,684,1506,31.2328767123,68.7671232877
1837,1500000US130890218102,130890218102,"Block Group 2, Census Tract 218.10, DeKalb County, Georgia",1319,1299,20,98.4836997726,1.51630022745
1838,1500000US130890218103,130890218103,"Block Group 3, Census Tract 218.10, DeKalb County, Georgia",1627,1445,182,88.8137676706,11.1862323294
1839,1500000US130890218121,130890218121,"Block Group 1, Census Tract 218.12, DeKalb County, Georgia",983,523,460,53.2044760936,46.7955239064
1840,1500000US130890218122,130890218122,"Block Group 2, Census Tract 218.12, DeKalb County, Georgia",1291,704,587,54.5313710302,45.4686289698
1841,1500000US130890218131,130890218131,"Block Group 1, Census Tract 218.13, DeKalb County, Georgia",2859,10,2849,0.349772647779,99.6502273522
1842,1500000US130890218141,130890218141,"Block Group 1, Census Tract 218.14, DeKalb County, Georgia",1045,790,255,75.5980861244,24.4019138756
1843,1500000US130890218142,130890218142,"Block Group 2, Census Tract 218.14, DeKalb County, Georgia",1382,359,1023,25.976845152,74.023154848
1844,1500000US130890218143,130890218143,"Block Group 3, Census Tract 218.14, DeKalb County, Georgia",1339,112,1227,8.3644510829,91.6355489171
1845,1500000US130890218144,130890218144,"Block Group 4, Census Tract 218.14, DeKalb County, Georgia",1870,105,1765,5.61497326203,94.385026738
1846,1500000US130890219061,130890219061,"Block Group 1, Census Tract 219.06, DeKalb County, Georgia",1644,1145,499,69.6472019465,30.3527980535
1847,1500000US130890219062,130890219062,"Block Group 2, Census Tract 219.06, DeKalb County, Georgia",758,455,303,60.0263852243,39.9736147757
1848,1500000US130890219063,130890219063,"Block Group 3, Census Tract 219.06, DeKalb County, Georgia",2818,1855,963,65.8268275373,34.1731724627
1849,1500000US130890219071,130890219071,"Block Group 1, Census Tract 219.07, DeKalb County, Georgia",4793,3821,972,79.7204256207,20.2795743793
1850,1500000US130890219072,130890219072,"Block Group 2, Census Tract 219.07, DeKalb County, Georgia",2209,1751,458,79.2666364871,20.7333635129
1851,1500000US130890219073,130890219073,"Block Group 3, Census Tract 219.07, DeKalb County, Georgia",1883,595,1288,31.5985130112,68.4014869888
1852,1500000US130890219081,130890219081,"Block Group 1, Census Tract 219.08, DeKalb County, Georgia",1943,1431,512,73.6489963973,26.3510036027
1853,1500000US130890219082,130890219082,"Block Group 2, Census Tract 219.08, DeKalb County, Georgia",4168,592,3576,14.2034548944,85.7965451056
1854,1500000US130890219091,130890219091,"Block Group 1, Census Tract 219.09, DeKalb County, Georgia",2234,179,2055,8.01253357207,91.9874664279
1855,1500000US130890219092,130890219092,"Block Group 2, Census Tract 219.09, DeKalb County, Georgia",1609,1474,135,91.609695463,8.39030453698
1856,1500000US130890219093,130890219093,"Block Group 3, Census Tract 219.09, DeKalb County, Georgia",1013,66,947,6.51530108588,93.4846989141
1857,1500000US130890219094,130890219094,"Block Group 4, Census Tract 219.09, DeKalb County, Georgia",1750,681,1069,38.9142857143,61.0857142857
1858,1500000US130890219101,130890219101,"Block Group 1, Census Tract 219.10, DeKalb County, Georgia",1341,606,735,45.1901565996,54.8098434004
1859,1500000US130890219102,130890219102,"Block Group 2, Census Tract 219.10, DeKalb County, Georgia",1787,1614,173,90.3189703414,9.68102965865
1860,1500000US130890219103,130890219103,"Block Group 3, Census Tract 219.10, DeKalb County, Georgia",1683,1058,625,62.8639334522,37.1360665478
1861,1500000US130890219111,130890219111,"Block Group 1, Census Tract 219.11, DeKalb County, Georgia",816,0,816,0.0,100.0
1862,1500000US130890219112,130890219112,"Block Group 2, Census Tract 219.11, DeKalb County, Georgia",1373,320,1053,23.3066278223,76.6933721777
1863,1500000US130890219121,130890219121,"Block Group 1, Census Tract 219.12, DeKalb County, Georgia",1451,1422,29,98.0013783598,1.99862164025
1864,1500000US130890219122,130890219122,"Block Group 2, Census Tract 219.12, DeKalb County, Georgia",1364,1292,72,94.7214076246,5.27859237537
1865,1500000US130890219123,130890219123,"Block Group 3, Census Tract 219.12, DeKalb County, Georgia",644,644,0,100.0,0.0
1866,1500000US130890219131,130890219131,"Block Group 1, Census Tract 219.13, DeKalb County, Georgia",2422,63,2359,2.60115606936,97.3988439306
1867,1500000US130890219132,130890219132,"Block Group 2, Census Tract 219.13, DeKalb County, Georgia",848,0,848,0.0,100.0
1868,1500000US130890219133,130890219133,"Block Group 3, Census Tract 219.13, DeKalb County, Georgia",1243,684,559,55.028157683,44.971842317
1869,1500000US130890220011,130890220011,"Block Group 1, Census Tract 220.01, DeKalb County, Georgia",2013,1031,982,51.217088922,48.782911078
1870,1500000US130890220012,130890220012,"Block Group 2, Census Tract 220.01, DeKalb County, Georgia",2321,1980,341,85.308056872,14.691943128
1871,1500000US130890220041,130890220041,"Block Group 1, Census Tract 220.04, DeKalb County, Georgia",2663,1998,665,75.0281637251,24.9718362749
1872,1500000US130890220042,130890220042,"Block Group 2, Census Tract 220.04, DeKalb County, Georgia",1381,1302,79,94.2795076032,5.72049239681
1873,1500000US130890220043,130890220043,"Block Group 3, Census Tract 220.04, DeKalb County, Georgia",1977,1384,593,70.0050581689,29.9949418311
1874,1500000US130890220051,130890220051,"Block Group 1, Census Tract 220.05, DeKalb County, Georgia",1727,223,1504,12.9125651419,87.0874348581
1875,1500000US130890220052,130890220052,"Block Group 2, Census Tract 220.05, DeKalb County, Georgia",1117,555,562,49.6866606983,50.3133393017
1876,1500000US130890220053,130890220053,"Block Group 3, Census Tract 220.05, DeKalb County, Georgia",1736,631,1105,36.3479262673,63.6520737327
1877,1500000US130890220071,130890220071,"Block Group 1, Census Tract 220.07, DeKalb County, Georgia",2254,73,2181,3.23868677906,96.7613132209
1878,1500000US130890220072,130890220072,"Block Group 2, Census Tract 220.07, DeKalb County, Georgia",1833,197,1636,10.7474086197,89.2525913803
1879,1500000US130890220081,130890220081,"Block Group 1, Census Tract 220.08, DeKalb County, Georgia",1057,496,561,46.9252601703,53.0747398297
1880,1500000US130890220082,130890220082,"Block Group 2, Census Tract 220.08, DeKalb County, Georgia",2580,128,2452,4.96124031008,95.0387596899
1881,1500000US130890220083,130890220083,"Block Group 3, Census Tract 220.08, DeKalb County, Georgia",3693,327,3366,8.85458976442,91.1454102356
1882,1500000US130890220084,130890220084,"Block Group 4, Census Tract 220.08, DeKalb County, Georgia",1037,124,913,11.9575699132,88.0424300868
1883,1500000US130890220091,130890220091,"Block Group 1, Census Tract 220.09, DeKalb County, Georgia",1844,204,1640,11.0629067245,88.9370932755
1884,1500000US130890220092,130890220092,"Block Group 2, Census Tract 220.09, DeKalb County, Georgia",1905,163,1742,8.55643044619,91.4435695538
1885,1500000US130890220093,130890220093,"Block Group 3, Census Tract 220.09, DeKalb County, Georgia",1341,0,1341,0.0,100.0
1886,1500000US130890220101,130890220101,"Block Group 1, Census Tract 220.10, DeKalb County, Georgia",2659,1082,1577,40.6919894697,59.3080105303
1887,1500000US130890221001,130890221001,"Block Group 1, Census Tract 221, DeKalb County, Georgia",2090,939,1151,44.9282296651,55.0717703349
1888,1500000US130890221002,130890221002,"Block Group 2, Census Tract 221, DeKalb County, Georgia",1511,653,858,43.2164129715,56.7835870285
1889,1500000US130890222031,130890222031,"Block Group 1, Census Tract 222.03, DeKalb County, Georgia",2051,394,1657,19.2101413944,80.7898586056
1890,1500000US130890222041,130890222041,"Block Group 1, Census Tract 222.04, DeKalb County, Georgia",3732,1047,2685,28.0546623794,71.9453376206
1891,1500000US130890222042,130890222042,"Block Group 2, Census Tract 222.04, DeKalb County, Georgia",765,342,423,44.7058823529,55.2941176471
1892,1500000US130890222043,130890222043,"Block Group 3, Census Tract 222.04, DeKalb County, Georgia",1509,0,1509,0.0,100.0
1893,1500000US130890222044,130890222044,"Block Group 4, Census Tract 222.04, DeKalb County, Georgia",898,185,713,20.6013363029,79.3986636971
1894,1500000US130890223011,130890223011,"Block Group 1, Census Tract 223.01, DeKalb County, Georgia",1306,860,446,65.8499234303,34.1500765697
1895,1500000US130890223012,130890223012,"Block Group 2, Census Tract 223.01, DeKalb County, Georgia",498,231,267,46.3855421687,53.6144578313
1896,1500000US130890223013,130890223013,"Block Group 3, Census Tract 223.01, DeKalb County, Georgia",909,808,101,88.8888888889,11.1111111111
1897,1500000US130890223014,130890223014,"Block Group 4, Census Tract 223.01, DeKalb County, Georgia",1376,1026,350,74.5639534884,25.4360465116
1898,1500000US130890223015,130890223015,"Block Group 5, Census Tract 223.01, DeKalb County, Georgia",1801,315,1486,17.490283176,82.509716824
1899,1500000US130890223021,130890223021,"Block Group 1, Census Tract 223.02, DeKalb County, Georgia",1562,1258,304,80.5377720871,19.4622279129
1900,1500000US130890223022,130890223022,"Block Group 2, Census Tract 223.02, DeKalb County, Georgia",1274,531,743,41.6797488226,58.3202511774
1901,1500000US130890223023,130890223023,"Block Group 3, Census Tract 223.02, DeKalb County, Georgia",1728,610,1118,35.3009259259,64.6990740741
1902,1500000US130890224011,130890224011,"Block Group 1, Census Tract 224.01, DeKalb County, Georgia",1862,740,1122,39.7422126745,60.2577873255
1903,1500000US130890224012,130890224012,"Block Group 2, Census Tract 224.01, DeKalb County, Georgia",924,689,235,74.5670995671,25.4329004329
1904,1500000US130890224013,130890224013,"Block Group 3, Census Tract 224.01, DeKalb County, Georgia",973,826,147,84.8920863309,15.1079136691
1905,1500000US130890224021,130890224021,"Block Group 1, Census Tract 224.02, DeKalb County, Georgia",778,377,401,48.4575835476,51.5424164524
1906,1500000US130890224022,130890224022,"Block Group 2, Census Tract 224.02, DeKalb County, Georgia",467,23,444,4.92505353319,95.0749464668
1907,1500000US130890224031,130890224031,"Block Group 1, Census Tract 224.03, DeKalb County, Georgia",1304,1194,110,91.5644171779,8.43558282209
1908,1500000US130890224032,130890224032,"Block Group 2, Census Tract 224.03, DeKalb County, Georgia",1619,1246,373,76.9610870908,23.0389129092
1909,1500000US130890224033,130890224033,"Block Group 3, Census Tract 224.03, DeKalb County, Georgia",1065,1039,26,97.558685446,2.44131455399
1910,1500000US130890225001,130890225001,"Block Group 1, Census Tract 225, DeKalb County, Georgia",1992,326,1666,16.3654618474,83.6345381526
1911,1500000US130890225002,130890225002,"Block Group 2, Census Tract 225, DeKalb County, Georgia",1052,814,238,77.3764258555,22.6235741445
1912,1500000US130890225003,130890225003,"Block Group 3, Census Tract 225, DeKalb County, Georgia",1425,1176,249,82.5263157895,17.4736842105
1913,1500000US130890225004,130890225004,"Block Group 4, Census Tract 225, DeKalb County, Georgia",1784,1378,406,77.2421524664,22.7578475336
1914,1500000US130890226001,130890226001,"Block Group 1, Census Tract 226, DeKalb County, Georgia",1756,1366,390,77.7904328018,22.2095671982
1915,1500000US130890226002,130890226002,"Block Group 2, Census Tract 226, DeKalb County, Georgia",1960,1018,942,51.9387755102,48.0612244898
1916,1500000US130890226003,130890226003,"Block Group 3, Census Tract 226, DeKalb County, Georgia",1883,1193,690,63.356346256,36.643653744
1917,1500000US130890227001,130890227001,"Block Group 1, Census Tract 227, DeKalb County, Georgia",1882,1520,362,80.7651434644,19.2348565356
1918,1500000US130890227002,130890227002,"Block Group 2, Census Tract 227, DeKalb County, Georgia",964,819,145,84.9585062241,15.0414937759
1919,1500000US130890227003,130890227003,"Block Group 3, Census Tract 227, DeKalb County, Georgia",1446,1024,422,70.81604426,29.18395574
1920,1500000US130890228001,130890228001,"Block Group 1, Census Tract 228, DeKalb County, Georgia",534,354,180,66.2921348315,33.7078651685
1921,1500000US130890228002,130890228002,"Block Group 2, Census Tract 228, DeKalb County, Georgia",1689,1447,242,85.6719952635,14.3280047365
1922,1500000US130890228003,130890228003,"Block Group 3, Census Tract 228, DeKalb County, Georgia",960,818,142,85.2083333333,14.7916666667
1923,1500000US130890229001,130890229001,"Block Group 1, Census Tract 229, DeKalb County, Georgia",1511,879,632,58.1733951026,41.8266048974
1924,1500000US130890229002,130890229002,"Block Group 2, Census Tract 229, DeKalb County, Georgia",151,151,0,100.0,0.0
1925,1500000US130890229003,130890229003,"Block Group 3, Census Tract 229, DeKalb County, Georgia",1980,1528,452,77.1717171717,22.8282828283
1926,1500000US130890230001,130890230001,"Block Group 1, Census Tract 230, DeKalb County, Georgia",2096,1653,443,78.8645038168,21.1354961832
1927,1500000US130890231011,130890231011,"Block Group 1, Census Tract 231.01, DeKalb County, Georgia",638,496,142,77.7429467085,22.2570532915
1928,1500000US130890231012,130890231012,"Block Group 2, Census Tract 231.01, DeKalb County, Georgia",1657,1064,593,64.2124321062,35.7875678938
1929,1500000US130890231013,130890231013,"Block Group 3, Census Tract 231.01, DeKalb County, Georgia",833,501,332,60.144057623,39.855942377
1930,1500000US130890231014,130890231014,"Block Group 4, Census Tract 231.01, DeKalb County, Georgia",1455,894,561,61.4432989691,38.5567010309
1931,1500000US130890231021,130890231021,"Block Group 1, Census Tract 231.02, DeKalb County, Georgia",1443,964,479,66.8052668053,33.1947331947
1932,1500000US130890231022,130890231022,"Block Group 2, Census Tract 231.02, DeKalb County, Georgia",1768,421,1347,23.8122171946,76.1877828054
1933,1500000US130890231071,130890231071,"Block Group 1, Census Tract 231.07, DeKalb County, Georgia",1788,1035,753,57.8859060403,42.1140939597
1934,1500000US130890231072,130890231072,"Block Group 2, Census Tract 231.07, DeKalb County, Georgia",1320,323,997,24.4696969697,75.5303030303
1935,1500000US130890231073,130890231073,"Block Group 3, Census Tract 231.07, DeKalb County, Georgia",1388,749,639,53.9625360231,46.0374639769
1936,1500000US130890231081,130890231081,"Block Group 1, Census Tract 231.08, DeKalb County, Georgia",1629,541,1088,33.2105586249,66.7894413751
1937,1500000US130890231082,130890231082,"Block Group 2, Census Tract 231.08, DeKalb County, Georgia",1238,714,524,57.6736672052,42.3263327948
1938,1500000US130890231083,130890231083,"Block Group 3, Census Tract 231.08, DeKalb County, Georgia",1854,544,1310,29.3419633225,70.6580366775
1939,1500000US130890231111,130890231111,"Block Group 1, Census Tract 231.11, DeKalb County, Georgia",2048,1127,921,55.029296875,44.970703125
1940,1500000US130890231121,130890231121,"Block Group 1, Census Tract 231.12, DeKalb County, Georgia",1390,0,1390,0.0,100.0
1941,1500000US130890231122,130890231122,"Block Group 2, Census Tract 231.12, DeKalb County, Georgia",2334,430,1904,18.4233076264,81.5766923736
1942,1500000US130890231123,130890231123,"Block Group 3, Census Tract 231.12, DeKalb County, Georgia",541,92,449,17.0055452865,82.9944547135
1943,1500000US130890231131,130890231131,"Block Group 1, Census Tract 231.13, DeKalb County, Georgia",2059,493,1566,23.9436619718,76.0563380282
1944,1500000US130890231132,130890231132,"Block Group 2, Census Tract 231.13, DeKalb County, Georgia",1338,324,1014,24.2152466368,75.7847533632
1945,1500000US130890231141,130890231141,"Block Group 1, Census Tract 231.14, DeKalb County, Georgia",1094,870,224,79.5246800731,20.4753199269
1946,1500000US130890231142,130890231142,"Block Group 2, Census Tract 231.14, DeKalb County, Georgia",1331,978,353,73.4785875282,26.5214124718
1947,1500000US130890231151,130890231151,"Block Group 1, Census Tract 231.15, DeKalb County, Georgia",0,0,0,,
1948,1500000US130890232041,130890232041,"Block Group 1, Census Tract 232.04, DeKalb County, Georgia",2653,1187,1466,44.7418017339,55.2581982661
1949,1500000US130890232042,130890232042,"Block Group 2, Census Tract 232.04, DeKalb County, Georgia",2562,1752,810,68.3840749415,31.6159250585
1950,1500000US130890232043,130890232043,"Block Group 3, Census Tract 232.04, DeKalb County, Georgia",1915,1407,508,73.4725848564,26.5274151436
1951,1500000US130890232061,130890232061,"Block Group 1, Census Tract 232.06, DeKalb County, Georgia",2956,1810,1146,61.2313937754,38.7686062246
1952,1500000US130890232062,130890232062,"Block Group 2, Census Tract 232.06, DeKalb County, Georgia",3179,2232,947,70.2107581,29.7892419
1953,1500000US130890232063,130890232063,"Block Group 3, Census Tract 232.06, DeKalb County, Georgia",1507,533,974,35.3682813537,64.6317186463
1954,1500000US130890232081,130890232081,"Block Group 1, Census Tract 232.08, DeKalb County, Georgia",2542,1888,654,74.2722265932,25.7277734068
1955,1500000US130890232082,130890232082,"Block Group 2, Census Tract 232.08, DeKalb County, Georgia",1318,948,370,71.9271623672,28.0728376328
1956,1500000US130890232083,130890232083,"Block Group 3, Census Tract 232.08, DeKalb County, Georgia",3168,932,2236,29.4191919192,70.5808080808
1957,1500000US130890232091,130890232091,"Block Group 1, Census Tract 232.09, DeKalb County, Georgia",1485,750,735,50.5050505051,49.4949494949
1958,1500000US130890232092,130890232092,"Block Group 2, Census Tract 232.09, DeKalb County, Georgia",2528,2235,293,88.4098101266,11.5901898734
1959,1500000US130890232093,130890232093,"Block Group 3, Census Tract 232.09, DeKalb County, Georgia",1607,1120,487,69.6950840075,30.3049159925
1960,1500000US130890232101,130890232101,"Block Group 1, Census Tract 232.10, DeKalb County, Georgia",1247,1194,53,95.7497995188,4.25020048115
1961,1500000US130890232102,130890232102,"Block Group 2, Census Tract 232.10, DeKalb County, Georgia",753,270,483,35.8565737052,64.1434262948
1962,1500000US130890232103,130890232103,"Block Group 3, Census Tract 232.10, DeKalb County, Georgia",1792,1069,723,59.6540178571,40.3459821429
1963,1500000US130890232104,130890232104,"Block Group 4, Census Tract 232.10, DeKalb County, Georgia",644,359,285,55.7453416149,44.2546583851
1964,1500000US130890232105,130890232105,"Block Group 5, Census Tract 232.10, DeKalb County, Georgia",2029,209,1820,10.3006407097,89.6993592903
1965,1500000US130890232111,130890232111,"Block Group 1, Census Tract 232.11, DeKalb County, Georgia",1483,1091,392,73.5670937289,26.4329062711
1966,1500000US130890232112,130890232112,"Block Group 2, Census Tract 232.11, DeKalb County, Georgia",1528,763,765,49.9345549738,50.0654450262
1967,1500000US130890232121,130890232121,"Block Group 1, Census Tract 232.12, DeKalb County, Georgia",1499,1084,415,72.3148765844,27.6851234156
1968,1500000US130890232122,130890232122,"Block Group 2, Census Tract 232.12, DeKalb County, Georgia",2095,1218,877,58.138424821,41.861575179
1969,1500000US130890232131,130890232131,"Block Group 1, Census Tract 232.13, DeKalb County, Georgia",1226,886,340,72.2675367047,27.7324632953
1970,1500000US130890232132,130890232132,"Block Group 2, Census Tract 232.13, DeKalb County, Georgia",1502,1355,147,90.2130492676,9.78695073236
1971,1500000US130890232133,130890232133,"Block Group 3, Census Tract 232.13, DeKalb County, Georgia",3186,1329,1857,41.713747646,58.286252354
1972,1500000US130890232141,130890232141,"Block Group 1, Census Tract 232.14, DeKalb County, Georgia",3199,1609,1590,50.2969678024,49.7030321976
1973,1500000US130890232142,130890232142,"Block Group 2, Census Tract 232.14, DeKalb County, Georgia",2887,1054,1833,36.508486318,63.491513682
1974,1500000US130890233031,130890233031,"Block Group 1, Census Tract 233.03, DeKalb County, Georgia",3472,2582,890,74.366359447,25.633640553
1975,1500000US130890233032,130890233032,"Block Group 2, Census Tract 233.03, DeKalb County, Georgia",809,458,351,56.6131025958,43.3868974042
1976,1500000US130890233033,130890233033,"Block Group 3, Census Tract 233.03, DeKalb County, Georgia",960,357,603,37.1875,62.8125
1977,1500000US130890233034,130890233034,"Block Group 4, Census Tract 233.03, DeKalb County, Georgia",1563,398,1165,25.4638515675,74.5361484325
1978,1500000US130890233061,130890233061,"Block Group 1, Census Tract 233.06, DeKalb County, Georgia",2635,2155,480,81.7836812144,18.2163187856
1979,1500000US130890233062,130890233062,"Block Group 2, Census Tract 233.06, DeKalb County, Georgia",2006,1547,459,77.1186440678,22.8813559322
1980,1500000US130890233063,130890233063,"Block Group 3, Census Tract 233.06, DeKalb County, Georgia",2306,2082,224,90.2862098873,9.71379011275
1981,1500000US130890233091,130890233091,"Block Group 1, Census Tract 233.09, DeKalb County, Georgia",1212,604,608,49.8349834983,50.1650165017
1982,1500000US130890233092,130890233092,"Block Group 2, Census Tract 233.09, DeKalb County, Georgia",1890,1416,474,74.9206349206,25.0793650794
1983,1500000US130890233093,130890233093,"Block Group 3, Census Tract 233.09, DeKalb County, Georgia",4417,2397,2020,54.2676024451,45.7323975549
1984,1500000US130890233094,130890233094,"Block Group 4, Census Tract 233.09, DeKalb County, Georgia",1911,1434,477,75.0392464678,24.9607535322
1985,1500000US130890233101,130890233101,"Block Group 1, Census Tract 233.10, DeKalb County, Georgia",2315,635,1680,27.4298056156,72.5701943844
1986,1500000US130890233102,130890233102,"Block Group 2, Census Tract 233.10, DeKalb County, Georgia",3920,792,3128,20.2040816327,79.7959183673
1987,1500000US130890233103,130890233103,"Block Group 3, Census Tract 233.10, DeKalb County, Georgia",1788,0,1788,0.0,100.0
1988,1500000US130890233104,130890233104,"Block Group 4, Census Tract 233.10, DeKalb County, Georgia",1339,543,796,40.5526512323,59.4473487677
1989,1500000US130890233111,130890233111,"Block Group 1, Census Tract 233.11, DeKalb County, Georgia",3090,2495,595,80.7443365696,19.2556634304
1990,1500000US130890233112,130890233112,"Block Group 2, Census Tract 233.11, DeKalb County, Georgia",1899,840,1059,44.233807267,55.766192733
1991,1500000US130890233121,130890233121,"Block Group 1, Census Tract 233.12, DeKalb County, Georgia",3860,3343,517,86.6062176166,13.3937823834
1992,1500000US130890233122,130890233122,"Block Group 2, Census Tract 233.12, DeKalb County, Georgia",2905,2198,707,75.6626506024,24.3373493976
1993,1500000US130890233123,130890233123,"Block Group 3, Census Tract 233.12, DeKalb County, Georgia",2397,1440,957,60.0750938673,39.9249061327
1994,1500000US130890233131,130890233131,"Block Group 1, Census Tract 233.13, DeKalb County, Georgia",1918,1204,714,62.7737226277,37.2262773723
1995,1500000US130890233132,130890233132,"Block Group 2, Census Tract 233.13, DeKalb County, Georgia",3001,2395,606,79.8067310896,20.1932689104
1996,1500000US130890233141,130890233141,"Block Group 1, Census Tract 233.14, DeKalb County, Georgia",1630,1169,461,71.717791411,28.282208589
1997,1500000US130890233142,130890233142,"Block Group 2, Census Tract 233.14, DeKalb County, Georgia",2020,1439,581,71.2376237624,28.7623762376
1998,1500000US130890233143,130890233143,"Block Group 3, Census Tract 233.14, DeKalb County, Georgia",1419,1037,382,73.0796335447,26.9203664553
1999,1500000US130890233151,130890233151,"Block Group 1, Census Tract 233.15, DeKalb County, Georgia",3177,2815,362,88.6056027699,11.3943972301
2000,1500000US130890233152,130890233152,"Block Group 2, Census Tract 233.15, DeKalb County, Georgia",1538,1312,226,85.3055916775,14.6944083225
2001,1500000US130890233161,130890233161,"Block Group 1, Census Tract 233.16, DeKalb County, Georgia",2897,2563,334,88.4708318951,11.5291681049
2002,1500000US130890233162,130890233162,"Block Group 2, Census Tract 233.16, DeKalb County, Georgia",3482,2408,1074,69.155657668,30.844342332
2003,1500000US130890233163,130890233163,"Block Group 3, Census Tract 233.16, DeKalb County, Georgia",1652,1053,599,63.7409200969,36.2590799031
2004,1500000US130890234101,130890234101,"Block Group 1, Census Tract 234.10, DeKalb County, Georgia",1417,85,1332,5.9985885674,94.0014114326
2005,1500000US130890234102,130890234102,"Block Group 2, Census Tract 234.10, DeKalb County, Georgia",1715,984,731,57.3760932945,42.6239067055
2006,1500000US130890234111,130890234111,"Block Group 1, Census Tract 234.11, DeKalb County, Georgia",1916,1236,680,64.509394572,35.490605428
2007,1500000US130890234112,130890234112,"Block Group 2, Census Tract 234.11, DeKalb County, Georgia",2031,1324,707,65.1895617922,34.8104382078
2008,1500000US130890234121,130890234121,"Block Group 1, Census Tract 234.12, DeKalb County, Georgia",2013,953,1060,47.3422752111,52.6577247889
2009,1500000US130890234122,130890234122,"Block Group 2, Census Tract 234.12, DeKalb County, Georgia",1803,1250,553,69.328896284,30.671103716
2010,1500000US130890234123,130890234123,"Block Group 3, Census Tract 234.12, DeKalb County, Georgia",2646,2161,485,81.6704459562,18.3295540438
2011,1500000US130890234131,130890234131,"Block Group 1, Census Tract 234.13, DeKalb County, Georgia",1703,1531,172,89.9001761597,10.0998238403
2012,1500000US130890234132,130890234132,"Block Group 2, Census Tract 234.13, DeKalb County, Georgia",1699,1414,285,83.2254267216,16.7745732784
2013,1500000US130890234141,130890234141,"Block Group 1, Census Tract 234.14, DeKalb County, Georgia",2144,1032,1112,48.1343283582,51.8656716418
2014,1500000US130890234142,130890234142,"Block Group 2, Census Tract 234.14, DeKalb County, Georgia",1221,1097,124,89.8443898444,10.1556101556
2015,1500000US130890234143,130890234143,"Block Group 3, Census Tract 234.14, DeKalb County, Georgia",3084,2555,529,82.8469520104,17.1530479896
2016,1500000US130890234161,130890234161,"Block Group 1, Census Tract 234.16, DeKalb County, Georgia",1974,562,1412,28.4701114488,71.5298885512
2017,1500000US130890234162,130890234162,"Block Group 2, Census Tract 234.16, DeKalb County, Georgia",2798,1715,1083,61.2937812723,38.7062187277
2018,1500000US130890234163,130890234163,"Block Group 3, Census Tract 234.16, DeKalb County, Georgia",1563,1229,334,78.6308381318,21.3691618682
2019,1500000US130890234164,130890234164,"Block Group 4, Census Tract 234.16, DeKalb County, Georgia",1555,1372,183,88.231511254,11.768488746
2020,1500000US130890234181,130890234181,"Block Group 1, Census Tract 234.18, DeKalb County, Georgia",6274,1859,4415,29.6302199554,70.3697800446
2021,1500000US130890234182,130890234182,"Block Group 2, Census Tract 234.18, DeKalb County, Georgia",3318,3019,299,90.9885473177,9.01145268234
2022,1500000US130890234183,130890234183,"Block Group 3, Census Tract 234.18, DeKalb County, Georgia",3741,3016,725,80.6201550388,19.3798449612
2023,1500000US130890234184,130890234184,"Block Group 4, Census Tract 234.18, DeKalb County, Georgia",5964,4090,1874,68.5781354795,31.4218645205
2024,1500000US130890234191,130890234191,"Block Group 1, Census Tract 234.19, DeKalb County, Georgia",6061,5135,926,84.7219930705,15.2780069295
2025,1500000US130890234192,130890234192,"Block Group 2, Census Tract 234.19, DeKalb County, Georgia",1448,1362,86,94.0607734807,5.93922651934
2026,1500000US130890234193,130890234193,"Block Group 3, Census Tract 234.19, DeKalb County, Georgia",1960,1567,393,79.9489795918,20.0510204082
2027,1500000US130890234211,130890234211,"Block Group 1, Census Tract 234.21, DeKalb County, Georgia",3051,461,2590,15.1098000656,84.8901999344
2028,1500000US130890234212,130890234212,"Block Group 2, Census Tract 234.21, DeKalb County, Georgia",1167,817,350,70.0085689803,29.9914310197
2029,1500000US130890234213,130890234213,"Block Group 3, Census Tract 234.21, DeKalb County, Georgia",3567,1671,1896,46.8460891505,53.1539108495
2030,1500000US130890234221,130890234221,"Block Group 1, Census Tract 234.22, DeKalb County, Georgia",1762,1639,123,93.0192962543,6.98070374574
2031,1500000US130890234222,130890234222,"Block Group 2, Census Tract 234.22, DeKalb County, Georgia",3171,2439,732,76.9157994324,23.0842005676
2032,1500000US130890234231,130890234231,"Block Group 1, Census Tract 234.23, DeKalb County, Georgia",2794,2738,56,97.9957050823,2.00429491768
2033,1500000US130890234232,130890234232,"Block Group 2, Census Tract 234.23, DeKalb County, Georgia",1325,1148,177,86.641509434,13.358490566
2034,1500000US130890234233,130890234233,"Block Group 3, Census Tract 234.23, DeKalb County, Georgia",3337,2273,1064,68.1150734192,31.8849265808
2035,1500000US130890234241,130890234241,"Block Group 1, Census Tract 234.24, DeKalb County, Georgia",4005,3517,488,87.8152309613,12.1847690387
2036,1500000US130890234242,130890234242,"Block Group 2, Census Tract 234.24, DeKalb County, Georgia",1884,1275,609,67.6751592357,32.3248407643
2037,1500000US130890234251,130890234251,"Block Group 1, Census Tract 234.25, DeKalb County, Georgia",2349,2058,291,87.6117496807,12.3882503193
2038,1500000US130890234252,130890234252,"Block Group 2, Census Tract 234.25, DeKalb County, Georgia",3424,2255,1169,65.8586448598,34.1413551402
2039,1500000US130890234261,130890234261,"Block Group 1, Census Tract 234.26, DeKalb County, Georgia",2614,2243,371,85.8071920428,14.1928079572
2040,1500000US130890234262,130890234262,"Block Group 2, Census Tract 234.26, DeKalb County, Georgia",2206,1640,566,74.3427017226,25.6572982774
2041,1500000US130890234271,130890234271,"Block Group 1, Census Tract 234.27, DeKalb County, Georgia",2099,1615,484,76.941400667,23.058599333
2042,1500000US130890234272,130890234272,"Block Group 2, Census Tract 234.27, DeKalb County, Georgia",732,655,77,89.4808743169,10.5191256831
2043,1500000US130890234281,130890234281,"Block Group 1, Census Tract 234.28, DeKalb County, Georgia",831,125,706,15.0421179302,84.9578820698
2044,1500000US130890234282,130890234282,"Block Group 2, Census Tract 234.28, DeKalb County, Georgia",2659,758,1901,28.5069575028,71.4930424972
2045,1500000US130890234283,130890234283,"Block Group 3, Census Tract 234.28, DeKalb County, Georgia",4534,1186,3348,26.1579179532,73.8420820468
2046,1500000US130890234284,130890234284,"Block Group 4, Census Tract 234.28, DeKalb County, Georgia",1675,429,1246,25.6119402985,74.3880597015
2047,1500000US130890235011,130890235011,"Block Group 1, Census Tract 235.01, DeKalb County, Georgia",1472,530,942,36.0054347826,63.9945652174
2048,1500000US130890235012,130890235012,"Block Group 2, Census Tract 235.01, DeKalb County, Georgia",1786,586,1200,32.81075028,67.18924972
2049,1500000US130890235041,130890235041,"Block Group 1, Census Tract 235.04, DeKalb County, Georgia",782,573,209,73.273657289,26.726342711
2050,1500000US130890235042,130890235042,"Block Group 2, Census Tract 235.04, DeKalb County, Georgia",687,249,438,36.2445414847,63.7554585153
2051,1500000US130890235043,130890235043,"Block Group 3, Census Tract 235.04, DeKalb County, Georgia",1555,137,1418,8.81028938907,91.1897106109
2052,1500000US130890235051,130890235051,"Block Group 1, Census Tract 235.05, DeKalb County, Georgia",1278,750,528,58.6854460094,41.3145539906
2053,1500000US130890235052,130890235052,"Block Group 2, Census Tract 235.05, DeKalb County, Georgia",1188,934,254,78.6195286195,21.3804713805
2054,1500000US130890235061,130890235061,"Block Group 1, Census Tract 235.06, DeKalb County, Georgia",2137,805,1332,37.6696303229,62.3303696771
2055,1500000US130890235062,130890235062,"Block Group 2, Census Tract 235.06, DeKalb County, Georgia",1831,1424,407,77.7717094484,22.2282905516
2056,1500000US130890235063,130890235063,"Block Group 3, Census Tract 235.06, DeKalb County, Georgia",1767,1385,382,78.3814374646,21.6185625354
2057,1500000US130890235071,130890235071,"Block Group 1, Census Tract 235.07, DeKalb County, Georgia",1109,400,709,36.0685302074,63.9314697926
2058,1500000US130890235072,130890235072,"Block Group 2, Census Tract 235.07, DeKalb County, Georgia",1018,787,231,77.3084479371,22.6915520629
2059,1500000US130890235073,130890235073,"Block Group 3, Census Tract 235.07, DeKalb County, Georgia",1738,1463,275,84.1772151899,15.8227848101
2060,1500000US130890236011,130890236011,"Block Group 1, Census Tract 236.01, DeKalb County, Georgia",1018,706,312,69.3516699411,30.6483300589
2061,1500000US130890236012,130890236012,"Block Group 2, Census Tract 236.01, DeKalb County, Georgia",1208,896,312,74.1721854305,25.8278145695
2062,1500000US130890236013,130890236013,"Block Group 3, Census Tract 236.01, DeKalb County, Georgia",873,470,403,53.8373424971,46.1626575029
2063,1500000US130890236021,130890236021,"Block Group 1, Census Tract 236.02, DeKalb County, Georgia",1000,645,355,64.5,35.5
2064,1500000US130890236022,130890236022,"Block Group 2, Census Tract 236.02, DeKalb County, Georgia",1591,942,649,59.2080452546,40.7919547454
2065,1500000US130890236031,130890236031,"Block Group 1, Census Tract 236.03, DeKalb County, Georgia",1622,995,627,61.3440197287,38.6559802713
2066,1500000US130890236032,130890236032,"Block Group 2, Census Tract 236.03, DeKalb County, Georgia",1747,754,993,43.1597023469,56.8402976531
2067,1500000US130890237001,130890237001,"Block Group 1, Census Tract 237, DeKalb County, Georgia",1736,552,1184,31.797235023,68.202764977
2068,1500000US130890237002,130890237002,"Block Group 2, Census Tract 237, DeKalb County, Georgia",1343,848,495,63.1422189129,36.8577810871
2069,1500000US130890237003,130890237003,"Block Group 3, Census Tract 237, DeKalb County, Georgia",1469,310,1159,21.1027910143,78.8972089857
2070,1500000US130890237004,130890237004,"Block Group 4, Census Tract 237, DeKalb County, Georgia",1147,332,815,28.9450741064,71.0549258936
2071,1500000US130890238011,130890238011,"Block Group 1, Census Tract 238.01, DeKalb County, Georgia",675,551,124,81.6296296296,18.3703703704
2072,1500000US130890238012,130890238012,"Block Group 2, Census Tract 238.01, DeKalb County, Georgia",1642,960,682,58.4652862363,41.5347137637
2073,1500000US130890238013,130890238013,"Block Group 3, Census Tract 238.01, DeKalb County, Georgia",1261,1021,240,80.9674861221,19.0325138779
2074,1500000US130890238021,130890238021,"Block Group 1, Census Tract 238.02, DeKalb County, Georgia",1309,530,779,40.4889228419,59.5110771581
2075,1500000US130890238022,130890238022,"Block Group 2, Census Tract 238.02, DeKalb County, Georgia",2413,895,1518,37.090758392,62.909241608
2076,1500000US130890238031,130890238031,"Block Group 1, Census Tract 238.03, DeKalb County, Georgia",1131,757,374,66.9319186561,33.0680813439
2077,1500000US130890238032,130890238032,"Block Group 2, Census Tract 238.03, DeKalb County, Georgia",804,520,284,64.6766169154,35.3233830846
2078,1500000US130890238033,130890238033,"Block Group 3, Census Tract 238.03, DeKalb County, Georgia",1672,1046,626,62.5598086124,37.4401913876
2079,1500000US130890238034,130890238034,"Block Group 4, Census Tract 238.03, DeKalb County, Georgia",1708,1257,451,73.5948477752,26.4051522248
2080,1500000US130899800001,130899800001,"Block Group 1, Census Tract 9800, DeKalb County, Georgia",0,0,0,,
2081,1500000US130919601001,130919601001,"Block Group 1, Census Tract 9601, Dodge County, Georgia",1097,769,328,70.1002734731,29.8997265269
2082,1500000US130919601002,130919601002,"Block Group 2, Census Tract 9601, Dodge County, Georgia",874,741,133,84.7826086957,15.2173913043
2083,1500000US130919602001,130919602001,"Block Group 1, Census Tract 9602, Dodge County, Georgia",1736,1260,476,72.5806451613,27.4193548387
2084,1500000US130919602002,130919602002,"Block Group 2, Census Tract 9602, Dodge County, Georgia",805,506,299,62.8571428571,37.1428571429
2085,1500000US130919602003,130919602003,"Block Group 3, Census Tract 9602, Dodge County, Georgia",577,284,293,49.2201039861,50.7798960139
2086,1500000US130919603001,130919603001,"Block Group 1, Census Tract 9603, Dodge County, Georgia",1583,1163,420,73.4680985471,26.5319014529
2087,1500000US130919603002,130919603002,"Block Group 2, Census Tract 9603, Dodge County, Georgia",1463,719,744,49.1455912509,50.8544087491
2088,1500000US130919603003,130919603003,"Block Group 3, Census Tract 9603, Dodge County, Georgia",890,581,309,65.2808988764,34.7191011236
2089,1500000US130919603004,130919603004,"Block Group 4, Census Tract 9603, Dodge County, Georgia",1059,1059,0,100.0,0.0
2090,1500000US130919603005,130919603005,"Block Group 5, Census Tract 9603, Dodge County, Georgia",1261,649,612,51.4670896114,48.5329103886
2091,1500000US130919604001,130919604001,"Block Group 1, Census Tract 9604, Dodge County, Georgia",872,372,500,42.6605504587,57.3394495413
2092,1500000US130919604002,130919604002,"Block Group 2, Census Tract 9604, Dodge County, Georgia",1365,779,586,57.0695970696,42.9304029304
2093,1500000US130919604003,130919604003,"Block Group 3, Census Tract 9604, Dodge County, Georgia",1280,577,703,45.078125,54.921875
2094,1500000US130919605001,130919605001,"Block Group 1, Census Tract 9605, Dodge County, Georgia",1046,762,284,72.8489483748,27.1510516252
2095,1500000US130919605002,130919605002,"Block Group 2, Census Tract 9605, Dodge County, Georgia",1128,880,248,78.0141843972,21.9858156028
2096,1500000US130919606001,130919606001,"Block Group 1, Census Tract 9606, Dodge County, Georgia",1031,745,286,72.2599418041,27.7400581959
2097,1500000US130919606002,130919606002,"Block Group 2, Census Tract 9606, Dodge County, Georgia",913,716,197,78.4227820372,21.5772179628
2098,1500000US130939701001,130939701001,"Block Group 1, Census Tract 9701, Dooly County, Georgia",1667,1304,363,78.224355129,21.775644871
2099,1500000US130939701002,130939701002,"Block Group 2, Census Tract 9701, Dooly County, Georgia",1732,947,785,54.6766743649,45.3233256351
2100,1500000US130939701003,130939701003,"Block Group 3, Census Tract 9701, Dooly County, Georgia",681,544,137,79.8825256975,20.1174743025
2101,1500000US130939702001,130939702001,"Block Group 1, Census Tract 9702, Dooly County, Georgia",790,469,321,59.3670886076,40.6329113924
2102,1500000US130939702002,130939702002,"Block Group 2, Census Tract 9702, Dooly County, Georgia",1244,1048,196,84.2443729904,15.7556270096
2103,1500000US130939703001,130939703001,"Block Group 1, Census Tract 9703, Dooly County, Georgia",1994,1215,779,60.9327983952,39.0672016048
2104,1500000US130939703002,130939703002,"Block Group 2, Census Tract 9703, Dooly County, Georgia",1611,793,818,49.2240844196,50.7759155804
2105,1500000US130939703003,130939703003,"Block Group 3, Census Tract 9703, Dooly County, Georgia",2021,1426,595,70.559129144,29.440870856
2106,1500000US130939703004,130939703004,"Block Group 4, Census Tract 9703, Dooly County, Georgia",879,379,500,43.1171786121,56.8828213879
2107,1500000US130950001001,130950001001,"Block Group 1, Census Tract 1, Dougherty County, Georgia",878,674,204,76.7653758542,23.2346241458
2108,1500000US130950001002,130950001002,"Block Group 2, Census Tract 1, Dougherty County, Georgia",366,130,236,35.5191256831,64.4808743169
2109,1500000US130950001003,130950001003,"Block Group 3, Census Tract 1, Dougherty County, Georgia",970,186,784,19.175257732,80.824742268
2110,1500000US130950001004,130950001004,"Block Group 4, Census Tract 1, Dougherty County, Georgia",1421,229,1192,16.1154116819,83.8845883181
2111,1500000US130950001005,130950001005,"Block Group 5, Census Tract 1, Dougherty County, Georgia",895,442,453,49.3854748603,50.6145251397
2112,1500000US130950002001,130950002001,"Block Group 1, Census Tract 2, Dougherty County, Georgia",785,163,622,20.7643312102,79.2356687898
2113,1500000US130950002002,130950002002,"Block Group 2, Census Tract 2, Dougherty County, Georgia",291,96,195,32.9896907216,67.0103092784
2114,1500000US130950002003,130950002003,"Block Group 3, Census Tract 2, Dougherty County, Georgia",1328,441,887,33.2078313253,66.7921686747
2115,1500000US130950002004,130950002004,"Block Group 4, Census Tract 2, Dougherty County, Georgia",540,133,407,24.6296296296,75.3703703704
2116,1500000US130950004001,130950004001,"Block Group 1, Census Tract 4, Dougherty County, Georgia",1354,349,1005,25.7754800591,74.2245199409
2117,1500000US130950004002,130950004002,"Block Group 2, Census Tract 4, Dougherty County, Georgia",2320,574,1746,24.7413793103,75.2586206897
2118,1500000US130950004003,130950004003,"Block Group 3, Census Tract 4, Dougherty County, Georgia",2324,410,1914,17.6419965577,82.3580034423
2119,1500000US130950005011,130950005011,"Block Group 1, Census Tract 5.01, Dougherty County, Georgia",3564,1743,1821,48.9057239057,51.0942760943
2120,1500000US130950005012,130950005012,"Block Group 2, Census Tract 5.01, Dougherty County, Georgia",1511,682,829,45.1356717406,54.8643282594
2121,1500000US130950005021,130950005021,"Block Group 1, Census Tract 5.02, Dougherty County, Georgia",1752,1025,727,58.50456621,41.49543379
2122,1500000US130950005022,130950005022,"Block Group 2, Census Tract 5.02, Dougherty County, Georgia",1500,1224,276,81.6,18.4
2123,1500000US130950005023,130950005023,"Block Group 3, Census Tract 5.02, Dougherty County, Georgia",677,653,24,96.4549483013,3.54505169867
2124,1500000US130950005024,130950005024,"Block Group 4, Census Tract 5.02, Dougherty County, Georgia",969,838,131,86.4809081527,13.5190918473
2125,1500000US130950006001,130950006001,"Block Group 1, Census Tract 6, Dougherty County, Georgia",1284,660,624,51.4018691589,48.5981308411
2126,1500000US130950006002,130950006002,"Block Group 2, Census Tract 6, Dougherty County, Georgia",1661,207,1454,12.462372065,87.537627935
2127,1500000US130950007001,130950007001,"Block Group 1, Census Tract 7, Dougherty County, Georgia",1903,819,1084,43.0373095113,56.9626904887
2128,1500000US130950008001,130950008001,"Block Group 1, Census Tract 8, Dougherty County, Georgia",889,55,834,6.18672665917,93.8132733408
2129,1500000US130950008002,130950008002,"Block Group 2, Census Tract 8, Dougherty County, Georgia",541,96,445,17.7449168207,82.2550831793
2130,1500000US130950009001,130950009001,"Block Group 1, Census Tract 9, Dougherty County, Georgia",1030,308,722,29.9029126214,70.0970873786
2131,1500000US130950009002,130950009002,"Block Group 2, Census Tract 9, Dougherty County, Georgia",1020,282,738,27.6470588235,72.3529411765
2132,1500000US130950010001,130950010001,"Block Group 1, Census Tract 10, Dougherty County, Georgia",512,148,364,28.90625,71.09375
2133,1500000US130950010002,130950010002,"Block Group 2, Census Tract 10, Dougherty County, Georgia",1567,286,1281,18.2514358647,81.7485641353
2134,1500000US130950011001,130950011001,"Block Group 1, Census Tract 11, Dougherty County, Georgia",1513,40,1473,2.64375413087,97.3562458691
2135,1500000US130950011002,130950011002,"Block Group 2, Census Tract 11, Dougherty County, Georgia",1110,488,622,43.963963964,56.036036036
2136,1500000US130950011003,130950011003,"Block Group 3, Census Tract 11, Dougherty County, Georgia",907,370,537,40.7938257993,59.2061742007
2137,1500000US130950011004,130950011004,"Block Group 4, Census Tract 11, Dougherty County, Georgia",1086,403,683,37.1086556169,62.8913443831
2138,1500000US130950011005,130950011005,"Block Group 5, Census Tract 11, Dougherty County, Georgia",1501,873,628,58.1612258494,41.8387741506
2139,1500000US130950014031,130950014031,"Block Group 1, Census Tract 14.03, Dougherty County, Georgia",1081,158,923,14.6160962072,85.3839037928
2140,1500000US130950014032,130950014032,"Block Group 2, Census Tract 14.03, Dougherty County, Georgia",1399,483,916,34.5246604718,65.4753395282
2141,1500000US130950015001,130950015001,"Block Group 1, Census Tract 15, Dougherty County, Georgia",693,110,583,15.873015873,84.126984127
2142,1500000US130950015002,130950015002,"Block Group 2, Census Tract 15, Dougherty County, Georgia",1164,447,717,38.4020618557,61.5979381443
2143,1500000US130950015003,130950015003,"Block Group 3, Census Tract 15, Dougherty County, Georgia",920,111,809,12.0652173913,87.9347826087
2144,1500000US130950103021,130950103021,"Block Group 1, Census Tract 103.02, Dougherty County, Georgia",805,385,420,47.8260869565,52.1739130435
2145,1500000US130950103022,130950103022,"Block Group 2, Census Tract 103.02, Dougherty County, Georgia",1092,160,932,14.652014652,85.347985348
2146,1500000US130950103023,130950103023,"Block Group 3, Census Tract 103.02, Dougherty County, Georgia",758,504,254,66.4907651715,33.5092348285
2147,1500000US130950103024,130950103024,"Block Group 4, Census Tract 103.02, Dougherty County, Georgia",712,349,363,49.0168539326,50.9831460674
2148,1500000US130950103025,130950103025,"Block Group 5, Census Tract 103.02, Dougherty County, Georgia",1579,190,1389,12.0329322356,87.9670677644
2149,1500000US130950104011,130950104011,"Block Group 1, Census Tract 104.01, Dougherty County, Georgia",2220,1884,336,84.8648648649,15.1351351351
2150,1500000US130950104012,130950104012,"Block Group 2, Census Tract 104.01, Dougherty County, Georgia",3110,2117,993,68.0707395498,31.9292604502
2151,1500000US130950104013,130950104013,"Block Group 3, Census Tract 104.01, Dougherty County, Georgia",2071,2017,54,97.3925639788,2.60743602125
2152,1500000US130950104021,130950104021,"Block Group 1, Census Tract 104.02, Dougherty County, Georgia",3026,1731,1295,57.2042300066,42.7957699934
2153,1500000US130950104031,130950104031,"Block Group 1, Census Tract 104.03, Dougherty County, Georgia",1581,1230,351,77.7988614801,22.2011385199
2154,1500000US130950105001,130950105001,"Block Group 1, Census Tract 105, Dougherty County, Georgia",1579,1058,521,67.0044331856,32.9955668144
2155,1500000US130950105002,130950105002,"Block Group 2, Census Tract 105, Dougherty County, Georgia",754,704,50,93.3687002653,6.63129973475
2156,1500000US130950106011,130950106011,"Block Group 1, Census Tract 106.01, Dougherty County, Georgia",1181,293,888,24.8094834886,75.1905165114
2157,1500000US130950106012,130950106012,"Block Group 2, Census Tract 106.01, Dougherty County, Georgia",1270,269,1001,21.1811023622,78.8188976378
2158,1500000US130950106021,130950106021,"Block Group 1, Census Tract 106.02, Dougherty County, Georgia",2050,1196,854,58.3414634146,41.6585365854
2159,1500000US130950106022,130950106022,"Block Group 2, Census Tract 106.02, Dougherty County, Georgia",1942,1102,840,56.745623069,43.254376931
2160,1500000US130950107001,130950107001,"Block Group 1, Census Tract 107, Dougherty County, Georgia",3135,755,2380,24.0829346093,75.9170653907
2161,1500000US130950107002,130950107002,"Block Group 2, Census Tract 107, Dougherty County, Georgia",949,264,685,27.8187565859,72.1812434141
2162,1500000US130950107003,130950107003,"Block Group 3, Census Tract 107, Dougherty County, Georgia",1243,73,1170,5.87288817377,94.1271118262
2163,1500000US130950109001,130950109001,"Block Group 1, Census Tract 109, Dougherty County, Georgia",1074,848,226,78.95716946,21.04283054
2164,1500000US130950109002,130950109002,"Block Group 2, Census Tract 109, Dougherty County, Georgia",581,483,98,83.1325301205,16.8674698795
2165,1500000US130950109003,130950109003,"Block Group 3, Census Tract 109, Dougherty County, Georgia",21,21,0,100.0,0.0
2166,1500000US130950110001,130950110001,"Block Group 1, Census Tract 110, Dougherty County, Georgia",1294,1285,9,99.3044822257,0.695517774343
2167,1500000US130950110002,130950110002,"Block Group 2, Census Tract 110, Dougherty County, Georgia",1225,1013,212,82.693877551,17.306122449
2168,1500000US130950112001,130950112001,"Block Group 1, Census Tract 112, Dougherty County, Georgia",871,737,134,84.6153846154,15.3846153846
2169,1500000US130950112002,130950112002,"Block Group 2, Census Tract 112, Dougherty County, Georgia",1344,613,731,45.6101190476,54.3898809524
2170,1500000US130950112003,130950112003,"Block Group 3, Census Tract 112, Dougherty County, Georgia",1151,806,345,70.0260642919,29.9739357081
2171,1500000US130950113001,130950113001,"Block Group 1, Census Tract 113, Dougherty County, Georgia",2151,700,1451,32.5430032543,67.4569967457
2172,1500000US130950114001,130950114001,"Block Group 1, Census Tract 114, Dougherty County, Georgia",1260,301,959,23.8888888889,76.1111111111
2173,1500000US130950114002,130950114002,"Block Group 2, Census Tract 114, Dougherty County, Georgia",168,26,142,15.4761904762,84.5238095238
2174,1500000US130950116001,130950116001,"Block Group 1, Census Tract 116, Dougherty County, Georgia",1547,1290,257,83.3872010343,16.6127989657
2175,1500000US130950116002,130950116002,"Block Group 2, Census Tract 116, Dougherty County, Georgia",417,65,352,15.587529976,84.412470024
2176,1500000US130970801021,130970801021,"Block Group 1, Census Tract 801.02, Douglas County, Georgia",1889,1029,860,54.4732662785,45.5267337215
2177,1500000US130970801022,130970801022,"Block Group 2, Census Tract 801.02, Douglas County, Georgia",5492,2039,3453,37.1267297888,62.8732702112
2178,1500000US130970801031,130970801031,"Block Group 1, Census Tract 801.03, Douglas County, Georgia",1459,0,1459,0.0,100.0
2179,1500000US130970801032,130970801032,"Block Group 2, Census Tract 801.03, Douglas County, Georgia",1623,1056,567,65.0646950092,34.9353049908
2180,1500000US130970801033,130970801033,"Block Group 3, Census Tract 801.03, Douglas County, Georgia",1094,0,1094,0.0,100.0
2181,1500000US130970801034,130970801034,"Block Group 4, Census Tract 801.03, Douglas County, Georgia",2769,1196,1573,43.1924882629,56.8075117371
2182,1500000US130970802011,130970802011,"Block Group 1, Census Tract 802.01, Douglas County, Georgia",750,733,17,97.7333333333,2.26666666667
2183,1500000US130970802012,130970802012,"Block Group 2, Census Tract 802.01, Douglas County, Georgia",3179,2221,958,69.8647373388,30.1352626612
2184,1500000US130970802013,130970802013,"Block Group 3, Census Tract 802.01, Douglas County, Georgia",1873,1715,158,91.564335291,8.43566470902
2185,1500000US130970802021,130970802021,"Block Group 1, Census Tract 802.02, Douglas County, Georgia",846,660,186,78.0141843972,21.9858156028
2186,1500000US130970802022,130970802022,"Block Group 2, Census Tract 802.02, Douglas County, Georgia",2596,1319,1277,50.8089368259,49.1910631741
2187,1500000US130970802023,130970802023,"Block Group 3, Census Tract 802.02, Douglas County, Georgia",3964,2776,1188,70.0302724521,29.9697275479
2188,1500000US130970802024,130970802024,"Block Group 4, Census Tract 802.02, Douglas County, Georgia",2840,1882,958,66.2676056338,33.7323943662
2189,1500000US130970803011,130970803011,"Block Group 1, Census Tract 803.01, Douglas County, Georgia",3349,2436,913,72.7381307853,27.2618692147
2190,1500000US130970803012,130970803012,"Block Group 2, Census Tract 803.01, Douglas County, Georgia",3464,1727,1737,49.8556581986,50.1443418014
2191,1500000US130970803013,130970803013,"Block Group 3, Census Tract 803.01, Douglas County, Georgia",3691,1866,1825,50.5554050393,49.4445949607
2192,1500000US130970803014,130970803014,"Block Group 4, Census Tract 803.01, Douglas County, Georgia",1798,1429,369,79.4771968854,20.5228031146
2193,1500000US130970803031,130970803031,"Block Group 1, Census Tract 803.03, Douglas County, Georgia",2909,1208,1701,41.5262976968,58.4737023032
2194,1500000US130970803032,130970803032,"Block Group 2, Census Tract 803.03, Douglas County, Georgia",950,816,134,85.8947368421,14.1052631579
2195,1500000US130970803041,130970803041,"Block Group 1, Census Tract 803.04, Douglas County, Georgia",1110,439,671,39.5495495495,60.4504504505
2196,1500000US130970803042,130970803042,"Block Group 2, Census Tract 803.04, Douglas County, Georgia",3370,1283,2087,38.0712166172,61.9287833828
2197,1500000US130970804021,130970804021,"Block Group 1, Census Tract 804.02, Douglas County, Georgia",1678,1447,231,86.2336114422,13.7663885578
2198,1500000US130970804022,130970804022,"Block Group 2, Census Tract 804.02, Douglas County, Georgia",3139,3104,35,98.8849952214,1.11500477859
2199,1500000US130970804023,130970804023,"Block Group 3, Census Tract 804.02, Douglas County, Georgia",3313,3051,262,92.0917597344,7.90824026562
2200,1500000US130970804031,130970804031,"Block Group 1, Census Tract 804.03, Douglas County, Georgia",3515,3201,314,91.06685633,8.93314366999
2201,1500000US130970804032,130970804032,"Block Group 2, Census Tract 804.03, Douglas County, Georgia",1375,947,428,68.8727272727,31.1272727273
2202,1500000US130970804041,130970804041,"Block Group 1, Census Tract 804.04, Douglas County, Georgia",2284,1625,659,71.1471103327,28.8528896673
2203,1500000US130970804042,130970804042,"Block Group 2, Census Tract 804.04, Douglas County, Georgia",970,914,56,94.2268041237,5.77319587629
2204,1500000US130970804043,130970804043,"Block Group 3, Census Tract 804.04, Douglas County, Georgia",5345,4268,1077,79.8503274088,20.1496725912
2205,1500000US130970805051,130970805051,"Block Group 1, Census Tract 805.05, Douglas County, Georgia",3285,1846,1439,56.1948249619,43.8051750381
2206,1500000US130970805052,130970805052,"Block Group 2, Census Tract 805.05, Douglas County, Georgia",1568,1270,298,80.9948979592,19.0051020408
2207,1500000US130970805061,130970805061,"Block Group 1, Census Tract 805.06, Douglas County, Georgia",1249,743,506,59.4875900721,40.5124099279
2208,1500000US130970805062,130970805062,"Block Group 2, Census Tract 805.06, Douglas County, Georgia",2091,1625,466,77.7140124342,22.2859875658
2209,1500000US130970805063,130970805063,"Block Group 3, Census Tract 805.06, Douglas County, Georgia",1898,1686,212,88.8303477345,11.1696522655
2210,1500000US130970805071,130970805071,"Block Group 1, Census Tract 805.07, Douglas County, Georgia",2699,1709,990,63.3197480548,36.6802519452
2211,1500000US130970805072,130970805072,"Block Group 2, Census Tract 805.07, Douglas County, Georgia",976,846,130,86.6803278689,13.3196721311
2212,1500000US130970805081,130970805081,"Block Group 1, Census Tract 805.08, Douglas County, Georgia",1607,1017,590,63.2856253889,36.7143746111
2213,1500000US130970805082,130970805082,"Block Group 2, Census Tract 805.08, Douglas County, Georgia",2117,391,1726,18.4695323571,81.5304676429
2214,1500000US130970805083,130970805083,"Block Group 3, Census Tract 805.08, Douglas County, Georgia",1485,953,532,64.1750841751,35.8249158249
2215,1500000US130970805091,130970805091,"Block Group 1, Census Tract 805.09, Douglas County, Georgia",2040,1544,496,75.6862745098,24.3137254902
2216,1500000US130970805092,130970805092,"Block Group 2, Census Tract 805.09, Douglas County, Georgia",2569,2320,249,90.3075126508,9.69248734916
2217,1500000US130970805093,130970805093,"Block Group 3, Census Tract 805.09, Douglas County, Georgia",1141,823,318,72.12971078,27.87028922
2218,1500000US130970805101,130970805101,"Block Group 1, Census Tract 805.10, Douglas County, Georgia",2247,2159,88,96.0836671117,3.9163328883
2219,1500000US130970805102,130970805102,"Block Group 2, Census Tract 805.10, Douglas County, Georgia",3193,2302,891,72.0952082681,27.9047917319
2220,1500000US130970805103,130970805103,"Block Group 3, Census Tract 805.10, Douglas County, Georgia",2265,2133,132,94.1721854305,5.82781456954
2221,1500000US130970805111,130970805111,"Block Group 1, Census Tract 805.11, Douglas County, Georgia",3811,3562,249,93.4662818158,6.5337181842
2222,1500000US130970805112,130970805112,"Block Group 2, Census Tract 805.11, Douglas County, Georgia",5071,4328,743,85.3480575823,14.6519424177
2223,1500000US130970806021,130970806021,"Block Group 1, Census Tract 806.02, Douglas County, Georgia",3339,2825,514,84.6061695118,15.3938304882
2224,1500000US130970806022,130970806022,"Block Group 2, Census Tract 806.02, Douglas County, Georgia",2241,1491,750,66.5327978581,33.4672021419
2225,1500000US130970806031,130970806031,"Block Group 1, Census Tract 806.03, Douglas County, Georgia",3187,2541,646,79.7301537496,20.2698462504
2226,1500000US130970806032,130970806032,"Block Group 2, Census Tract 806.03, Douglas County, Georgia",2794,1828,966,65.42591267,34.57408733
2227,1500000US130970806041,130970806041,"Block Group 1, Census Tract 806.04, Douglas County, Georgia",825,628,197,76.1212121212,23.8787878788
2228,1500000US130970806042,130970806042,"Block Group 2, Census Tract 806.04, Douglas County, Georgia",5482,4946,536,90.2225465159,9.77745348413
2229,1500000US130970806043,130970806043,"Block Group 3, Census Tract 806.04, Douglas County, Georgia",1955,1350,605,69.0537084399,30.9462915601
2230,1500000US130970806044,130970806044,"Block Group 4, Census Tract 806.04, Douglas County, Georgia",1444,1137,307,78.7396121884,21.2603878116
2231,1500000US130990901001,130990901001,"Block Group 1, Census Tract 901, Early County, Georgia",578,412,166,71.2802768166,28.7197231834
2232,1500000US130990901002,130990901002,"Block Group 2, Census Tract 901, Early County, Georgia",802,666,136,83.042394015,16.957605985
2233,1500000US130990902001,130990902001,"Block Group 1, Census Tract 902, Early County, Georgia",629,270,359,42.9252782194,57.0747217806
2234,1500000US130990902002,130990902002,"Block Group 2, Census Tract 902, Early County, Georgia",614,252,362,41.0423452769,58.9576547231
2235,1500000US130990902003,130990902003,"Block Group 3, Census Tract 902, Early County, Georgia",746,555,191,74.3967828418,25.6032171582
2236,1500000US130990902004,130990902004,"Block Group 4, Census Tract 902, Early County, Georgia",421,263,158,62.4703087886,37.5296912114
2237,1500000US130990903001,130990903001,"Block Group 1, Census Tract 903, Early County, Georgia",905,627,278,69.2817679558,30.7182320442
2238,1500000US130990903002,130990903002,"Block Group 2, Census Tract 903, Early County, Georgia",589,516,73,87.6061120543,12.3938879457
2239,1500000US130990904001,130990904001,"Block Group 1, Census Tract 904, Early County, Georgia",1221,625,596,51.1875511876,48.8124488124
2240,1500000US130990904002,130990904002,"Block Group 2, Census Tract 904, Early County, Georgia",1003,741,262,73.8783649053,26.1216350947
2241,1500000US130990904003,130990904003,"Block Group 3, Census Tract 904, Early County, Georgia",1063,601,462,56.5380997178,43.4619002822
2242,1500000US130990905001,130990905001,"Block Group 1, Census Tract 905, Early County, Georgia",702,686,16,97.7207977208,2.2792022792
2243,1500000US130990905002,130990905002,"Block Group 2, Census Tract 905, Early County, Georgia",1147,645,502,56.2336530078,43.7663469922
2244,1500000US131018801001,131018801001,"Block Group 1, Census Tract 8801, Echols County, Georgia",1662,1122,540,67.5090252708,32.4909747292
2245,1500000US131018802001,131018802001,"Block Group 1, Census Tract 8802, Echols County, Georgia",820,400,420,48.7804878049,51.2195121951
2246,1500000US131018802002,131018802002,"Block Group 2, Census Tract 8802, Echols County, Georgia",1566,1113,453,71.0727969349,28.9272030651
2247,1500000US131030301001,131030301001,"Block Group 1, Census Tract 301, Effingham County, Georgia",1927,1436,491,74.5199792423,25.4800207577
2248,1500000US131030301002,131030301002,"Block Group 2, Census Tract 301, Effingham County, Georgia",580,548,32,94.4827586207,5.51724137931
2249,1500000US131030301003,131030301003,"Block Group 3, Census Tract 301, Effingham County, Georgia",907,654,253,72.1058434399,27.8941565601
2250,1500000US131030302021,131030302021,"Block Group 1, Census Tract 302.02, Effingham County, Georgia",1732,1542,190,89.0300230947,10.9699769053
2251,1500000US131030302022,131030302022,"Block Group 2, Census Tract 302.02, Effingham County, Georgia",4024,2961,1063,73.583499006,26.416500994
2252,1500000US131030302031,131030302031,"Block Group 1, Census Tract 302.03, Effingham County, Georgia",792,589,203,74.3686868687,25.6313131313
2253,1500000US131030302032,131030302032,"Block Group 2, Census Tract 302.03, Effingham County, Georgia",4667,3409,1258,73.0447825155,26.9552174845
2254,1500000US131030302033,131030302033,"Block Group 3, Census Tract 302.03, Effingham County, Georgia",2309,1769,540,76.6132524903,23.3867475097
2255,1500000US131030302041,131030302041,"Block Group 1, Census Tract 302.04, Effingham County, Georgia",2014,1138,876,56.504468719,43.495531281
2256,1500000US131030302042,131030302042,"Block Group 2, Census Tract 302.04, Effingham County, Georgia",1933,1571,362,81.2726332126,18.7273667874
2257,1500000US131030303011,131030303011,"Block Group 1, Census Tract 303.01, Effingham County, Georgia",2547,2526,21,99.1755005889,0.824499411072
2258,1500000US131030303012,131030303012,"Block Group 2, Census Tract 303.01, Effingham County, Georgia",2086,1865,221,89.4055608821,10.5944391179
2259,1500000US131030303031,131030303031,"Block Group 1, Census Tract 303.03, Effingham County, Georgia",2333,1743,590,74.7106729533,25.2893270467
2260,1500000US131030303041,131030303041,"Block Group 1, Census Tract 303.04, Effingham County, Georgia",2875,2197,678,76.4173913043,23.5826086957
2261,1500000US131030303042,131030303042,"Block Group 2, Census Tract 303.04, Effingham County, Georgia",2782,2146,636,77.1387491014,22.8612508986
2262,1500000US131030303043,131030303043,"Block Group 3, Census Tract 303.04, Effingham County, Georgia",1694,802,892,47.3435655254,52.6564344746
2263,1500000US131030303051,131030303051,"Block Group 1, Census Tract 303.05, Effingham County, Georgia",2762,1948,814,70.528602462,29.471397538
2264,1500000US131030303052,131030303052,"Block Group 2, Census Tract 303.05, Effingham County, Georgia",5303,3791,1512,71.4878370734,28.5121629266
2265,1500000US131030304011,131030304011,"Block Group 1, Census Tract 304.01, Effingham County, Georgia",2065,1915,150,92.7360774818,7.26392251816
2266,1500000US131030304012,131030304012,"Block Group 2, Census Tract 304.01, Effingham County, Georgia",3017,2522,495,83.5929731521,16.4070268479
2267,1500000US131030304021,131030304021,"Block Group 1, Census Tract 304.02, Effingham County, Georgia",3275,2813,462,85.893129771,14.106870229
2268,1500000US131030304022,131030304022,"Block Group 2, Census Tract 304.02, Effingham County, Georgia",2759,2306,453,83.5810076115,16.4189923885
2269,1500000US131050001001,131050001001,"Block Group 1, Census Tract 1, Elbert County, Georgia",926,741,185,80.0215982721,19.9784017279
2270,1500000US131050001002,131050001002,"Block Group 2, Census Tract 1, Elbert County, Georgia",1199,1029,170,85.8215179316,14.1784820684
2271,1500000US131050001003,131050001003,"Block Group 3, Census Tract 1, Elbert County, Georgia",1387,1017,370,73.3237202596,26.6762797404
2272,1500000US131050002001,131050002001,"Block Group 1, Census Tract 2, Elbert County, Georgia",961,717,244,74.6097814776,25.3902185224
2273,1500000US131050002002,131050002002,"Block Group 2, Census Tract 2, Elbert County, Georgia",898,819,79,91.2026726058,8.79732739421
2274,1500000US131050002003,131050002003,"Block Group 3, Census Tract 2, Elbert County, Georgia",948,567,381,59.8101265823,40.1898734177
2275,1500000US131050003001,131050003001,"Block Group 1, Census Tract 3, Elbert County, Georgia",998,598,400,59.9198396794,40.0801603206
2276,1500000US131050003002,131050003002,"Block Group 2, Census Tract 3, Elbert County, Georgia",1032,528,504,51.1627906977,48.8372093023
2277,1500000US131050003003,131050003003,"Block Group 3, Census Tract 3, Elbert County, Georgia",1660,1257,403,75.7228915663,24.2771084337
2278,1500000US131050004001,131050004001,"Block Group 1, Census Tract 4, Elbert County, Georgia",945,604,341,63.9153439153,36.0846560847
2279,1500000US131050004002,131050004002,"Block Group 2, Census Tract 4, Elbert County, Georgia",877,585,292,66.7046750285,33.2953249715
2280,1500000US131050004003,131050004003,"Block Group 3, Census Tract 4, Elbert County, Georgia",990,480,510,48.4848484848,51.5151515152
2281,1500000US131050004004,131050004004,"Block Group 4, Census Tract 4, Elbert County, Georgia",597,361,236,60.4690117253,39.5309882747
2282,1500000US131050004005,131050004005,"Block Group 5, Census Tract 4, Elbert County, Georgia",682,340,342,49.853372434,50.146627566
2283,1500000US131050005001,131050005001,"Block Group 1, Census Tract 5, Elbert County, Georgia",863,441,422,51.100811124,48.899188876
2284,1500000US131050005002,131050005002,"Block Group 2, Census Tract 5, Elbert County, Georgia",1391,806,585,57.9439252336,42.0560747664
2285,1500000US131050005003,131050005003,"Block Group 3, Census Tract 5, Elbert County, Georgia",791,619,172,78.2553729456,21.7446270544
2286,1500000US131050005004,131050005004,"Block Group 4, Census Tract 5, Elbert County, Georgia",703,703,0,100.0,0.0
2287,1500000US131050005005,131050005005,"Block Group 5, Census Tract 5, Elbert County, Georgia",972,901,71,92.695473251,7.30452674897
2288,1500000US131050005006,131050005006,"Block Group 6, Census Tract 5, Elbert County, Georgia",466,384,82,82.4034334764,17.5965665236
2289,1500000US131079701001,131079701001,"Block Group 1, Census Tract 9701, Emanuel County, Georgia",1919,1470,449,76.6023970818,23.3976029182
2290,1500000US131079701002,131079701002,"Block Group 2, Census Tract 9701, Emanuel County, Georgia",424,349,75,82.3113207547,17.6886792453
2291,1500000US131079701003,131079701003,"Block Group 3, Census Tract 9701, Emanuel County, Georgia",1662,1015,647,61.0709987966,38.9290012034
2292,1500000US131079701004,131079701004,"Block Group 4, Census Tract 9701, Emanuel County, Georgia",1290,752,538,58.2945736434,41.7054263566
2293,1500000US131079702001,131079702001,"Block Group 1, Census Tract 9702, Emanuel County, Georgia",818,666,152,81.4180929095,18.5819070905
2294,1500000US131079702002,131079702002,"Block Group 2, Census Tract 9702, Emanuel County, Georgia",803,595,208,74.097135741,25.902864259
2295,1500000US131079703001,131079703001,"Block Group 1, Census Tract 9703, Emanuel County, Georgia",1315,1082,233,82.2813688213,17.7186311787
2296,1500000US131079703002,131079703002,"Block Group 2, Census Tract 9703, Emanuel County, Georgia",1254,985,269,78.5486443381,21.4513556619
2297,1500000US131079703003,131079703003,"Block Group 3, Census Tract 9703, Emanuel County, Georgia",1333,307,1026,23.0307576894,76.9692423106
2298,1500000US131079704001,131079704001,"Block Group 1, Census Tract 9704, Emanuel County, Georgia",2018,1370,648,67.8889990089,32.1110009911
2299,1500000US131079704002,131079704002,"Block Group 2, Census Tract 9704, Emanuel County, Georgia",1380,1041,339,75.4347826087,24.5652173913
2300,1500000US131079704003,131079704003,"Block Group 3, Census Tract 9704, Emanuel County, Georgia",1162,89,1073,7.65920826162,92.3407917384
2301,1500000US131079705001,131079705001,"Block Group 1, Census Tract 9705, Emanuel County, Georgia",510,380,130,74.5098039216,25.4901960784
2302,1500000US131079705002,131079705002,"Block Group 2, Census Tract 9705, Emanuel County, Georgia",783,750,33,95.785440613,4.21455938697
2303,1500000US131079706001,131079706001,"Block Group 1, Census Tract 9706, Emanuel County, Georgia",1336,967,369,72.380239521,27.619760479
2304,1500000US131079706002,131079706002,"Block Group 2, Census Tract 9706, Emanuel County, Georgia",1452,1155,297,79.5454545455,20.4545454545
2305,1500000US131079706003,131079706003,"Block Group 3, Census Tract 9706, Emanuel County, Georgia",1019,790,229,77.5269872424,22.4730127576
2306,1500000US131079706004,131079706004,"Block Group 4, Census Tract 9706, Emanuel County, Georgia",1394,570,824,40.8895265423,59.1104734577
2307,1500000US131099701001,131099701001,"Block Group 1, Census Tract 9701, Evans County, Georgia",1501,1242,259,82.7448367755,17.2551632245
2308,1500000US131099701002,131099701002,"Block Group 2, Census Tract 9701, Evans County, Georgia",1479,1099,380,74.306964165,25.693035835
2309,1500000US131099702001,131099702001,"Block Group 1, Census Tract 9702, Evans County, Georgia",1047,597,450,57.0200573066,42.9799426934
2310,1500000US131099702002,131099702002,"Block Group 2, Census Tract 9702, Evans County, Georgia",1019,574,445,56.3297350343,43.6702649657
2311,1500000US131099702003,131099702003,"Block Group 3, Census Tract 9702, Evans County, Georgia",978,845,133,86.4008179959,13.5991820041
2312,1500000US131099702004,131099702004,"Block Group 4, Census Tract 9702, Evans County, Georgia",700,579,121,82.7142857143,17.2857142857
2313,1500000US131099703001,131099703001,"Block Group 1, Census Tract 9703, Evans County, Georgia",423,230,193,54.3735224586,45.6264775414
2314,1500000US131099703002,131099703002,"Block Group 2, Census Tract 9703, Evans County, Georgia",1297,411,886,31.6885119507,68.3114880493
2315,1500000US131099703003,131099703003,"Block Group 3, Census Tract 9703, Evans County, Georgia",934,361,573,38.6509635974,61.3490364026
2316,1500000US131099703004,131099703004,"Block Group 4, Census Tract 9703, Evans County, Georgia",985,499,486,50.6598984772,49.3401015228
2317,1500000US131110501001,131110501001,"Block Group 1, Census Tract 501, Fannin County, Georgia",2196,1934,262,88.0692167577,11.9307832423
2318,1500000US131110501002,131110501002,"Block Group 2, Census Tract 501, Fannin County, Georgia",1386,1055,331,76.1183261183,23.8816738817
2319,1500000US131110502001,131110502001,"Block Group 1, Census Tract 502, Fannin County, Georgia",1784,1516,268,84.9775784753,15.0224215247
2320,1500000US131110502002,131110502002,"Block Group 2, Census Tract 502, Fannin County, Georgia",614,267,347,43.4853420195,56.5146579805
2321,1500000US131110502003,131110502003,"Block Group 3, Census Tract 502, Fannin County, Georgia",810,465,345,57.4074074074,42.5925925926
2322,1500000US131110502004,131110502004,"Block Group 4, Census Tract 502, Fannin County, Georgia",1665,1413,252,84.8648648649,15.1351351351
2323,1500000US131110502005,131110502005,"Block Group 5, Census Tract 502, Fannin County, Georgia",1255,890,365,70.9163346614,29.0836653386
2324,1500000US131110503001,131110503001,"Block Group 1, Census Tract 503, Fannin County, Georgia",1574,1157,417,73.5069885642,26.4930114358
2325,1500000US131110503002,131110503002,"Block Group 2, Census Tract 503, Fannin County, Georgia",1188,944,244,79.4612794613,20.5387205387
2326,1500000US131110504001,131110504001,"Block Group 1, Census Tract 504, Fannin County, Georgia",994,805,189,80.985915493,19.014084507
2327,1500000US131110504002,131110504002,"Block Group 2, Census Tract 504, Fannin County, Georgia",1056,1011,45,95.7386363636,4.26136363636
2328,1500000US131110504003,131110504003,"Block Group 3, Census Tract 504, Fannin County, Georgia",1974,1866,108,94.5288753799,5.47112462006
2329,1500000US131110504004,131110504004,"Block Group 4, Census Tract 504, Fannin County, Georgia",1195,550,645,46.0251046025,53.9748953975
2330,1500000US131110504005,131110504005,"Block Group 5, Census Tract 504, Fannin County, Georgia",1758,984,774,55.9726962457,44.0273037543
2331,1500000US131110505001,131110505001,"Block Group 1, Census Tract 505, Fannin County, Georgia",444,444,0,100.0,0.0
2332,1500000US131110505002,131110505002,"Block Group 2, Census Tract 505, Fannin County, Georgia",1752,1106,646,63.1278538813,36.8721461187
2333,1500000US131110505003,131110505003,"Block Group 3, Census Tract 505, Fannin County, Georgia",1357,1313,44,96.7575534267,3.24244657332
2334,1500000US131110505004,131110505004,"Block Group 4, Census Tract 505, Fannin County, Georgia",548,504,44,91.9708029197,8.02919708029
2335,1500000US131131401011,131131401011,"Block Group 1, Census Tract 1401.01, Fayette County, Georgia",1940,1861,79,95.9278350515,4.07216494845
2336,1500000US131131401012,131131401012,"Block Group 2, Census Tract 1401.01, Fayette County, Georgia",1318,1181,137,89.6054628225,10.3945371775
2337,1500000US131131401013,131131401013,"Block Group 3, Census Tract 1401.01, Fayette County, Georgia",3530,3244,286,91.8980169972,8.10198300283
2338,1500000US131131401021,131131401021,"Block Group 1, Census Tract 1401.02, Fayette County, Georgia",1066,1021,45,95.7786116323,4.22138836773
2339,1500000US131131401022,131131401022,"Block Group 2, Census Tract 1401.02, Fayette County, Georgia",2303,2228,75,96.7433782023,3.25662179766
2340,1500000US131131401023,131131401023,"Block Group 3, Census Tract 1401.02, Fayette County, Georgia",2252,1800,452,79.9289520426,20.0710479574
2341,1500000US131131402031,131131402031,"Block Group 1, Census Tract 1402.03, Fayette County, Georgia",3683,3117,566,84.6320934021,15.3679065979
2342,1500000US131131402032,131131402032,"Block Group 2, Census Tract 1402.03, Fayette County, Georgia",2073,1803,270,86.975397974,13.024602026
2343,1500000US131131402041,131131402041,"Block Group 1, Census Tract 1402.04, Fayette County, Georgia",1127,741,386,65.7497781721,34.2502218279
2344,1500000US131131402042,131131402042,"Block Group 2, Census Tract 1402.04, Fayette County, Georgia",2156,1967,189,91.2337662338,8.76623376623
2345,1500000US131131402043,131131402043,"Block Group 3, Census Tract 1402.04, Fayette County, Georgia",2267,1850,417,81.6056462285,18.3943537715
2346,1500000US131131402061,131131402061,"Block Group 1, Census Tract 1402.06, Fayette County, Georgia",2893,2467,426,85.2748012444,14.7251987556
2347,1500000US131131402062,131131402062,"Block Group 2, Census Tract 1402.06, Fayette County, Georgia",1600,1288,312,80.5,19.5
2348,1500000US131131402071,131131402071,"Block Group 1, Census Tract 1402.07, Fayette County, Georgia",1760,1011,749,57.4431818182,42.5568181818
2349,1500000US131131402072,131131402072,"Block Group 2, Census Tract 1402.07, Fayette County, Georgia",930,871,59,93.6559139785,6.34408602151
2350,1500000US131131402073,131131402073,"Block Group 3, Census Tract 1402.07, Fayette County, Georgia",2575,2349,226,91.2233009709,8.77669902913
2351,1500000US131131402081,131131402081,"Block Group 1, Census Tract 1402.08, Fayette County, Georgia",4314,2872,1442,66.5739452944,33.4260547056
2352,1500000US131131402082,131131402082,"Block Group 2, Census Tract 1402.08, Fayette County, Georgia",1195,905,290,75.7322175732,24.2677824268
2353,1500000US131131402083,131131402083,"Block Group 3, Census Tract 1402.08, Fayette County, Georgia",2287,1568,719,68.5614341933,31.4385658067
2354,1500000US131131403031,131131403031,"Block Group 1, Census Tract 1403.03, Fayette County, Georgia",1207,735,472,60.8947804474,39.1052195526
2355,1500000US131131403032,131131403032,"Block Group 2, Census Tract 1403.03, Fayette County, Georgia",2041,1517,524,74.326310632,25.673689368
2356,1500000US131131403033,131131403033,"Block Group 3, Census Tract 1403.03, Fayette County, Georgia",1339,1181,158,88.2001493652,11.7998506348
2357,1500000US131131403041,131131403041,"Block Group 1, Census Tract 1403.04, Fayette County, Georgia",2277,1996,281,87.6592007027,12.3407992973
2358,1500000US131131403042,131131403042,"Block Group 2, Census Tract 1403.04, Fayette County, Georgia",1208,1162,46,96.1920529801,3.80794701987
2359,1500000US131131403043,131131403043,"Block Group 3, Census Tract 1403.04, Fayette County, Georgia",2270,1424,846,62.731277533,37.268722467
2360,1500000US131131403051,131131403051,"Block Group 1, Census Tract 1403.05, Fayette County, Georgia",5319,4634,685,87.1216394059,12.8783605941
2361,1500000US131131403061,131131403061,"Block Group 1, Census Tract 1403.06, Fayette County, Georgia",2753,2004,749,72.7933163821,27.2066836179
2362,1500000US131131403062,131131403062,"Block Group 2, Census Tract 1403.06, Fayette County, Georgia",3023,1321,1702,43.6983129342,56.3016870658
2363,1500000US131131403063,131131403063,"Block Group 3, Census Tract 1403.06, Fayette County, Georgia",1863,1307,556,70.1556629093,29.8443370907
2364,1500000US131131403071,131131403071,"Block Group 1, Census Tract 1403.07, Fayette County, Georgia",3131,2948,183,94.1552219738,5.84477802619
2365,1500000US131131403072,131131403072,"Block Group 2, Census Tract 1403.07, Fayette County, Georgia",1687,1635,52,96.9176052164,3.08239478364
2366,1500000US131131404031,131131404031,"Block Group 1, Census Tract 1404.03, Fayette County, Georgia",895,784,111,87.5977653631,12.4022346369
2367,1500000US131131404032,131131404032,"Block Group 2, Census Tract 1404.03, Fayette County, Georgia",925,735,190,79.4594594595,20.5405405405
2368,1500000US131131404033,131131404033,"Block Group 3, Census Tract 1404.03, Fayette County, Georgia",3548,3269,279,92.1364148816,7.86358511838
2369,1500000US131131404041,131131404041,"Block Group 1, Census Tract 1404.04, Fayette County, Georgia",1675,990,685,59.1044776119,40.8955223881
2370,1500000US131131404042,131131404042,"Block Group 2, Census Tract 1404.04, Fayette County, Georgia",3921,3606,315,91.9663351186,8.03366488141
2371,1500000US131131404051,131131404051,"Block Group 1, Census Tract 1404.05, Fayette County, Georgia",1394,1259,135,90.3156384505,9.6843615495
2372,1500000US131131404052,131131404052,"Block Group 2, Census Tract 1404.05, Fayette County, Georgia",2303,1873,430,81.3287016934,18.6712983066
2373,1500000US131131404061,131131404061,"Block Group 1, Census Tract 1404.06, Fayette County, Georgia",2292,1667,625,72.7312390925,27.2687609075
2374,1500000US131131404062,131131404062,"Block Group 2, Census Tract 1404.06, Fayette County, Georgia",1462,968,494,66.2106703146,33.7893296854
2375,1500000US131131404071,131131404071,"Block Group 1, Census Tract 1404.07, Fayette County, Georgia",1255,1255,0,100.0,0.0
2376,1500000US131131404072,131131404072,"Block Group 2, Census Tract 1404.07, Fayette County, Georgia",3242,1271,1971,39.2041949414,60.7958050586
2377,1500000US131131404073,131131404073,"Block Group 3, Census Tract 1404.07, Fayette County, Georgia",3174,3109,65,97.9521109011,2.04788909893
2378,1500000US131131404081,131131404081,"Block Group 1, Census Tract 1404.08, Fayette County, Georgia",1343,1117,226,83.1720029784,16.8279970216
2379,1500000US131131404082,131131404082,"Block Group 2, Census Tract 1404.08, Fayette County, Georgia",1705,1599,106,93.7829912023,6.21700879765
2380,1500000US131131405011,131131405011,"Block Group 1, Census Tract 1405.01, Fayette County, Georgia",2950,2877,73,97.5254237288,2.47457627119
2381,1500000US131131405012,131131405012,"Block Group 2, Census Tract 1405.01, Fayette County, Georgia",2965,2870,95,96.7959527825,3.20404721754
2382,1500000US131131405021,131131405021,"Block Group 1, Census Tract 1405.02, Fayette County, Georgia",2495,2247,248,90.0601202405,9.93987975952
2383,1500000US131131405022,131131405022,"Block Group 2, Census Tract 1405.02, Fayette County, Georgia",1107,1097,10,99.0966576332,0.903342366757
2384,1500000US131150001001,131150001001,"Block Group 1, Census Tract 1, Floyd County, Georgia",2381,1979,402,83.1163376732,16.8836623268
2385,1500000US131150001002,131150001002,"Block Group 2, Census Tract 1, Floyd County, Georgia",857,611,246,71.2952158693,28.7047841307
2386,1500000US131150001003,131150001003,"Block Group 3, Census Tract 1, Floyd County, Georgia",1306,701,605,53.6753445636,46.3246554364
2387,1500000US131150002011,131150002011,"Block Group 1, Census Tract 2.01, Floyd County, Georgia",1420,687,733,48.3802816901,51.6197183099
2388,1500000US131150002012,131150002012,"Block Group 2, Census Tract 2.01, Floyd County, Georgia",2549,1302,1247,51.0788544527,48.9211455473
2389,1500000US131150002013,131150002013,"Block Group 3, Census Tract 2.01, Floyd County, Georgia",2422,1927,495,79.5623451693,20.4376548307
2390,1500000US131150002021,131150002021,"Block Group 1, Census Tract 2.02, Floyd County, Georgia",2012,1476,536,73.3598409543,26.6401590457
2391,1500000US131150002022,131150002022,"Block Group 2, Census Tract 2.02, Floyd County, Georgia",1888,1505,383,79.7139830508,20.2860169492
2392,1500000US131150003001,131150003001,"Block Group 1, Census Tract 3, Floyd County, Georgia",874,773,101,88.4439359268,11.5560640732
2393,1500000US131150003002,131150003002,"Block Group 2, Census Tract 3, Floyd County, Georgia",388,0,388,0.0,100.0
2394,1500000US131150004001,131150004001,"Block Group 1, Census Tract 4, Floyd County, Georgia",1604,1182,422,73.6907730673,26.3092269327
2395,1500000US131150004002,131150004002,"Block Group 2, Census Tract 4, Floyd County, Georgia",2417,1958,459,81.0095159288,18.9904840712
2396,1500000US131150004003,131150004003,"Block Group 3, Census Tract 4, Floyd County, Georgia",1312,678,634,51.6768292683,48.3231707317
2397,1500000US131150004004,131150004004,"Block Group 4, Census Tract 4, Floyd County, Georgia",2173,1117,1056,51.4035895076,48.5964104924
2398,1500000US131150005001,131150005001,"Block Group 1, Census Tract 5, Floyd County, Georgia",758,465,293,61.345646438,38.654353562
2399,1500000US131150005002,131150005002,"Block Group 2, Census Tract 5, Floyd County, Georgia",1736,644,1092,37.0967741935,62.9032258065
2400,1500000US131150005003,131150005003,"Block Group 3, Census Tract 5, Floyd County, Georgia",1403,668,735,47.612259444,52.387740556
2401,1500000US131150006001,131150006001,"Block Group 1, Census Tract 6, Floyd County, Georgia",1347,312,1035,23.1625835189,76.8374164811
2402,1500000US131150006002,131150006002,"Block Group 2, Census Tract 6, Floyd County, Georgia",1651,677,974,41.0054512417,58.9945487583
2403,1500000US131150006003,131150006003,"Block Group 3, Census Tract 6, Floyd County, Georgia",1473,264,1209,17.9226069246,82.0773930754
2404,1500000US131150007001,131150007001,"Block Group 1, Census Tract 7, Floyd County, Georgia",2111,1540,571,72.9512079583,27.0487920417
2405,1500000US131150007002,131150007002,"Block Group 2, Census Tract 7, Floyd County, Georgia",2626,2054,572,78.2178217822,21.7821782178
2406,1500000US131150008001,131150008001,"Block Group 1, Census Tract 8, Floyd County, Georgia",2358,1984,374,84.139100933,15.860899067
2407,1500000US131150008002,131150008002,"Block Group 2, Census Tract 8, Floyd County, Georgia",2387,1614,773,67.616254713,32.383745287
2408,1500000US131150009001,131150009001,"Block Group 1, Census Tract 9, Floyd County, Georgia",2500,1286,1214,51.44,48.56
2409,1500000US131150011001,131150011001,"Block Group 1, Census Tract 11, Floyd County, Georgia",1289,435,854,33.747090768,66.252909232
2410,1500000US131150011002,131150011002,"Block Group 2, Census Tract 11, Floyd County, Georgia",779,50,729,6.41848523748,93.5815147625
2411,1500000US131150011003,131150011003,"Block Group 3, Census Tract 11, Floyd County, Georgia",507,341,166,67.258382643,32.741617357
2412,1500000US131150012001,131150012001,"Block Group 1, Census Tract 12, Floyd County, Georgia",890,562,328,63.1460674157,36.8539325843
2413,1500000US131150012002,131150012002,"Block Group 2, Census Tract 12, Floyd County, Georgia",1909,1448,461,75.851231011,24.148768989
2414,1500000US131150012003,131150012003,"Block Group 3, Census Tract 12, Floyd County, Georgia",1559,668,891,42.847979474,57.152020526
2415,1500000US131150013001,131150013001,"Block Group 1, Census Tract 13, Floyd County, Georgia",2198,1261,937,57.3703366697,42.6296633303
2416,1500000US131150013002,131150013002,"Block Group 2, Census Tract 13, Floyd County, Georgia",1897,509,1388,26.831839747,73.168160253
2417,1500000US131150013003,131150013003,"Block Group 3, Census Tract 13, Floyd County, Georgia",1965,998,967,50.7888040712,49.2111959288
2418,1500000US131150014001,131150014001,"Block Group 1, Census Tract 14, Floyd County, Georgia",1927,1561,366,81.0067462377,18.9932537623
2419,1500000US131150014002,131150014002,"Block Group 2, Census Tract 14, Floyd County, Georgia",2858,2706,152,94.6815955213,5.31840447866
2420,1500000US131150014003,131150014003,"Block Group 3, Census Tract 14, Floyd County, Georgia",1871,1871,0,100.0,0.0
2421,1500000US131150016001,131150016001,"Block Group 1, Census Tract 16, Floyd County, Georgia",1217,310,907,25.472473295,74.527526705
2422,1500000US131150016002,131150016002,"Block Group 2, Census Tract 16, Floyd County, Georgia",936,121,815,12.9273504274,87.0726495726
2423,1500000US131150016003,131150016003,"Block Group 3, Census Tract 16, Floyd County, Georgia",1314,311,1003,23.6681887367,76.3318112633
2424,1500000US131150017011,131150017011,"Block Group 1, Census Tract 17.01, Floyd County, Georgia",2559,2275,284,88.9019148105,11.0980851895
2425,1500000US131150017012,131150017012,"Block Group 2, Census Tract 17.01, Floyd County, Georgia",2457,1802,655,73.3414733415,26.6585266585
2426,1500000US131150017013,131150017013,"Block Group 3, Census Tract 17.01, Floyd County, Georgia",1331,1078,253,80.9917355372,19.0082644628
2427,1500000US131150017021,131150017021,"Block Group 1, Census Tract 17.02, Floyd County, Georgia",1571,1296,275,82.4952259707,17.5047740293
2428,1500000US131150017022,131150017022,"Block Group 2, Census Tract 17.02, Floyd County, Georgia",2440,1907,533,78.1557377049,21.8442622951
2429,1500000US131150017023,131150017023,"Block Group 3, Census Tract 17.02, Floyd County, Georgia",1265,217,1048,17.1541501976,82.8458498024
2430,1500000US131150017024,131150017024,"Block Group 4, Census Tract 17.02, Floyd County, Georgia",1023,338,685,33.0400782014,66.9599217986
2431,1500000US131150018001,131150018001,"Block Group 1, Census Tract 18, Floyd County, Georgia",1708,1155,553,67.6229508197,32.3770491803
2432,1500000US131150018002,131150018002,"Block Group 2, Census Tract 18, Floyd County, Georgia",685,305,380,44.5255474453,55.4744525547
2433,1500000US131150018003,131150018003,"Block Group 3, Census Tract 18, Floyd County, Georgia",2115,1414,701,66.8557919622,33.1442080378
2434,1500000US131150020001,131150020001,"Block Group 1, Census Tract 20, Floyd County, Georgia",1743,1277,466,73.2644865175,26.7355134825
2435,1500000US131150020002,131150020002,"Block Group 2, Census Tract 20, Floyd County, Georgia",1277,1012,265,79.2482380579,20.7517619421
2436,1500000US131150020003,131150020003,"Block Group 3, Census Tract 20, Floyd County, Georgia",1003,837,166,83.4496510469,16.5503489531
2437,1500000US131150021001,131150021001,"Block Group 1, Census Tract 21, Floyd County, Georgia",1597,1022,575,63.9949906074,36.0050093926
2438,1500000US131150021002,131150021002,"Block Group 2, Census Tract 21, Floyd County, Georgia",1199,424,775,35.3628023353,64.6371976647
2439,1500000US131150021003,131150021003,"Block Group 3, Census Tract 21, Floyd County, Georgia",1095,210,885,19.1780821918,80.8219178082
2440,1500000US131171301011,131171301011,"Block Group 1, Census Tract 1301.01, Forsyth County, Georgia",2704,2203,501,81.4718934911,18.5281065089
2441,1500000US131171301012,131171301012,"Block Group 2, Census Tract 1301.01, Forsyth County, Georgia",1393,1131,262,81.191672649,18.808327351
2442,1500000US131171301021,131171301021,"Block Group 1, Census Tract 1301.02, Forsyth County, Georgia",2728,2420,308,88.7096774194,11.2903225806
2443,1500000US131171301031,131171301031,"Block Group 1, Census Tract 1301.03, Forsyth County, Georgia",1439,1087,352,75.5385684503,24.4614315497
2444,1500000US131171301032,131171301032,"Block Group 2, Census Tract 1301.03, Forsyth County, Georgia",1218,1135,83,93.1855500821,6.8144499179
2445,1500000US131171301033,131171301033,"Block Group 3, Census Tract 1301.03, Forsyth County, Georgia",918,725,193,78.9760348584,21.0239651416
2446,1500000US131171301041,131171301041,"Block Group 1, Census Tract 1301.04, Forsyth County, Georgia",1543,1370,173,88.7880751782,11.2119248218
2447,1500000US131171301042,131171301042,"Block Group 2, Census Tract 1301.04, Forsyth County, Georgia",1512,1100,412,72.7513227513,27.2486772487
2448,1500000US131171301043,131171301043,"Block Group 3, Census Tract 1301.04, Forsyth County, Georgia",915,717,198,78.3606557377,21.6393442623
2449,1500000US131171301051,131171301051,"Block Group 1, Census Tract 1301.05, Forsyth County, Georgia",2571,1107,1464,43.057176196,56.942823804
2450,1500000US131171302011,131171302011,"Block Group 1, Census Tract 1302.01, Forsyth County, Georgia",1602,1420,182,88.6392009988,11.3607990012
2451,1500000US131171302012,131171302012,"Block Group 2, Census Tract 1302.01, Forsyth County, Georgia",1642,1613,29,98.2338611449,1.76613885505
2452,1500000US131171302013,131171302013,"Block Group 3, Census Tract 1302.01, Forsyth County, Georgia",1565,1335,230,85.303514377,14.696485623
2453,1500000US131171302021,131171302021,"Block Group 1, Census Tract 1302.02, Forsyth County, Georgia",1380,1308,72,94.7826086957,5.21739130435
2454,1500000US131171302022,131171302022,"Block Group 2, Census Tract 1302.02, Forsyth County, Georgia",673,663,10,98.514115899,1.48588410104
2455,1500000US131171302023,131171302023,"Block Group 3, Census Tract 1302.02, Forsyth County, Georgia",1794,1721,73,95.9308807135,4.06911928651
2456,1500000US131171302031,131171302031,"Block Group 1, Census Tract 1302.03, Forsyth County, Georgia",2835,1966,869,69.3474426808,30.6525573192
2457,1500000US131171302032,131171302032,"Block Group 2, Census Tract 1302.03, Forsyth County, Georgia",2657,2146,511,80.7677832142,19.2322167858
2458,1500000US131171302041,131171302041,"Block Group 1, Census Tract 1302.04, Forsyth County, Georgia",2293,1747,546,76.1883994767,23.8116005233
2459,1500000US131171302042,131171302042,"Block Group 2, Census Tract 1302.04, Forsyth County, Georgia",1988,1741,247,87.5754527163,12.4245472837
2460,1500000US131171302051,131171302051,"Block Group 1, Census Tract 1302.05, Forsyth County, Georgia",1467,979,488,66.7348329925,33.2651670075
2461,1500000US131171302052,131171302052,"Block Group 2, Census Tract 1302.05, Forsyth County, Georgia",509,269,240,52.8487229862,47.1512770138
2462,1500000US131171302053,131171302053,"Block Group 3, Census Tract 1302.05, Forsyth County, Georgia",556,358,198,64.3884892086,35.6115107914
2463,1500000US131171303011,131171303011,"Block Group 1, Census Tract 1303.01, Forsyth County, Georgia",1993,1763,230,88.4596086302,11.5403913698
2464,1500000US131171303012,131171303012,"Block Group 2, Census Tract 1303.01, Forsyth County, Georgia",3721,3127,594,84.0365493147,15.9634506853
2465,1500000US131171303021,131171303021,"Block Group 1, Census Tract 1303.02, Forsyth County, Georgia",1101,995,106,90.3723887375,9.62761126249
2466,1500000US131171303022,131171303022,"Block Group 2, Census Tract 1303.02, Forsyth County, Georgia",2179,2030,149,93.1620009179,6.83799908215
2467,1500000US131171303023,131171303023,"Block Group 3, Census Tract 1303.02, Forsyth County, Georgia",2270,2115,155,93.1718061674,6.8281938326
2468,1500000US131171303031,131171303031,"Block Group 1, Census Tract 1303.03, Forsyth County, Georgia",2773,2349,424,84.7097006852,15.2902993148
2469,1500000US131171303032,131171303032,"Block Group 2, Census Tract 1303.03, Forsyth County, Georgia",1413,1403,10,99.2922859165,0.70771408351
2470,1500000US131171303041,131171303041,"Block Group 1, Census Tract 1303.04, Forsyth County, Georgia",1864,1694,170,90.8798283262,9.12017167382
2471,1500000US131171303042,131171303042,"Block Group 2, Census Tract 1303.04, Forsyth County, Georgia",2657,2153,504,81.0312382386,18.9687617614
2472,1500000US131171303051,131171303051,"Block Group 1, Census Tract 1303.05, Forsyth County, Georgia",905,876,29,96.7955801105,3.2044198895
2473,1500000US131171303052,131171303052,"Block Group 2, Census Tract 1303.05, Forsyth County, Georgia",3095,2513,582,81.1954765751,18.8045234249
2474,1500000US131171303053,131171303053,"Block Group 3, Census Tract 1303.05, Forsyth County, Georgia",1679,1632,47,97.2007147111,2.79928528886
2475,1500000US131171303061,131171303061,"Block Group 1, Census Tract 1303.06, Forsyth County, Georgia",2798,2719,79,97.1765546819,2.82344531808
2476,1500000US131171303062,131171303062,"Block Group 2, Census Tract 1303.06, Forsyth County, Georgia",1812,1672,140,92.2737306843,7.72626931567
2477,1500000US131171303071,131171303071,"Block Group 1, Census Tract 1303.07, Forsyth County, Georgia",2509,2286,223,91.1119968115,8.88800318852
2478,1500000US131171303072,131171303072,"Block Group 2, Census Tract 1303.07, Forsyth County, Georgia",1762,1675,87,95.0624290579,4.93757094211
2479,1500000US131171304031,131171304031,"Block Group 1, Census Tract 1304.03, Forsyth County, Georgia",783,444,339,56.7049808429,43.2950191571
2480,1500000US131171304032,131171304032,"Block Group 2, Census Tract 1304.03, Forsyth County, Georgia",1488,1281,207,86.0887096774,13.9112903226
2481,1500000US131171304033,131171304033,"Block Group 3, Census Tract 1304.03, Forsyth County, Georgia",1136,822,314,72.3591549296,27.6408450704
2482,1500000US131171304034,131171304034,"Block Group 4, Census Tract 1304.03, Forsyth County, Georgia",2302,2302,0,100.0,0.0
2483,1500000US131171304041,131171304041,"Block Group 1, Census Tract 1304.04, Forsyth County, Georgia",2074,1873,201,90.3085824494,9.69141755063
2484,1500000US131171304042,131171304042,"Block Group 2, Census Tract 1304.04, Forsyth County, Georgia",2565,2270,295,88.4990253411,11.5009746589
2485,1500000US131171304051,131171304051,"Block Group 1, Census Tract 1304.05, Forsyth County, Georgia",2153,1844,309,85.6479331166,14.3520668834
2486,1500000US131171304052,131171304052,"Block Group 2, Census Tract 1304.05, Forsyth County, Georgia",1854,1562,292,84.2502696872,15.7497303128
2487,1500000US131171304061,131171304061,"Block Group 1, Census Tract 1304.06, Forsyth County, Georgia",2165,1416,749,65.4041570439,34.5958429561
2488,1500000US131171304062,131171304062,"Block Group 2, Census Tract 1304.06, Forsyth County, Georgia",2105,1610,495,76.4845605701,23.5154394299
2489,1500000US131171304063,131171304063,"Block Group 3, Census Tract 1304.06, Forsyth County, Georgia",1242,880,362,70.8534621578,29.1465378422
2490,1500000US131171304081,131171304081,"Block Group 1, Census Tract 1304.08, Forsyth County, Georgia",2352,1467,885,62.3724489796,37.6275510204
2491,1500000US131171304082,131171304082,"Block Group 2, Census Tract 1304.08, Forsyth County, Georgia",1262,780,482,61.8066561014,38.1933438986
2492,1500000US131171304091,131171304091,"Block Group 1, Census Tract 1304.09, Forsyth County, Georgia",645,350,295,54.2635658915,45.7364341085
2493,1500000US131171304092,131171304092,"Block Group 2, Census Tract 1304.09, Forsyth County, Georgia",1810,1305,505,72.0994475138,27.9005524862
2494,1500000US131171304101,131171304101,"Block Group 1, Census Tract 1304.10, Forsyth County, Georgia",725,564,161,77.7931034483,22.2068965517
2495,1500000US131171304102,131171304102,"Block Group 2, Census Tract 1304.10, Forsyth County, Georgia",1481,105,1376,7.08980418636,92.9101958136
2496,1500000US131171304103,131171304103,"Block Group 3, Census Tract 1304.10, Forsyth County, Georgia",1664,1238,426,74.3990384615,25.6009615385
2497,1500000US131171305031,131171305031,"Block Group 1, Census Tract 1305.03, Forsyth County, Georgia",1604,1324,280,82.5436408978,17.4563591022
2498,1500000US131171305032,131171305032,"Block Group 2, Census Tract 1305.03, Forsyth County, Georgia",1113,924,189,83.0188679245,16.9811320755
2499,1500000US131171305041,131171305041,"Block Group 1, Census Tract 1305.04, Forsyth County, Georgia",1985,1302,683,65.5919395466,34.4080604534
2500,1500000US131171305042,131171305042,"Block Group 2, Census Tract 1305.04, Forsyth County, Georgia",1755,1364,391,77.7207977208,22.2792022792
2501,1500000US131171305051,131171305051,"Block Group 1, Census Tract 1305.05, Forsyth County, Georgia",1169,997,172,85.2865697177,14.7134302823
2502,1500000US131171305052,131171305052,"Block Group 2, Census Tract 1305.05, Forsyth County, Georgia",1469,1438,31,97.8897208986,2.11027910143
2503,1500000US131171305061,131171305061,"Block Group 1, Census Tract 1305.06, Forsyth County, Georgia",1092,985,107,90.2014652015,9.79853479853
2504,1500000US131171305062,131171305062,"Block Group 2, Census Tract 1305.06, Forsyth County, Georgia",2380,1822,558,76.5546218487,23.4453781513
2505,1500000US131171305071,131171305071,"Block Group 1, Census Tract 1305.07, Forsyth County, Georgia",873,720,153,82.4742268041,17.5257731959
2506,1500000US131171305072,131171305072,"Block Group 2, Census Tract 1305.07, Forsyth County, Georgia",1442,1357,85,94.105409154,5.89459084605
2507,1500000US131171305081,131171305081,"Block Group 1, Census Tract 1305.08, Forsyth County, Georgia",2543,2432,111,95.6350766811,4.36492331891
2508,1500000US131171305082,131171305082,"Block Group 2, Census Tract 1305.08, Forsyth County, Georgia",2687,2575,112,95.8317826572,4.16821734276
2509,1500000US131171305091,131171305091,"Block Group 1, Census Tract 1305.09, Forsyth County, Georgia",1944,1790,154,92.0781893004,7.92181069959
2510,1500000US131171305092,131171305092,"Block Group 2, Census Tract 1305.09, Forsyth County, Georgia",1442,1273,169,88.2801664355,11.7198335645
2511,1500000US131171305101,131171305101,"Block Group 1, Census Tract 1305.10, Forsyth County, Georgia",2029,1922,107,94.7264662395,5.27353376047
2512,1500000US131171305102,131171305102,"Block Group 2, Census Tract 1305.10, Forsyth County, Georgia",2332,1492,840,63.9794168096,36.0205831904
2513,1500000US131171305103,131171305103,"Block Group 3, Census Tract 1305.10, Forsyth County, Georgia",2131,1767,364,82.9188174566,17.0811825434
2514,1500000US131171306011,131171306011,"Block Group 1, Census Tract 1306.01, Forsyth County, Georgia",2605,1484,1121,56.9673704415,43.0326295585
2515,1500000US131171306012,131171306012,"Block Group 2, Census Tract 1306.01, Forsyth County, Georgia",762,475,287,62.3359580052,37.6640419948
2516,1500000US131171306013,131171306013,"Block Group 3, Census Tract 1306.01, Forsyth County, Georgia",1379,1233,146,89.412617839,10.587382161
2517,1500000US131171306021,131171306021,"Block Group 1, Census Tract 1306.02, Forsyth County, Georgia",2721,1460,1261,53.6567438442,46.3432561558
2518,1500000US131171306022,131171306022,"Block Group 2, Census Tract 1306.02, Forsyth County, Georgia",2761,2417,344,87.5407461065,12.4592538935
2519,1500000US131171306031,131171306031,"Block Group 1, Census Tract 1306.03, Forsyth County, Georgia",2890,2652,238,91.7647058824,8.23529411765
2520,1500000US131171306032,131171306032,"Block Group 2, Census Tract 1306.03, Forsyth County, Georgia",1312,987,325,75.2286585366,24.7713414634
2521,1500000US131171306033,131171306033,"Block Group 3, Census Tract 1306.03, Forsyth County, Georgia",782,625,157,79.9232736573,20.0767263427
2522,1500000US131171306041,131171306041,"Block Group 1, Census Tract 1306.04, Forsyth County, Georgia",2572,2188,384,85.0699844479,14.9300155521
2523,1500000US131171306042,131171306042,"Block Group 2, Census Tract 1306.04, Forsyth County, Georgia",981,981,0,100.0,0.0
2524,1500000US131171306043,131171306043,"Block Group 3, Census Tract 1306.04, Forsyth County, Georgia",1584,1550,34,97.8535353535,2.14646464646
2525,1500000US131171306051,131171306051,"Block Group 1, Census Tract 1306.05, Forsyth County, Georgia",1326,1058,268,79.7888386124,20.2111613876
2526,1500000US131171306052,131171306052,"Block Group 2, Census Tract 1306.05, Forsyth County, Georgia",2601,2415,186,92.8489042676,7.15109573241
2527,1500000US131171306061,131171306061,"Block Group 1, Census Tract 1306.06, Forsyth County, Georgia",1790,1674,116,93.5195530726,6.48044692737
2528,1500000US131171306062,131171306062,"Block Group 2, Census Tract 1306.06, Forsyth County, Georgia",2701,2141,560,79.266938171,20.733061829
2529,1500000US131171306071,131171306071,"Block Group 1, Census Tract 1306.07, Forsyth County, Georgia",2210,1919,291,86.8325791855,13.1674208145
2530,1500000US131171306072,131171306072,"Block Group 2, Census Tract 1306.07, Forsyth County, Georgia",662,546,116,82.4773413897,17.5226586103
2531,1500000US131171306073,131171306073,"Block Group 3, Census Tract 1306.07, Forsyth County, Georgia",2694,2658,36,98.6636971047,1.33630289532
2532,1500000US131171306081,131171306081,"Block Group 1, Census Tract 1306.08, Forsyth County, Georgia",2885,2536,349,87.9029462738,12.0970537262
2533,1500000US131171306082,131171306082,"Block Group 2, Census Tract 1306.08, Forsyth County, Georgia",1881,1728,153,91.8660287081,8.13397129187
2534,1500000US131171306083,131171306083,"Block Group 3, Census Tract 1306.08, Forsyth County, Georgia",813,775,38,95.3259532595,4.67404674047
2535,1500000US131171306091,131171306091,"Block Group 1, Census Tract 1306.09, Forsyth County, Georgia",2954,2760,194,93.432633717,6.56736628301
2536,1500000US131171306092,131171306092,"Block Group 2, Census Tract 1306.09, Forsyth County, Georgia",1170,1141,29,97.5213675214,2.47863247863
2537,1500000US131171306093,131171306093,"Block Group 3, Census Tract 1306.09, Forsyth County, Georgia",1274,1171,103,91.9152276295,8.08477237049
2538,1500000US131171306101,131171306101,"Block Group 1, Census Tract 1306.10, Forsyth County, Georgia",1417,1417,0,100.0,0.0
2539,1500000US131171306102,131171306102,"Block Group 2, Census Tract 1306.10, Forsyth County, Georgia",1801,1634,167,90.7273736813,9.27262631871
2540,1500000US131171306103,131171306103,"Block Group 3, Census Tract 1306.10, Forsyth County, Georgia",1167,1167,0,100.0,0.0
2541,1500000US131171306111,131171306111,"Block Group 1, Census Tract 1306.11, Forsyth County, Georgia",1334,1295,39,97.0764617691,2.92353823088
2542,1500000US131171306112,131171306112,"Block Group 2, Census Tract 1306.11, Forsyth County, Georgia",2667,2544,123,95.3880764904,4.61192350956
2543,1500000US131171306121,131171306121,"Block Group 1, Census Tract 1306.12, Forsyth County, Georgia",2065,1991,74,96.416464891,3.58353510896
2544,1500000US131171306122,131171306122,"Block Group 2, Census Tract 1306.12, Forsyth County, Georgia",845,652,193,77.1597633136,22.8402366864
2545,1500000US131171306123,131171306123,"Block Group 3, Census Tract 1306.12, Forsyth County, Georgia",3666,3666,0,100.0,0.0
2546,1500000US131171306131,131171306131,"Block Group 1, Census Tract 1306.13, Forsyth County, Georgia",1442,868,574,60.1941747573,39.8058252427
2547,1500000US131171306132,131171306132,"Block Group 2, Census Tract 1306.13, Forsyth County, Georgia",1645,1551,94,94.2857142857,5.71428571429
2548,1500000US131198901011,131198901011,"Block Group 1, Census Tract 8901.01, Franklin County, Georgia",899,499,400,55.5061179088,44.4938820912
2549,1500000US131198901012,131198901012,"Block Group 2, Census Tract 8901.01, Franklin County, Georgia",1141,534,607,46.801051709,53.198948291
2550,1500000US131198901013,131198901013,"Block Group 3, Census Tract 8901.01, Franklin County, Georgia",1807,1014,793,56.1151079137,43.8848920863
2551,1500000US131198901021,131198901021,"Block Group 1, Census Tract 8901.02, Franklin County, Georgia",1152,948,204,82.2916666667,17.7083333333
2552,1500000US131198901022,131198901022,"Block Group 2, Census Tract 8901.02, Franklin County, Georgia",1172,683,489,58.2764505119,41.7235494881
2553,1500000US131198901023,131198901023,"Block Group 3, Census Tract 8901.02, Franklin County, Georgia",1738,1274,464,73.3026467204,26.6973532796
2554,1500000US131198902001,131198902001,"Block Group 1, Census Tract 8902, Franklin County, Georgia",1758,1413,345,80.3754266212,19.6245733788
2555,1500000US131198902002,131198902002,"Block Group 2, Census Tract 8902, Franklin County, Georgia",1567,1403,164,89.534141672,10.465858328
2556,1500000US131198902003,131198902003,"Block Group 3, Census Tract 8902, Franklin County, Georgia",1272,975,297,76.6509433962,23.3490566038
2557,1500000US131198902004,131198902004,"Block Group 4, Census Tract 8902, Franklin County, Georgia",1060,1045,15,98.5849056604,1.41509433962
2558,1500000US131198903001,131198903001,"Block Group 1, Census Tract 8903, Franklin County, Georgia",1706,1137,569,66.6471277843,33.3528722157
2559,1500000US131198903002,131198903002,"Block Group 2, Census Tract 8903, Franklin County, Georgia",1473,1137,336,77.1894093686,22.8105906314
2560,1500000US131198904001,131198904001,"Block Group 1, Census Tract 8904, Franklin County, Georgia",1035,649,386,62.7053140097,37.2946859903
2561,1500000US131198904002,131198904002,"Block Group 2, Census Tract 8904, Franklin County, Georgia",1003,723,280,72.0837487537,27.9162512463
2562,1500000US131198904003,131198904003,"Block Group 3, Census Tract 8904, Franklin County, Georgia",594,429,165,72.2222222222,27.7777777778
2563,1500000US131198904004,131198904004,"Block Group 4, Census Tract 8904, Franklin County, Georgia",2066,981,1085,47.4830590513,52.5169409487
2564,1500000US131210001001,131210001001,"Block Group 1, Census Tract 1, Fulton County, Georgia",1051,861,190,81.9219790676,18.0780209324
2565,1500000US131210001002,131210001002,"Block Group 2, Census Tract 1, Fulton County, Georgia",637,547,90,85.8712715856,14.1287284144
2566,1500000US131210001003,131210001003,"Block Group 3, Census Tract 1, Fulton County, Georgia",1795,1601,194,89.1922005571,10.8077994429
2567,1500000US131210001004,131210001004,"Block Group 4, Census Tract 1, Fulton County, Georgia",1150,1001,149,87.0434782609,12.9565217391
2568,1500000US131210002001,131210002001,"Block Group 1, Census Tract 2, Fulton County, Georgia",1475,745,730,50.5084745763,49.4915254237
2569,1500000US131210002002,131210002002,"Block Group 2, Census Tract 2, Fulton County, Georgia",1473,1205,268,81.805838425,18.194161575
2570,1500000US131210002003,131210002003,"Block Group 3, Census Tract 2, Fulton County, Georgia",1016,786,230,77.3622047244,22.6377952756
2571,1500000US131210002004,131210002004,"Block Group 4, Census Tract 2, Fulton County, Georgia",934,812,122,86.9379014989,13.0620985011
2572,1500000US131210002005,131210002005,"Block Group 5, Census Tract 2, Fulton County, Georgia",1267,1167,100,92.1073401736,7.89265982636
2573,1500000US131210004001,131210004001,"Block Group 1, Census Tract 4, Fulton County, Georgia",427,323,104,75.644028103,24.355971897
2574,1500000US131210004002,131210004002,"Block Group 2, Census Tract 4, Fulton County, Georgia",1000,618,382,61.8,38.2
2575,1500000US131210005001,131210005001,"Block Group 1, Census Tract 5, Fulton County, Georgia",3138,1170,1968,37.2848948375,62.7151051625
2576,1500000US131210005002,131210005002,"Block Group 2, Census Tract 5, Fulton County, Georgia",1060,976,84,92.0754716981,7.92452830189
2577,1500000US131210005003,131210005003,"Block Group 3, Census Tract 5, Fulton County, Georgia",905,749,156,82.7624309392,17.2375690608
2578,1500000US131210006001,131210006001,"Block Group 1, Census Tract 6, Fulton County, Georgia",4617,673,3944,14.576564869,85.423435131
2579,1500000US131210007001,131210007001,"Block Group 1, Census Tract 7, Fulton County, Georgia",0,0,0,,
2580,1500000US131210007002,131210007002,"Block Group 2, Census Tract 7, Fulton County, Georgia",753,430,323,57.1049136786,42.8950863214
2581,1500000US131210010011,131210010011,"Block Group 1, Census Tract 10.01, Fulton County, Georgia",367,98,269,26.7029972752,73.2970027248
2582,1500000US131210010012,131210010012,"Block Group 2, Census Tract 10.01, Fulton County, Georgia",946,559,387,59.0909090909,40.9090909091
2583,1500000US131210010021,131210010021,"Block Group 1, Census Tract 10.02, Fulton County, Georgia",860,4,856,0.46511627907,99.5348837209
2584,1500000US131210011001,131210011001,"Block Group 1, Census Tract 11, Fulton County, Georgia",1021,604,417,59.1576885406,40.8423114594
2585,1500000US131210011002,131210011002,"Block Group 2, Census Tract 11, Fulton County, Georgia",918,551,367,60.0217864924,39.9782135076
2586,1500000US131210011003,131210011003,"Block Group 3, Census Tract 11, Fulton County, Georgia",2306,636,1670,27.5802254987,72.4197745013
2587,1500000US131210012011,131210012011,"Block Group 1, Census Tract 12.01, Fulton County, Georgia",1780,884,896,49.6629213483,50.3370786517
2588,1500000US131210012012,131210012012,"Block Group 2, Census Tract 12.01, Fulton County, Georgia",2123,722,1401,34.0084785681,65.9915214319
2589,1500000US131210012021,131210012021,"Block Group 1, Census Tract 12.02, Fulton County, Georgia",2456,1654,802,67.345276873,32.654723127
2590,1500000US131210012022,131210012022,"Block Group 2, Census Tract 12.02, Fulton County, Georgia",1442,96,1346,6.65742024965,93.3425797503
2591,1500000US131210013001,131210013001,"Block Group 1, Census Tract 13, Fulton County, Georgia",2219,1002,1217,45.1554754394,54.8445245606
2592,1500000US131210013002,131210013002,"Block Group 2, Census Tract 13, Fulton County, Georgia",1062,512,550,48.2109227872,51.7890772128
2593,1500000US131210013003,131210013003,"Block Group 3, Census Tract 13, Fulton County, Georgia",869,256,613,29.4591484465,70.5408515535
2594,1500000US131210014001,131210014001,"Block Group 1, Census Tract 14, Fulton County, Georgia",1411,559,852,39.6172927002,60.3827072998
2595,1500000US131210014002,131210014002,"Block Group 2, Census Tract 14, Fulton County, Georgia",826,490,336,59.3220338983,40.6779661017
2596,1500000US131210015001,131210015001,"Block Group 1, Census Tract 15, Fulton County, Georgia",1384,166,1218,11.9942196532,88.0057803468
2597,1500000US131210015002,131210015002,"Block Group 2, Census Tract 15, Fulton County, Georgia",1308,840,468,64.2201834862,35.7798165138
2598,1500000US131210015003,131210015003,"Block Group 3, Census Tract 15, Fulton County, Georgia",774,197,577,25.4521963824,74.5478036176
2599,1500000US131210015004,131210015004,"Block Group 4, Census Tract 15, Fulton County, Georgia",849,306,543,36.0424028269,63.9575971731
2600,1500000US131210016001,131210016001,"Block Group 1, Census Tract 16, Fulton County, Georgia",2090,556,1534,26.6028708134,73.3971291866
2601,1500000US131210017001,131210017001,"Block Group 1, Census Tract 17, Fulton County, Georgia",2620,679,1941,25.9160305344,74.0839694656
2602,1500000US131210017002,131210017002,"Block Group 2, Census Tract 17, Fulton County, Georgia",1111,254,857,22.8622862286,77.1377137714
2603,1500000US131210018001,131210018001,"Block Group 1, Census Tract 18, Fulton County, Georgia",2684,941,1743,35.0596125186,64.9403874814
2604,1500000US131210018002,131210018002,"Block Group 2, Census Tract 18, Fulton County, Georgia",763,34,729,4.45609436435,95.5439056356
2605,1500000US131210018003,131210018003,"Block Group 3, Census Tract 18, Fulton County, Georgia",1082,280,802,25.8780036969,74.1219963031
2606,1500000US131210019001,131210019001,"Block Group 1, Census Tract 19, Fulton County, Georgia",297,0,297,0.0,100.0
2607,1500000US131210019002,131210019002,"Block Group 2, Census Tract 19, Fulton County, Georgia",1574,586,988,37.2299872935,62.7700127065
2608,1500000US131210021001,131210021001,"Block Group 1, Census Tract 21, Fulton County, Georgia",2098,630,1468,30.0285986654,69.9714013346
2609,1500000US131210023001,131210023001,"Block Group 1, Census Tract 23, Fulton County, Georgia",335,32,303,9.55223880597,90.447761194
2610,1500000US131210023002,131210023002,"Block Group 2, Census Tract 23, Fulton County, Georgia",462,125,337,27.0562770563,72.9437229437
2611,1500000US131210023003,131210023003,"Block Group 3, Census Tract 23, Fulton County, Georgia",447,85,362,19.0156599553,80.9843400447
2612,1500000US131210024001,131210024001,"Block Group 1, Census Tract 24, Fulton County, Georgia",1432,565,867,39.4553072626,60.5446927374
2613,1500000US131210024002,131210024002,"Block Group 2, Census Tract 24, Fulton County, Georgia",935,424,511,45.3475935829,54.6524064171
2614,1500000US131210025001,131210025001,"Block Group 1, Census Tract 25, Fulton County, Georgia",1541,156,1385,10.1232965607,89.8767034393
2615,1500000US131210025002,131210025002,"Block Group 2, Census Tract 25, Fulton County, Georgia",559,196,363,35.0626118068,64.9373881932
2616,1500000US131210026001,131210026001,"Block Group 1, Census Tract 26, Fulton County, Georgia",1205,90,1115,7.46887966805,92.531120332
2617,1500000US131210028001,131210028001,"Block Group 1, Census Tract 28, Fulton County, Georgia",1428,169,1259,11.8347338936,88.1652661064
2618,1500000US131210028002,131210028002,"Block Group 2, Census Tract 28, Fulton County, Georgia",475,11,464,2.31578947368,97.6842105263
2619,1500000US131210029001,131210029001,"Block Group 1, Census Tract 29, Fulton County, Georgia",2330,670,1660,28.7553648069,71.2446351931
2620,1500000US131210030001,131210030001,"Block Group 1, Census Tract 30, Fulton County, Georgia",1472,562,910,38.1793478261,61.8206521739
2621,1500000US131210030002,131210030002,"Block Group 2, Census Tract 30, Fulton County, Georgia",1605,1155,450,71.9626168224,28.0373831776
2622,1500000US131210031001,131210031001,"Block Group 1, Census Tract 31, Fulton County, Georgia",971,609,362,62.7188465499,37.2811534501
2623,1500000US131210031002,131210031002,"Block Group 2, Census Tract 31, Fulton County, Georgia",916,294,622,32.096069869,67.903930131
2624,1500000US131210032001,131210032001,"Block Group 1, Census Tract 32, Fulton County, Georgia",2138,1162,976,54.3498596819,45.6501403181
2625,1500000US131210035001,131210035001,"Block Group 1, Census Tract 35, Fulton County, Georgia",467,12,455,2.56959314775,97.4304068522
2626,1500000US131210035002,131210035002,"Block Group 2, Census Tract 35, Fulton County, Georgia",439,332,107,75.6264236902,24.3735763098
2627,1500000US131210036001,131210036001,"Block Group 1, Census Tract 36, Fulton County, Georgia",1294,314,980,24.2658423493,75.7341576507
2628,1500000US131210037001,131210037001,"Block Group 1, Census Tract 37, Fulton County, Georgia",54,0,54,0.0,100.0
2629,1500000US131210038001,131210038001,"Block Group 1, Census Tract 38, Fulton County, Georgia",359,62,297,17.2701949861,82.7298050139
2630,1500000US131210039001,131210039001,"Block Group 1, Census Tract 39, Fulton County, Georgia",1172,527,645,44.9658703072,55.0341296928
2631,1500000US131210039002,131210039002,"Block Group 2, Census Tract 39, Fulton County, Georgia",768,85,683,11.0677083333,88.9322916667
2632,1500000US131210040001,131210040001,"Block Group 1, Census Tract 40, Fulton County, Georgia",1148,592,556,51.5679442509,48.4320557491
2633,1500000US131210040002,131210040002,"Block Group 2, Census Tract 40, Fulton County, Georgia",635,282,353,44.4094488189,55.5905511811
2634,1500000US131210040003,131210040003,"Block Group 3, Census Tract 40, Fulton County, Georgia",625,357,268,57.12,42.88
2635,1500000US131210041001,131210041001,"Block Group 1, Census Tract 41, Fulton County, Georgia",486,54,432,11.1111111111,88.8888888889
2636,1500000US131210041002,131210041002,"Block Group 2, Census Tract 41, Fulton County, Georgia",904,99,805,10.9513274336,89.0486725664
2637,1500000US131210041003,131210041003,"Block Group 3, Census Tract 41, Fulton County, Georgia",499,243,256,48.6973947896,51.3026052104
2638,1500000US131210042001,131210042001,"Block Group 1, Census Tract 42, Fulton County, Georgia",414,0,414,0.0,100.0
2639,1500000US131210042002,131210042002,"Block Group 2, Census Tract 42, Fulton County, Georgia",1797,522,1275,29.0484140234,70.9515859766
2640,1500000US131210043001,131210043001,"Block Group 1, Census Tract 43, Fulton County, Georgia",0,0,0,,
2641,1500000US131210043002,131210043002,"Block Group 2, Census Tract 43, Fulton County, Georgia",1133,155,978,13.680494263,86.319505737
2642,1500000US131210044001,131210044001,"Block Group 1, Census Tract 44, Fulton County, Georgia",2509,101,2408,4.02550817059,95.9744918294
2643,1500000US131210048001,131210048001,"Block Group 1, Census Tract 48, Fulton County, Georgia",1048,72,976,6.87022900763,93.1297709924
2644,1500000US131210049001,131210049001,"Block Group 1, Census Tract 49, Fulton County, Georgia",1494,525,969,35.140562249,64.859437751
2645,1500000US131210049002,131210049002,"Block Group 2, Census Tract 49, Fulton County, Georgia",1397,1108,289,79.3128131711,20.6871868289
2646,1500000US131210050001,131210050001,"Block Group 1, Census Tract 50, Fulton County, Georgia",1933,1164,769,60.2172788412,39.7827211588
2647,1500000US131210052001,131210052001,"Block Group 1, Census Tract 52, Fulton County, Georgia",748,599,149,80.0802139037,19.9197860963
2648,1500000US131210052002,131210052002,"Block Group 2, Census Tract 52, Fulton County, Georgia",1262,663,599,52.5356576862,47.4643423138
2649,1500000US131210052003,131210052003,"Block Group 3, Census Tract 52, Fulton County, Georgia",2970,1855,1115,62.4579124579,37.5420875421
2650,1500000US131210053001,131210053001,"Block Group 1, Census Tract 53, Fulton County, Georgia",1709,742,967,43.4172030427,56.5827969573
2651,1500000US131210053002,131210053002,"Block Group 2, Census Tract 53, Fulton County, Georgia",1279,935,344,73.1039874902,26.8960125098
2652,1500000US131210053003,131210053003,"Block Group 3, Census Tract 53, Fulton County, Georgia",688,611,77,88.8081395349,11.1918604651
2653,1500000US131210055011,131210055011,"Block Group 1, Census Tract 55.01, Fulton County, Georgia",1050,425,625,40.4761904762,59.5238095238
2654,1500000US131210055012,131210055012,"Block Group 2, Census Tract 55.01, Fulton County, Georgia",1483,399,1084,26.9049224545,73.0950775455
2655,1500000US131210055021,131210055021,"Block Group 1, Census Tract 55.02, Fulton County, Georgia",2422,399,2023,16.4739884393,83.5260115607
2656,1500000US131210057001,131210057001,"Block Group 1, Census Tract 57, Fulton County, Georgia",1655,195,1460,11.7824773414,88.2175226586
2657,1500000US131210058001,131210058001,"Block Group 1, Census Tract 58, Fulton County, Georgia",2023,625,1398,30.8947108255,69.1052891745
2658,1500000US131210060001,131210060001,"Block Group 1, Census Tract 60, Fulton County, Georgia",600,129,471,21.5,78.5
2659,1500000US131210060002,131210060002,"Block Group 2, Census Tract 60, Fulton County, Georgia",1121,517,604,46.1195361285,53.8804638715
2660,1500000US131210060003,131210060003,"Block Group 3, Census Tract 60, Fulton County, Georgia",785,220,565,28.025477707,71.974522293
2661,1500000US131210060004,131210060004,"Block Group 4, Census Tract 60, Fulton County, Georgia",730,236,494,32.3287671233,67.6712328767
2662,1500000US131210061001,131210061001,"Block Group 1, Census Tract 61, Fulton County, Georgia",580,265,315,45.6896551724,54.3103448276
2663,1500000US131210061002,131210061002,"Block Group 2, Census Tract 61, Fulton County, Georgia",1295,714,581,55.1351351351,44.8648648649
2664,1500000US131210061003,131210061003,"Block Group 3, Census Tract 61, Fulton County, Georgia",730,539,191,73.8356164384,26.1643835616
2665,1500000US131210061004,131210061004,"Block Group 4, Census Tract 61, Fulton County, Georgia",1067,491,576,46.0168697282,53.9831302718
2666,1500000US131210062001,131210062001,"Block Group 1, Census Tract 62, Fulton County, Georgia",943,413,530,43.7963944857,56.2036055143
2667,1500000US131210062002,131210062002,"Block Group 2, Census Tract 62, Fulton County, Georgia",532,199,333,37.4060150376,62.5939849624
2668,1500000US131210063001,131210063001,"Block Group 1, Census Tract 63, Fulton County, Georgia",1079,427,652,39.5736793327,60.4263206673
2669,1500000US131210063002,131210063002,"Block Group 2, Census Tract 63, Fulton County, Georgia",571,120,451,21.0157618214,78.9842381786
2670,1500000US131210064001,131210064001,"Block Group 1, Census Tract 64, Fulton County, Georgia",1156,367,789,31.7474048443,68.2525951557
2671,1500000US131210065001,131210065001,"Block Group 1, Census Tract 65, Fulton County, Georgia",683,557,126,81.5519765739,18.4480234261
2672,1500000US131210065002,131210065002,"Block Group 2, Census Tract 65, Fulton County, Georgia",1683,1135,548,67.4390968509,32.5609031491
2673,1500000US131210065003,131210065003,"Block Group 3, Census Tract 65, Fulton County, Georgia",605,496,109,81.9834710744,18.0165289256
2674,1500000US131210065004,131210065004,"Block Group 4, Census Tract 65, Fulton County, Georgia",1303,442,861,33.9217191097,66.0782808903
2675,1500000US131210066011,131210066011,"Block Group 1, Census Tract 66.01, Fulton County, Georgia",848,450,398,53.0660377358,46.9339622642
2676,1500000US131210066012,131210066012,"Block Group 2, Census Tract 66.01, Fulton County, Georgia",1364,606,758,44.4281524927,55.5718475073
2677,1500000US131210066021,131210066021,"Block Group 1, Census Tract 66.02, Fulton County, Georgia",1363,278,1085,20.3961848863,79.6038151137
2678,1500000US131210067001,131210067001,"Block Group 1, Census Tract 67, Fulton County, Georgia",833,255,578,30.612244898,69.387755102
2679,1500000US131210067002,131210067002,"Block Group 2, Census Tract 67, Fulton County, Georgia",1560,493,1067,31.6025641026,68.3974358974
2680,1500000US131210067003,131210067003,"Block Group 3, Census Tract 67, Fulton County, Georgia",1340,733,607,54.7014925373,45.2985074627
2681,1500000US131210068011,131210068011,"Block Group 1, Census Tract 68.01, Fulton County, Georgia",0,0,0,,
2682,1500000US131210068021,131210068021,"Block Group 1, Census Tract 68.02, Fulton County, Georgia",1992,150,1842,7.53012048193,92.4698795181
2683,1500000US131210069001,131210069001,"Block Group 1, Census Tract 69, Fulton County, Georgia",974,315,659,32.340862423,67.659137577
2684,1500000US131210069002,131210069002,"Block Group 2, Census Tract 69, Fulton County, Georgia",1335,426,909,31.9101123596,68.0898876404
2685,1500000US131210069003,131210069003,"Block Group 3, Census Tract 69, Fulton County, Georgia",1242,812,430,65.3784219002,34.6215780998
2686,1500000US131210070011,131210070011,"Block Group 1, Census Tract 70.01, Fulton County, Georgia",2382,558,1824,23.4256926952,76.5743073048
2687,1500000US131210070012,131210070012,"Block Group 2, Census Tract 70.01, Fulton County, Georgia",1168,619,549,52.9965753425,47.0034246575
2688,1500000US131210070013,131210070013,"Block Group 3, Census Tract 70.01, Fulton County, Georgia",1190,738,452,62.0168067227,37.9831932773
2689,1500000US131210070021,131210070021,"Block Group 1, Census Tract 70.02, Fulton County, Georgia",860,267,593,31.0465116279,68.9534883721
2690,1500000US131210070022,131210070022,"Block Group 2, Census Tract 70.02, Fulton County, Georgia",429,102,327,23.7762237762,76.2237762238
2691,1500000US131210070023,131210070023,"Block Group 3, Census Tract 70.02, Fulton County, Georgia",297,153,144,51.5151515152,48.4848484848
2692,1500000US131210070024,131210070024,"Block Group 4, Census Tract 70.02, Fulton County, Georgia",302,0,302,0.0,100.0
2693,1500000US131210071001,131210071001,"Block Group 1, Census Tract 71, Fulton County, Georgia",858,368,490,42.8904428904,57.1095571096
2694,1500000US131210071002,131210071002,"Block Group 2, Census Tract 71, Fulton County, Georgia",1151,482,669,41.8766290182,58.1233709818
2695,1500000US131210072001,131210072001,"Block Group 1, Census Tract 72, Fulton County, Georgia",1682,597,1085,35.4934601665,64.5065398335
2696,1500000US131210072002,131210072002,"Block Group 2, Census Tract 72, Fulton County, Georgia",342,166,176,48.5380116959,51.4619883041
2697,1500000US131210073001,131210073001,"Block Group 1, Census Tract 73, Fulton County, Georgia",2638,956,1682,36.2395754359,63.7604245641
2698,1500000US131210073002,131210073002,"Block Group 2, Census Tract 73, Fulton County, Georgia",3397,683,2714,20.1059758611,79.8940241389
2699,1500000US131210073003,131210073003,"Block Group 3, Census Tract 73, Fulton County, Georgia",1909,175,1734,9.16710319539,90.8328968046
2700,1500000US131210074001,131210074001,"Block Group 1, Census Tract 74, Fulton County, Georgia",1406,352,1054,25.0355618777,74.9644381223
2701,1500000US131210074002,131210074002,"Block Group 2, Census Tract 74, Fulton County, Georgia",1260,157,1103,12.4603174603,87.5396825397
2702,1500000US131210075001,131210075001,"Block Group 1, Census Tract 75, Fulton County, Georgia",902,217,685,24.0576496674,75.9423503326
2703,1500000US131210075002,131210075002,"Block Group 2, Census Tract 75, Fulton County, Georgia",511,154,357,30.1369863014,69.8630136986
2704,1500000US131210075003,131210075003,"Block Group 3, Census Tract 75, Fulton County, Georgia",800,285,515,35.625,64.375
2705,1500000US131210075004,131210075004,"Block Group 4, Census Tract 75, Fulton County, Georgia",815,180,635,22.0858895706,77.9141104294
2706,1500000US131210076021,131210076021,"Block Group 1, Census Tract 76.02, Fulton County, Georgia",595,202,393,33.9495798319,66.0504201681
2707,1500000US131210076022,131210076022,"Block Group 2, Census Tract 76.02, Fulton County, Georgia",903,351,552,38.8704318937,61.1295681063
2708,1500000US131210076023,131210076023,"Block Group 3, Census Tract 76.02, Fulton County, Georgia",1055,390,665,36.9668246445,63.0331753555
2709,1500000US131210076031,131210076031,"Block Group 1, Census Tract 76.03, Fulton County, Georgia",1553,82,1471,5.2801030264,94.7198969736
2710,1500000US131210076032,131210076032,"Block Group 2, Census Tract 76.03, Fulton County, Georgia",1630,14,1616,0.858895705521,99.1411042945
2711,1500000US131210076033,131210076033,"Block Group 3, Census Tract 76.03, Fulton County, Georgia",1289,106,1183,8.22342901474,91.7765709853
2712,1500000US131210076041,131210076041,"Block Group 1, Census Tract 76.04, Fulton County, Georgia",2331,400,1931,17.16001716,82.83998284
2713,1500000US131210077031,131210077031,"Block Group 1, Census Tract 77.03, Fulton County, Georgia",1071,817,254,76.2838468721,23.7161531279
2714,1500000US131210077032,131210077032,"Block Group 2, Census Tract 77.03, Fulton County, Georgia",1740,799,941,45.9195402299,54.0804597701
2715,1500000US131210077033,131210077033,"Block Group 3, Census Tract 77.03, Fulton County, Georgia",1341,937,404,69.8732289336,30.1267710664
2716,1500000US131210077041,131210077041,"Block Group 1, Census Tract 77.04, Fulton County, Georgia",817,234,583,28.641370869,71.358629131
2717,1500000US131210077042,131210077042,"Block Group 2, Census Tract 77.04, Fulton County, Georgia",2156,663,1493,30.7513914657,69.2486085343
2718,1500000US131210077043,131210077043,"Block Group 3, Census Tract 77.04, Fulton County, Georgia",2344,1488,856,63.4812286689,36.5187713311
2719,1500000US131210077051,131210077051,"Block Group 1, Census Tract 77.05, Fulton County, Georgia",2517,451,2066,17.9181565356,82.0818434644
2720,1500000US131210077052,131210077052,"Block Group 2, Census Tract 77.05, Fulton County, Georgia",2504,772,1732,30.8306709265,69.1693290735
2721,1500000US131210077061,131210077061,"Block Group 1, Census Tract 77.06, Fulton County, Georgia",2820,503,2317,17.8368794326,82.1631205674
2722,1500000US131210077062,131210077062,"Block Group 2, Census Tract 77.06, Fulton County, Georgia",2248,432,1816,19.2170818505,80.7829181495
2723,1500000US131210077063,131210077063,"Block Group 3, Census Tract 77.06, Fulton County, Georgia",4422,1452,2970,32.8358208955,67.1641791045
2724,1500000US131210078021,131210078021,"Block Group 1, Census Tract 78.02, Fulton County, Georgia",4140,1558,2582,37.6328502415,62.3671497585
2725,1500000US131210078022,131210078022,"Block Group 2, Census Tract 78.02, Fulton County, Georgia",2852,2054,798,72.0196353436,27.9803646564
2726,1500000US131210078023,131210078023,"Block Group 3, Census Tract 78.02, Fulton County, Georgia",1207,1148,59,95.1118475559,4.88815244408
2727,1500000US131210078024,131210078024,"Block Group 4, Census Tract 78.02, Fulton County, Georgia",1815,1470,345,80.9917355372,19.0082644628
2728,1500000US131210078051,131210078051,"Block Group 1, Census Tract 78.05, Fulton County, Georgia",1220,423,797,34.6721311475,65.3278688525
2729,1500000US131210078052,131210078052,"Block Group 2, Census Tract 78.05, Fulton County, Georgia",1763,820,943,46.511627907,53.488372093
2730,1500000US131210078061,131210078061,"Block Group 1, Census Tract 78.06, Fulton County, Georgia",1676,1118,558,66.7064439141,33.2935560859
2731,1500000US131210078062,131210078062,"Block Group 2, Census Tract 78.06, Fulton County, Georgia",3863,962,2901,24.9029251877,75.0970748123
2732,1500000US131210078063,131210078063,"Block Group 3, Census Tract 78.06, Fulton County, Georgia",1055,976,79,92.5118483412,7.48815165877
2733,1500000US131210078071,131210078071,"Block Group 1, Census Tract 78.07, Fulton County, Georgia",2537,353,2184,13.9140717383,86.0859282617
2734,1500000US131210078072,131210078072,"Block Group 2, Census Tract 78.07, Fulton County, Georgia",666,423,243,63.5135135135,36.4864864865
2735,1500000US131210078081,131210078081,"Block Group 1, Census Tract 78.08, Fulton County, Georgia",1900,347,1553,18.2631578947,81.7368421053
2736,1500000US131210078082,131210078082,"Block Group 2, Census Tract 78.08, Fulton County, Georgia",2587,12,2575,0.46385775029,99.5361422497
2737,1500000US131210079001,131210079001,"Block Group 1, Census Tract 79, Fulton County, Georgia",1819,1604,215,88.1803188565,11.8196811435
2738,1500000US131210079002,131210079002,"Block Group 2, Census Tract 79, Fulton County, Georgia",1231,915,316,74.32981316,25.67018684
2739,1500000US131210079003,131210079003,"Block Group 3, Census Tract 79, Fulton County, Georgia",2673,1689,984,63.1874298541,36.8125701459
2740,1500000US131210080001,131210080001,"Block Group 1, Census Tract 80, Fulton County, Georgia",1064,566,498,53.1954887218,46.8045112782
2741,1500000US131210080002,131210080002,"Block Group 2, Census Tract 80, Fulton County, Georgia",1205,837,368,69.4605809129,30.5394190871
2742,1500000US131210080003,131210080003,"Block Group 3, Census Tract 80, Fulton County, Georgia",496,189,307,38.1048387097,61.8951612903
2743,1500000US131210080004,131210080004,"Block Group 4, Census Tract 80, Fulton County, Georgia",1255,628,627,50.0398406375,49.9601593625
2744,1500000US131210080005,131210080005,"Block Group 5, Census Tract 80, Fulton County, Georgia",1399,758,641,54.1815582559,45.8184417441
2745,1500000US131210081011,131210081011,"Block Group 1, Census Tract 81.01, Fulton County, Georgia",1138,805,333,70.7381370826,29.2618629174
2746,1500000US131210081021,131210081021,"Block Group 1, Census Tract 81.02, Fulton County, Georgia",1278,665,613,52.034428795,47.965571205
2747,1500000US131210081022,131210081022,"Block Group 2, Census Tract 81.02, Fulton County, Georgia",940,394,546,41.914893617,58.085106383
2748,1500000US131210081023,131210081023,"Block Group 3, Census Tract 81.02, Fulton County, Georgia",2160,254,1906,11.7592592593,88.2407407407
2749,1500000US131210081024,131210081024,"Block Group 4, Census Tract 81.02, Fulton County, Georgia",2653,685,1968,25.8198266114,74.1801733886
2750,1500000US131210082011,131210082011,"Block Group 1, Census Tract 82.01, Fulton County, Georgia",1951,1417,534,72.6294208098,27.3705791902
2751,1500000US131210082012,131210082012,"Block Group 2, Census Tract 82.01, Fulton County, Georgia",3083,1108,1975,35.9390204346,64.0609795654
2752,1500000US131210082013,131210082013,"Block Group 3, Census Tract 82.01, Fulton County, Georgia",960,326,634,33.9583333333,66.0416666667
2753,1500000US131210082021,131210082021,"Block Group 1, Census Tract 82.02, Fulton County, Georgia",948,431,517,45.4641350211,54.5358649789
2754,1500000US131210082022,131210082022,"Block Group 2, Census Tract 82.02, Fulton County, Georgia",836,245,591,29.3062200957,70.6937799043
2755,1500000US131210082023,131210082023,"Block Group 3, Census Tract 82.02, Fulton County, Georgia",257,31,226,12.0622568093,87.9377431907
2756,1500000US131210082024,131210082024,"Block Group 4, Census Tract 82.02, Fulton County, Georgia",0,0,0,,
2757,1500000US131210083011,131210083011,"Block Group 1, Census Tract 83.01, Fulton County, Georgia",1601,317,1284,19.8001249219,80.1998750781
2758,1500000US131210083012,131210083012,"Block Group 2, Census Tract 83.01, Fulton County, Georgia",604,489,115,80.9602649007,19.0397350993
2759,1500000US131210083021,131210083021,"Block Group 1, Census Tract 83.02, Fulton County, Georgia",793,233,560,29.3820933165,70.6179066835
2760,1500000US131210083022,131210083022,"Block Group 2, Census Tract 83.02, Fulton County, Georgia",961,611,350,63.5796045786,36.4203954214
2761,1500000US131210084001,131210084001,"Block Group 1, Census Tract 84, Fulton County, Georgia",1472,412,1060,27.9891304348,72.0108695652
2762,1500000US131210084002,131210084002,"Block Group 2, Census Tract 84, Fulton County, Georgia",883,237,646,26.8403171008,73.1596828992
2763,1500000US131210084003,131210084003,"Block Group 3, Census Tract 84, Fulton County, Georgia",599,195,404,32.5542570952,67.4457429048
2764,1500000US131210085001,131210085001,"Block Group 1, Census Tract 85, Fulton County, Georgia",548,205,343,37.4087591241,62.5912408759
2765,1500000US131210085002,131210085002,"Block Group 2, Census Tract 85, Fulton County, Georgia",1248,561,687,44.9519230769,55.0480769231
2766,1500000US131210085003,131210085003,"Block Group 3, Census Tract 85, Fulton County, Georgia",1222,628,594,51.3911620295,48.6088379705
2767,1500000US131210086011,131210086011,"Block Group 1, Census Tract 86.01, Fulton County, Georgia",1648,33,1615,2.00242718447,97.9975728155
2768,1500000US131210086012,131210086012,"Block Group 2, Census Tract 86.01, Fulton County, Georgia",891,288,603,32.3232323232,67.6767676768
2769,1500000US131210086013,131210086013,"Block Group 3, Census Tract 86.01, Fulton County, Georgia",1409,834,575,59.1909155429,40.8090844571
2770,1500000US131210086014,131210086014,"Block Group 4, Census Tract 86.01, Fulton County, Georgia",348,133,215,38.2183908046,61.7816091954
2771,1500000US131210086021,131210086021,"Block Group 1, Census Tract 86.02, Fulton County, Georgia",803,302,501,37.6089663761,62.3910336239
2772,1500000US131210086022,131210086022,"Block Group 2, Census Tract 86.02, Fulton County, Georgia",260,96,164,36.9230769231,63.0769230769
2773,1500000US131210087001,131210087001,"Block Group 1, Census Tract 87, Fulton County, Georgia",1009,248,761,24.5787908821,75.4212091179
2774,1500000US131210087002,131210087002,"Block Group 2, Census Tract 87, Fulton County, Georgia",818,154,664,18.826405868,81.173594132
2775,1500000US131210087003,131210087003,"Block Group 3, Census Tract 87, Fulton County, Georgia",969,281,688,28.9989680083,71.0010319917
2776,1500000US131210087004,131210087004,"Block Group 4, Census Tract 87, Fulton County, Georgia",1562,389,1173,24.9039692702,75.0960307298
2777,1500000US131210088001,131210088001,"Block Group 1, Census Tract 88, Fulton County, Georgia",2944,2284,660,77.5815217391,22.4184782609
2778,1500000US131210088002,131210088002,"Block Group 2, Census Tract 88, Fulton County, Georgia",1625,1099,526,67.6307692308,32.3692307692
2779,1500000US131210089021,131210089021,"Block Group 1, Census Tract 89.02, Fulton County, Georgia",1876,698,1178,37.2068230277,62.7931769723
2780,1500000US131210089022,131210089022,"Block Group 2, Census Tract 89.02, Fulton County, Georgia",659,261,398,39.6054628225,60.3945371775
2781,1500000US131210089023,131210089023,"Block Group 3, Census Tract 89.02, Fulton County, Georgia",1269,331,938,26.0835303388,73.9164696612
2782,1500000US131210089024,131210089024,"Block Group 4, Census Tract 89.02, Fulton County, Georgia",2722,1089,1633,40.0073475386,59.9926524614
2783,1500000US131210089031,131210089031,"Block Group 1, Census Tract 89.03, Fulton County, Georgia",1684,808,876,47.9809976247,52.0190023753
2784,1500000US131210089041,131210089041,"Block Group 1, Census Tract 89.04, Fulton County, Georgia",1323,870,453,65.7596371882,34.2403628118
2785,1500000US131210089042,131210089042,"Block Group 2, Census Tract 89.04, Fulton County, Georgia",1638,524,1114,31.9902319902,68.0097680098
2786,1500000US131210089043,131210089043,"Block Group 3, Census Tract 89.04, Fulton County, Georgia",1611,1404,207,87.1508379888,12.8491620112
2787,1500000US131210090001,131210090001,"Block Group 1, Census Tract 90, Fulton County, Georgia",1350,1200,150,88.8888888889,11.1111111111
2788,1500000US131210090002,131210090002,"Block Group 2, Census Tract 90, Fulton County, Georgia",1769,1716,53,97.0039570379,2.99604296213
2789,1500000US131210090003,131210090003,"Block Group 3, Census Tract 90, Fulton County, Georgia",1829,704,1125,38.4909786769,61.5090213231
2790,1500000US131210091011,131210091011,"Block Group 1, Census Tract 91.01, Fulton County, Georgia",1369,628,741,45.872899927,54.127100073
2791,1500000US131210091012,131210091012,"Block Group 2, Census Tract 91.01, Fulton County, Georgia",1565,619,946,39.552715655,60.447284345
2792,1500000US131210091013,131210091013,"Block Group 3, Census Tract 91.01, Fulton County, Georgia",627,47,580,7.49601275917,92.5039872408
2793,1500000US131210091014,131210091014,"Block Group 4, Census Tract 91.01, Fulton County, Georgia",1001,438,563,43.7562437562,56.2437562438
2794,1500000US131210091021,131210091021,"Block Group 1, Census Tract 91.02, Fulton County, Georgia",443,443,0,100.0,0.0
2795,1500000US131210091022,131210091022,"Block Group 2, Census Tract 91.02, Fulton County, Georgia",825,386,439,46.7878787879,53.2121212121
2796,1500000US131210091023,131210091023,"Block Group 3, Census Tract 91.02, Fulton County, Georgia",1840,574,1266,31.1956521739,68.8043478261
2797,1500000US131210092001,131210092001,"Block Group 1, Census Tract 92, Fulton County, Georgia",2404,700,1704,29.1181364393,70.8818635607
2798,1500000US131210092002,131210092002,"Block Group 2, Census Tract 92, Fulton County, Georgia",2976,358,2618,12.0295698925,87.9704301075
2799,1500000US131210092003,131210092003,"Block Group 3, Census Tract 92, Fulton County, Georgia",1703,539,1164,31.65002936,68.34997064
2800,1500000US131210093001,131210093001,"Block Group 1, Census Tract 93, Fulton County, Georgia",1079,779,300,72.1964782206,27.8035217794
2801,1500000US131210093002,131210093002,"Block Group 2, Census Tract 93, Fulton County, Georgia",1319,383,936,29.0371493556,70.9628506444
2802,1500000US131210093003,131210093003,"Block Group 3, Census Tract 93, Fulton County, Georgia",1510,1234,276,81.7218543046,18.2781456954
2803,1500000US131210093004,131210093004,"Block Group 4, Census Tract 93, Fulton County, Georgia",750,740,10,98.6666666667,1.33333333333
2804,1500000US131210094021,131210094021,"Block Group 1, Census Tract 94.02, Fulton County, Georgia",2795,44,2751,1.57423971377,98.4257602862
2805,1500000US131210094022,131210094022,"Block Group 2, Census Tract 94.02, Fulton County, Georgia",2227,358,1869,16.0754378087,83.9245621913
2806,1500000US131210094031,131210094031,"Block Group 1, Census Tract 94.03, Fulton County, Georgia",2448,505,1943,20.6290849673,79.3709150327
2807,1500000US131210094032,131210094032,"Block Group 2, Census Tract 94.03, Fulton County, Georgia",1245,182,1063,14.6184738956,85.3815261044
2808,1500000US131210094033,131210094033,"Block Group 3, Census Tract 94.03, Fulton County, Georgia",1279,73,1206,5.70758405004,94.29241595
2809,1500000US131210094041,131210094041,"Block Group 1, Census Tract 94.04, Fulton County, Georgia",2515,1889,626,75.1093439364,24.8906560636
2810,1500000US131210094042,131210094042,"Block Group 2, Census Tract 94.04, Fulton County, Georgia",1995,754,1241,37.7944862155,62.2055137845
2811,1500000US131210094043,131210094043,"Block Group 3, Census Tract 94.04, Fulton County, Georgia",311,166,145,53.3762057878,46.6237942122
2812,1500000US131210095011,131210095011,"Block Group 1, Census Tract 95.01, Fulton County, Georgia",470,259,211,55.1063829787,44.8936170213
2813,1500000US131210095012,131210095012,"Block Group 2, Census Tract 95.01, Fulton County, Georgia",1736,1440,296,82.9493087558,17.0506912442
2814,1500000US131210095013,131210095013,"Block Group 3, Census Tract 95.01, Fulton County, Georgia",1588,1525,63,96.0327455919,3.96725440806
2815,1500000US131210095021,131210095021,"Block Group 1, Census Tract 95.02, Fulton County, Georgia",490,445,45,90.8163265306,9.18367346939
2816,1500000US131210095022,131210095022,"Block Group 2, Census Tract 95.02, Fulton County, Georgia",297,164,133,55.2188552189,44.7811447811
2817,1500000US131210095023,131210095023,"Block Group 3, Census Tract 95.02, Fulton County, Georgia",960,592,368,61.6666666667,38.3333333333
2818,1500000US131210095024,131210095024,"Block Group 4, Census Tract 95.02, Fulton County, Georgia",1100,359,741,32.6363636364,67.3636363636
2819,1500000US131210096011,131210096011,"Block Group 1, Census Tract 96.01, Fulton County, Georgia",1003,503,500,50.149551346,49.850448654
2820,1500000US131210096012,131210096012,"Block Group 2, Census Tract 96.01, Fulton County, Georgia",1414,404,1010,28.5714285714,71.4285714286
2821,1500000US131210096021,131210096021,"Block Group 1, Census Tract 96.02, Fulton County, Georgia",1234,478,756,38.7358184765,61.2641815235
2822,1500000US131210096022,131210096022,"Block Group 2, Census Tract 96.02, Fulton County, Georgia",2131,925,1206,43.4068512435,56.5931487565
2823,1500000US131210096023,131210096023,"Block Group 3, Census Tract 96.02, Fulton County, Georgia",1245,1202,43,96.546184739,3.45381526104
2824,1500000US131210096031,131210096031,"Block Group 1, Census Tract 96.03, Fulton County, Georgia",1086,396,690,36.4640883978,63.5359116022
2825,1500000US131210096032,131210096032,"Block Group 2, Census Tract 96.03, Fulton County, Georgia",1374,844,530,61.4264919942,38.5735080058
2826,1500000US131210096033,131210096033,"Block Group 3, Census Tract 96.03, Fulton County, Georgia",1734,758,976,43.7139561707,56.2860438293
2827,1500000US131210097001,131210097001,"Block Group 1, Census Tract 97, Fulton County, Georgia",995,902,93,90.6532663317,9.34673366834
2828,1500000US131210097002,131210097002,"Block Group 2, Census Tract 97, Fulton County, Georgia",1032,941,91,91.1821705426,8.81782945736
2829,1500000US131210097003,131210097003,"Block Group 3, Census Tract 97, Fulton County, Georgia",1896,1716,180,90.5063291139,9.49367088608
2830,1500000US131210098011,131210098011,"Block Group 1, Census Tract 98.01, Fulton County, Georgia",1737,1152,585,66.3212435233,33.6787564767
2831,1500000US131210098012,131210098012,"Block Group 2, Census Tract 98.01, Fulton County, Georgia",1692,1641,51,96.9858156028,3.01418439716
2832,1500000US131210098013,131210098013,"Block Group 3, Census Tract 98.01, Fulton County, Georgia",1375,1375,0,100.0,0.0
2833,1500000US131210098021,131210098021,"Block Group 1, Census Tract 98.02, Fulton County, Georgia",1774,1688,86,95.1521984216,4.84780157835
2834,1500000US131210098022,131210098022,"Block Group 2, Census Tract 98.02, Fulton County, Georgia",2710,1522,1188,56.1623616236,43.8376383764
2835,1500000US131210099001,131210099001,"Block Group 1, Census Tract 99, Fulton County, Georgia",1579,828,751,52.4382520583,47.5617479417
2836,1500000US131210099002,131210099002,"Block Group 2, Census Tract 99, Fulton County, Georgia",1190,1190,0,100.0,0.0
2837,1500000US131210099003,131210099003,"Block Group 3, Census Tract 99, Fulton County, Georgia",1330,1330,0,100.0,0.0
2838,1500000US131210099004,131210099004,"Block Group 4, Census Tract 99, Fulton County, Georgia",669,669,0,100.0,0.0
2839,1500000US131210100011,131210100011,"Block Group 1, Census Tract 100.01, Fulton County, Georgia",1482,1223,259,82.5236167341,17.4763832659
2840,1500000US131210100012,131210100012,"Block Group 2, Census Tract 100.01, Fulton County, Georgia",1076,803,273,74.6282527881,25.3717472119
2841,1500000US131210100013,131210100013,"Block Group 3, Census Tract 100.01, Fulton County, Georgia",718,718,0,100.0,0.0
2842,1500000US131210100014,131210100014,"Block Group 4, Census Tract 100.01, Fulton County, Georgia",1228,842,386,68.5667752443,31.4332247557
2843,1500000US131210100021,131210100021,"Block Group 1, Census Tract 100.02, Fulton County, Georgia",1474,1474,0,100.0,0.0
2844,1500000US131210100022,131210100022,"Block Group 2, Census Tract 100.02, Fulton County, Georgia",2041,2041,0,100.0,0.0
2845,1500000US131210100023,131210100023,"Block Group 3, Census Tract 100.02, Fulton County, Georgia",3828,2122,1706,55.433646813,44.566353187
2846,1500000US131210101061,131210101061,"Block Group 1, Census Tract 101.06, Fulton County, Georgia",2099,1188,911,56.598380181,43.401619819
2847,1500000US131210101062,131210101062,"Block Group 2, Census Tract 101.06, Fulton County, Georgia",881,139,742,15.7775255392,84.2224744608
2848,1500000US131210101063,131210101063,"Block Group 3, Census Tract 101.06, Fulton County, Georgia",1087,1087,0,100.0,0.0
2849,1500000US131210101071,131210101071,"Block Group 1, Census Tract 101.07, Fulton County, Georgia",912,880,32,96.4912280702,3.50877192982
2850,1500000US131210101072,131210101072,"Block Group 2, Census Tract 101.07, Fulton County, Georgia",986,839,147,85.0912778905,14.9087221095
2851,1500000US131210101081,131210101081,"Block Group 1, Census Tract 101.08, Fulton County, Georgia",1266,1266,0,100.0,0.0
2852,1500000US131210101082,131210101082,"Block Group 2, Census Tract 101.08, Fulton County, Georgia",2333,2134,199,91.47021003,8.52978997
2853,1500000US131210101101,131210101101,"Block Group 1, Census Tract 101.10, Fulton County, Georgia",2609,1622,987,62.1694135684,37.8305864316
2854,1500000US131210101102,131210101102,"Block Group 2, Census Tract 101.10, Fulton County, Georgia",1118,565,553,50.5366726297,49.4633273703
2855,1500000US131210101103,131210101103,"Block Group 3, Census Tract 101.10, Fulton County, Georgia",1756,687,1069,39.1230068337,60.8769931663
2856,1500000US131210101131,131210101131,"Block Group 1, Census Tract 101.13, Fulton County, Georgia",1749,419,1330,23.9565465981,76.0434534019
2857,1500000US131210101132,131210101132,"Block Group 2, Census Tract 101.13, Fulton County, Georgia",3024,0,3024,0.0,100.0
2858,1500000US131210101133,131210101133,"Block Group 3, Census Tract 101.13, Fulton County, Georgia",1975,719,1256,36.4050632911,63.5949367089
2859,1500000US131210101141,131210101141,"Block Group 1, Census Tract 101.14, Fulton County, Georgia",1953,1438,515,73.63031234,26.36968766
2860,1500000US131210101142,131210101142,"Block Group 2, Census Tract 101.14, Fulton County, Georgia",2988,1193,1795,39.9263721553,60.0736278447
2861,1500000US131210101143,131210101143,"Block Group 3, Census Tract 101.14, Fulton County, Georgia",2408,1057,1351,43.8953488372,56.1046511628
2862,1500000US131210101151,131210101151,"Block Group 1, Census Tract 101.15, Fulton County, Georgia",2126,1539,587,72.3894637817,27.6105362183
2863,1500000US131210101171,131210101171,"Block Group 1, Census Tract 101.17, Fulton County, Georgia",2494,170,2324,6.81635926223,93.1836407378
2864,1500000US131210101172,131210101172,"Block Group 2, Census Tract 101.17, Fulton County, Georgia",838,113,725,13.4844868735,86.5155131265
2865,1500000US131210101181,131210101181,"Block Group 1, Census Tract 101.18, Fulton County, Georgia",3083,983,2100,31.8845280571,68.1154719429
2866,1500000US131210101182,131210101182,"Block Group 2, Census Tract 101.18, Fulton County, Georgia",974,76,898,7.80287474333,92.1971252567
2867,1500000US131210101183,131210101183,"Block Group 3, Census Tract 101.18, Fulton County, Georgia",1377,106,1271,7.6978939724,92.3021060276
2868,1500000US131210101191,131210101191,"Block Group 1, Census Tract 101.19, Fulton County, Georgia",1387,203,1184,14.6359048306,85.3640951694
2869,1500000US131210101192,131210101192,"Block Group 2, Census Tract 101.19, Fulton County, Georgia",1916,77,1839,4.01878914405,95.9812108559
2870,1500000US131210101193,131210101193,"Block Group 3, Census Tract 101.19, Fulton County, Georgia",1678,211,1467,12.5744934446,87.4255065554
2871,1500000US131210101201,131210101201,"Block Group 1, Census Tract 101.20, Fulton County, Georgia",2302,808,1494,35.099913119,64.900086881
2872,1500000US131210101211,131210101211,"Block Group 1, Census Tract 101.21, Fulton County, Georgia",2199,1517,682,68.985902683,31.014097317
2873,1500000US131210101221,131210101221,"Block Group 1, Census Tract 101.22, Fulton County, Georgia",2320,1243,1077,53.5775862069,46.4224137931
2874,1500000US131210101222,131210101222,"Block Group 2, Census Tract 101.22, Fulton County, Georgia",1853,1042,811,56.233135456,43.766864544
2875,1500000US131210101223,131210101223,"Block Group 3, Census Tract 101.22, Fulton County, Georgia",2096,42,2054,2.00381679389,97.9961832061
2876,1500000US131210101231,131210101231,"Block Group 1, Census Tract 101.23, Fulton County, Georgia",2793,704,2089,25.2058718224,74.7941281776
2877,1500000US131210101232,131210101232,"Block Group 2, Census Tract 101.23, Fulton County, Georgia",1396,1315,81,94.1977077364,5.80229226361
2878,1500000US131210101233,131210101233,"Block Group 3, Census Tract 101.23, Fulton County, Georgia",1704,362,1342,21.2441314554,78.7558685446
2879,1500000US131210102041,131210102041,"Block Group 1, Census Tract 102.04, Fulton County, Georgia",1056,1031,25,97.6325757576,2.36742424242
2880,1500000US131210102042,131210102042,"Block Group 2, Census Tract 102.04, Fulton County, Georgia",1991,1907,84,95.7810145655,4.21898543446
2881,1500000US131210102043,131210102043,"Block Group 3, Census Tract 102.04, Fulton County, Georgia",1242,1197,45,96.3768115942,3.6231884058
2882,1500000US131210102044,131210102044,"Block Group 4, Census Tract 102.04, Fulton County, Georgia",607,591,16,97.3640856672,2.63591433278
2883,1500000US131210102051,131210102051,"Block Group 1, Census Tract 102.05, Fulton County, Georgia",938,836,102,89.1257995736,10.8742004264
2884,1500000US131210102052,131210102052,"Block Group 2, Census Tract 102.05, Fulton County, Georgia",1057,674,383,63.7653736991,36.2346263009
2885,1500000US131210102053,131210102053,"Block Group 3, Census Tract 102.05, Fulton County, Georgia",1933,1814,119,93.8437661666,6.15623383342
2886,1500000US131210102054,131210102054,"Block Group 4, Census Tract 102.05, Fulton County, Georgia",1050,775,275,73.8095238095,26.1904761905
2887,1500000US131210102061,131210102061,"Block Group 1, Census Tract 102.06, Fulton County, Georgia",2365,2030,335,85.8350951374,14.1649048626
2888,1500000US131210102062,131210102062,"Block Group 2, Census Tract 102.06, Fulton County, Georgia",1552,1466,86,94.4587628866,5.5412371134
2889,1500000US131210102063,131210102063,"Block Group 3, Census Tract 102.06, Fulton County, Georgia",1343,1332,11,99.1809381981,0.819061801936
2890,1500000US131210102081,131210102081,"Block Group 1, Census Tract 102.08, Fulton County, Georgia",1799,1053,746,58.5325180656,41.4674819344
2891,1500000US131210102082,131210102082,"Block Group 2, Census Tract 102.08, Fulton County, Georgia",336,0,336,0.0,100.0
2892,1500000US131210102083,131210102083,"Block Group 3, Census Tract 102.08, Fulton County, Georgia",2058,390,1668,18.9504373178,81.0495626822
2893,1500000US131210102091,131210102091,"Block Group 1, Census Tract 102.09, Fulton County, Georgia",1206,352,854,29.1873963516,70.8126036484
2894,1500000US131210102092,131210102092,"Block Group 2, Census Tract 102.09, Fulton County, Georgia",969,767,202,79.1537667699,20.8462332301
2895,1500000US131210102093,131210102093,"Block Group 3, Census Tract 102.09, Fulton County, Georgia",3600,184,3416,5.11111111111,94.8888888889
2896,1500000US131210102101,131210102101,"Block Group 1, Census Tract 102.10, Fulton County, Georgia",1534,874,660,56.9752281617,43.0247718383
2897,1500000US131210102102,131210102102,"Block Group 2, Census Tract 102.10, Fulton County, Georgia",2304,1349,955,58.5503472222,41.4496527778
2898,1500000US131210102103,131210102103,"Block Group 3, Census Tract 102.10, Fulton County, Georgia",1950,1303,647,66.8205128205,33.1794871795
2899,1500000US131210102111,131210102111,"Block Group 1, Census Tract 102.11, Fulton County, Georgia",1227,1205,22,98.207008965,1.79299103504
2900,1500000US131210102112,131210102112,"Block Group 2, Census Tract 102.11, Fulton County, Georgia",2030,1528,502,75.2709359606,24.7290640394
2901,1500000US131210102121,131210102121,"Block Group 1, Census Tract 102.12, Fulton County, Georgia",1999,413,1586,20.6603301651,79.3396698349
2902,1500000US131210102122,131210102122,"Block Group 2, Census Tract 102.12, Fulton County, Georgia",773,669,104,86.5459249677,13.4540750323
2903,1500000US131210102123,131210102123,"Block Group 3, Census Tract 102.12, Fulton County, Georgia",2256,824,1432,36.524822695,63.475177305
2904,1500000US131210103011,131210103011,"Block Group 1, Census Tract 103.01, Fulton County, Georgia",9717,7710,2007,79.3454769991,20.6545230009
2905,1500000US131210103012,131210103012,"Block Group 2, Census Tract 103.01, Fulton County, Georgia",6419,4964,1455,77.3329179,22.6670821
2906,1500000US131210103031,131210103031,"Block Group 1, Census Tract 103.03, Fulton County, Georgia",3102,2195,907,70.7607994842,29.2392005158
2907,1500000US131210103032,131210103032,"Block Group 2, Census Tract 103.03, Fulton County, Georgia",6383,4165,2218,65.2514491618,34.7485508382
2908,1500000US131210103041,131210103041,"Block Group 1, Census Tract 103.04, Fulton County, Georgia",4897,4119,778,84.1127220747,15.8872779253
2909,1500000US131210103042,131210103042,"Block Group 2, Census Tract 103.04, Fulton County, Georgia",10474,8311,2163,79.3488638534,20.6511361466
2910,1500000US131210104001,131210104001,"Block Group 1, Census Tract 104, Fulton County, Georgia",1756,1492,264,84.9658314351,15.0341685649
2911,1500000US131210104002,131210104002,"Block Group 2, Census Tract 104, Fulton County, Georgia",1443,1106,337,76.6458766459,23.3541233541
2912,1500000US131210104003,131210104003,"Block Group 3, Census Tract 104, Fulton County, Georgia",3885,2899,986,74.6203346203,25.3796653797
2913,1500000US131210104004,131210104004,"Block Group 4, Census Tract 104, Fulton County, Georgia",1297,807,490,62.2205088666,37.7794911334
2914,1500000US131210105071,131210105071,"Block Group 1, Census Tract 105.07, Fulton County, Georgia",3119,1953,1166,62.6162231484,37.3837768516
2915,1500000US131210105072,131210105072,"Block Group 2, Census Tract 105.07, Fulton County, Georgia",1055,637,418,60.3791469194,39.6208530806
2916,1500000US131210105073,131210105073,"Block Group 3, Census Tract 105.07, Fulton County, Georgia",2146,494,1652,23.0195712954,76.9804287046
2917,1500000US131210105074,131210105074,"Block Group 4, Census Tract 105.07, Fulton County, Georgia",2021,1226,795,60.6630381,39.3369619
2918,1500000US131210105081,131210105081,"Block Group 1, Census Tract 105.08, Fulton County, Georgia",4002,2785,1217,69.5902048976,30.4097951024
2919,1500000US131210105101,131210105101,"Block Group 1, Census Tract 105.10, Fulton County, Georgia",3030,1395,1635,46.0396039604,53.9603960396
2920,1500000US131210105102,131210105102,"Block Group 2, Census Tract 105.10, Fulton County, Georgia",1265,208,1057,16.442687747,83.557312253
2921,1500000US131210105103,131210105103,"Block Group 3, Census Tract 105.10, Fulton County, Georgia",9365,4627,4738,49.407367859,50.592632141
2922,1500000US131210105104,131210105104,"Block Group 4, Census Tract 105.10, Fulton County, Georgia",2141,1582,559,73.8907052779,26.1092947221
2923,1500000US131210105111,131210105111,"Block Group 1, Census Tract 105.11, Fulton County, Georgia",1838,1076,762,58.5418933624,41.4581066376
2924,1500000US131210105112,131210105112,"Block Group 2, Census Tract 105.11, Fulton County, Georgia",5839,4855,984,83.1477992807,16.8522007193
2925,1500000US131210105113,131210105113,"Block Group 3, Census Tract 105.11, Fulton County, Georgia",611,480,131,78.5597381342,21.4402618658
2926,1500000US131210105121,131210105121,"Block Group 1, Census Tract 105.12, Fulton County, Georgia",3387,441,2946,13.0203720106,86.9796279894
2927,1500000US131210105122,131210105122,"Block Group 2, Census Tract 105.12, Fulton County, Georgia",1042,463,579,44.43378119,55.56621881
2928,1500000US131210105123,131210105123,"Block Group 3, Census Tract 105.12, Fulton County, Georgia",2220,562,1658,25.3153153153,74.6846846847
2929,1500000US131210105131,131210105131,"Block Group 1, Census Tract 105.13, Fulton County, Georgia",4628,3759,869,81.2229904927,18.7770095073
2930,1500000US131210105132,131210105132,"Block Group 2, Census Tract 105.13, Fulton County, Georgia",3191,1509,1682,47.2892510185,52.7107489815
2931,1500000US131210105133,131210105133,"Block Group 3, Census Tract 105.13, Fulton County, Georgia",5198,3718,1480,71.527510581,28.472489419
2932,1500000US131210105141,131210105141,"Block Group 1, Census Tract 105.14, Fulton County, Georgia",4132,3700,432,89.5450145208,10.4549854792
2933,1500000US131210105142,131210105142,"Block Group 2, Census Tract 105.14, Fulton County, Georgia",4389,3032,1357,69.0817953976,30.9182046024
2934,1500000US131210105143,131210105143,"Block Group 3, Census Tract 105.14, Fulton County, Georgia",3185,1017,2168,31.9309262166,68.0690737834
2935,1500000US131210105151,131210105151,"Block Group 1, Census Tract 105.15, Fulton County, Georgia",4809,2922,1887,60.7610729881,39.2389270119
2936,1500000US131210105161,131210105161,"Block Group 1, Census Tract 105.16, Fulton County, Georgia",2711,1492,1219,55.0350424198,44.9649575802
2937,1500000US131210105162,131210105162,"Block Group 2, Census Tract 105.16, Fulton County, Georgia",3823,2641,1182,69.0818728747,30.9181271253
2938,1500000US131210105163,131210105163,"Block Group 3, Census Tract 105.16, Fulton County, Georgia",2377,1412,965,59.4026083298,40.5973916702
2939,1500000US131210106011,131210106011,"Block Group 1, Census Tract 106.01, Fulton County, Georgia",1242,757,485,60.9500805153,39.0499194847
2940,1500000US131210106012,131210106012,"Block Group 2, Census Tract 106.01, Fulton County, Georgia",1078,184,894,17.0686456401,82.9313543599
2941,1500000US131210106013,131210106013,"Block Group 3, Census Tract 106.01, Fulton County, Georgia",486,258,228,53.0864197531,46.9135802469
2942,1500000US131210106014,131210106014,"Block Group 4, Census Tract 106.01, Fulton County, Georgia",781,258,523,33.0345710627,66.9654289373
2943,1500000US131210106031,131210106031,"Block Group 1, Census Tract 106.03, Fulton County, Georgia",833,16,817,1.92076830732,98.0792316927
2944,1500000US131210106032,131210106032,"Block Group 2, Census Tract 106.03, Fulton County, Georgia",2224,548,1676,24.6402877698,75.3597122302
2945,1500000US131210106033,131210106033,"Block Group 3, Census Tract 106.03, Fulton County, Georgia",752,0,752,0.0,100.0
2946,1500000US131210106041,131210106041,"Block Group 1, Census Tract 106.04, Fulton County, Georgia",639,0,639,0.0,100.0
2947,1500000US131210106042,131210106042,"Block Group 2, Census Tract 106.04, Fulton County, Georgia",223,0,223,0.0,100.0
2948,1500000US131210106043,131210106043,"Block Group 3, Census Tract 106.04, Fulton County, Georgia",1896,983,913,51.8459915612,48.1540084388
2949,1500000US131210108001,131210108001,"Block Group 1, Census Tract 108, Fulton County, Georgia",537,118,419,21.9739292365,78.0260707635
2950,1500000US131210108002,131210108002,"Block Group 2, Census Tract 108, Fulton County, Georgia",1002,678,324,67.6646706587,32.3353293413
2951,1500000US131210108003,131210108003,"Block Group 3, Census Tract 108, Fulton County, Georgia",2013,440,1573,21.8579234973,78.1420765027
2952,1500000US131210108004,131210108004,"Block Group 4, Census Tract 108, Fulton County, Georgia",1428,168,1260,11.7647058824,88.2352941176
2953,1500000US131210108005,131210108005,"Block Group 5, Census Tract 108, Fulton County, Georgia",355,216,139,60.8450704225,39.1549295775
2954,1500000US131210108006,131210108006,"Block Group 6, Census Tract 108, Fulton County, Georgia",1309,421,888,32.1619556914,67.8380443086
2955,1500000US131210110001,131210110001,"Block Group 1, Census Tract 110, Fulton County, Georgia",682,289,393,42.3753665689,57.6246334311
2956,1500000US131210110002,131210110002,"Block Group 2, Census Tract 110, Fulton County, Georgia",1050,181,869,17.2380952381,82.7619047619
2957,1500000US131210110003,131210110003,"Block Group 3, Census Tract 110, Fulton County, Georgia",931,261,670,28.0343716434,71.9656283566
2958,1500000US131210110004,131210110004,"Block Group 4, Census Tract 110, Fulton County, Georgia",408,102,306,25.0,75.0
2959,1500000US131210111001,131210111001,"Block Group 1, Census Tract 111, Fulton County, Georgia",658,432,226,65.6534954407,34.3465045593
2960,1500000US131210111002,131210111002,"Block Group 2, Census Tract 111, Fulton County, Georgia",1100,751,349,68.2727272727,31.7272727273
2961,1500000US131210111003,131210111003,"Block Group 3, Census Tract 111, Fulton County, Georgia",551,342,209,62.0689655172,37.9310344828
2962,1500000US131210112011,131210112011,"Block Group 1, Census Tract 112.01, Fulton County, Georgia",1422,379,1043,26.6526019691,73.3473980309
2963,1500000US131210112012,131210112012,"Block Group 2, Census Tract 112.01, Fulton County, Georgia",1286,395,891,30.7153965785,69.2846034215
2964,1500000US131210112013,131210112013,"Block Group 3, Census Tract 112.01, Fulton County, Georgia",1458,587,871,40.2606310014,59.7393689986
2965,1500000US131210112021,131210112021,"Block Group 1, Census Tract 112.02, Fulton County, Georgia",388,282,106,72.6804123711,27.3195876289
2966,1500000US131210112022,131210112022,"Block Group 2, Census Tract 112.02, Fulton County, Georgia",568,328,240,57.7464788732,42.2535211268
2967,1500000US131210112023,131210112023,"Block Group 3, Census Tract 112.02, Fulton County, Georgia",979,410,569,41.8794688458,58.1205311542
2968,1500000US131210112024,131210112024,"Block Group 4, Census Tract 112.02, Fulton County, Georgia",698,460,238,65.9025787966,34.0974212034
2969,1500000US131210112025,131210112025,"Block Group 5, Census Tract 112.02, Fulton County, Georgia",1465,305,1160,20.819112628,79.180887372
2970,1500000US131210112026,131210112026,"Block Group 6, Census Tract 112.02, Fulton County, Georgia",699,219,480,31.330472103,68.669527897
2971,1500000US131210113011,131210113011,"Block Group 1, Census Tract 113.01, Fulton County, Georgia",733,575,158,78.4447476126,21.5552523874
2972,1500000US131210113012,131210113012,"Block Group 2, Census Tract 113.01, Fulton County, Georgia",512,252,260,49.21875,50.78125
2973,1500000US131210113013,131210113013,"Block Group 3, Census Tract 113.01, Fulton County, Georgia",296,239,57,80.7432432432,19.2567567568
2974,1500000US131210113014,131210113014,"Block Group 4, Census Tract 113.01, Fulton County, Georgia",998,889,109,89.0781563126,10.9218436874
2975,1500000US131210113015,131210113015,"Block Group 5, Census Tract 113.01, Fulton County, Georgia",701,550,151,78.4593437946,21.5406562054
2976,1500000US131210113016,131210113016,"Block Group 6, Census Tract 113.01, Fulton County, Georgia",980,386,594,39.387755102,60.612244898
2977,1500000US131210113031,131210113031,"Block Group 1, Census Tract 113.03, Fulton County, Georgia",3746,1986,1760,53.0165509877,46.9834490123
2978,1500000US131210113032,131210113032,"Block Group 2, Census Tract 113.03, Fulton County, Georgia",1139,390,749,34.2405618964,65.7594381036
2979,1500000US131210113033,131210113033,"Block Group 3, Census Tract 113.03, Fulton County, Georgia",495,390,105,78.7878787879,21.2121212121
2980,1500000US131210113034,131210113034,"Block Group 4, Census Tract 113.03, Fulton County, Georgia",613,120,493,19.5758564437,80.4241435563
2981,1500000US131210113035,131210113035,"Block Group 5, Census Tract 113.03, Fulton County, Georgia",3101,714,2387,23.0248306998,76.9751693002
2982,1500000US131210113051,131210113051,"Block Group 1, Census Tract 113.05, Fulton County, Georgia",1129,377,752,33.3923826395,66.6076173605
2983,1500000US131210113052,131210113052,"Block Group 2, Census Tract 113.05, Fulton County, Georgia",2369,246,2123,10.3841283242,89.6158716758
2984,1500000US131210113053,131210113053,"Block Group 3, Census Tract 113.05, Fulton County, Georgia",1645,404,1241,24.5592705167,75.4407294833
2985,1500000US131210113061,131210113061,"Block Group 1, Census Tract 113.06, Fulton County, Georgia",1307,49,1258,3.74904361132,96.2509563887
2986,1500000US131210113062,131210113062,"Block Group 2, Census Tract 113.06, Fulton County, Georgia",1129,1009,120,89.3711248893,10.6288751107
2987,1500000US131210114051,131210114051,"Block Group 1, Census Tract 114.05, Fulton County, Georgia",1751,1268,483,72.4157624215,27.5842375785
2988,1500000US131210114052,131210114052,"Block Group 2, Census Tract 114.05, Fulton County, Georgia",1036,653,383,63.0308880309,36.9691119691
2989,1500000US131210114053,131210114053,"Block Group 3, Census Tract 114.05, Fulton County, Georgia",2344,713,1631,30.4180887372,69.5819112628
2990,1500000US131210114054,131210114054,"Block Group 4, Census Tract 114.05, Fulton County, Georgia",2735,238,2497,8.70201096892,91.2979890311
2991,1500000US131210114101,131210114101,"Block Group 1, Census Tract 114.10, Fulton County, Georgia",2514,1675,839,66.6268894193,33.3731105807
2992,1500000US131210114102,131210114102,"Block Group 2, Census Tract 114.10, Fulton County, Georgia",2106,1640,466,77.8727445394,22.1272554606
2993,1500000US131210114103,131210114103,"Block Group 3, Census Tract 114.10, Fulton County, Georgia",2071,1966,105,94.9299855142,5.07001448576
2994,1500000US131210114111,131210114111,"Block Group 1, Census Tract 114.11, Fulton County, Georgia",2605,1393,1212,53.4740882917,46.5259117083
2995,1500000US131210114112,131210114112,"Block Group 2, Census Tract 114.11, Fulton County, Georgia",765,736,29,96.2091503268,3.7908496732
2996,1500000US131210114113,131210114113,"Block Group 3, Census Tract 114.11, Fulton County, Georgia",2666,1221,1445,45.7989497374,54.2010502626
2997,1500000US131210114114,131210114114,"Block Group 4, Census Tract 114.11, Fulton County, Georgia",1001,977,24,97.6023976024,2.3976023976
2998,1500000US131210114115,131210114115,"Block Group 5, Census Tract 114.11, Fulton County, Georgia",1359,1265,94,93.0831493745,6.91685062546
2999,1500000US131210114121,131210114121,"Block Group 1, Census Tract 114.12, Fulton County, Georgia",4063,2773,1290,68.2500615309,31.7499384691
3000,1500000US131210114122,131210114122,"Block Group 2, Census Tract 114.12, Fulton County, Georgia",1924,1154,770,59.9792099792,40.0207900208
3001,1500000US131210114123,131210114123,"Block Group 3, Census Tract 114.12, Fulton County, Georgia",3325,2380,945,71.5789473684,28.4210526316
3002,1500000US131210114141,131210114141,"Block Group 1, Census Tract 114.14, Fulton County, Georgia",2174,443,1731,20.3771849126,79.6228150874
3003,1500000US131210114142,131210114142,"Block Group 2, Census Tract 114.14, Fulton County, Georgia",1251,1251,0,100.0,0.0
3004,1500000US131210114143,131210114143,"Block Group 3, Census Tract 114.14, Fulton County, Georgia",1970,1892,78,96.0406091371,3.95939086294
3005,1500000US131210114144,131210114144,"Block Group 4, Census Tract 114.14, Fulton County, Georgia",2148,517,1631,24.0689013035,75.9310986965
3006,1500000US131210114161,131210114161,"Block Group 1, Census Tract 114.16, Fulton County, Georgia",1981,1981,0,100.0,0.0
3007,1500000US131210114162,131210114162,"Block Group 2, Census Tract 114.16, Fulton County, Georgia",2187,1947,240,89.0260631001,10.9739368999
3008,1500000US131210114163,131210114163,"Block Group 3, Census Tract 114.16, Fulton County, Georgia",1060,947,113,89.3396226415,10.6603773585
3009,1500000US131210114171,131210114171,"Block Group 1, Census Tract 114.17, Fulton County, Georgia",1021,960,61,94.0254652302,5.97453476983
3010,1500000US131210114172,131210114172,"Block Group 2, Census Tract 114.17, Fulton County, Georgia",1527,913,614,59.7904387688,40.2095612312
3011,1500000US131210114173,131210114173,"Block Group 3, Census Tract 114.17, Fulton County, Georgia",1620,1324,296,81.7283950617,18.2716049383
3012,1500000US131210114174,131210114174,"Block Group 4, Census Tract 114.17, Fulton County, Georgia",609,577,32,94.7454844007,5.25451559934
3013,1500000US131210114181,131210114181,"Block Group 1, Census Tract 114.18, Fulton County, Georgia",854,652,202,76.3466042155,23.6533957845
3014,1500000US131210114182,131210114182,"Block Group 2, Census Tract 114.18, Fulton County, Georgia",511,437,74,85.518590998,14.481409002
3015,1500000US131210114183,131210114183,"Block Group 3, Census Tract 114.18, Fulton County, Georgia",1134,1134,0,100.0,0.0
3016,1500000US131210114184,131210114184,"Block Group 4, Census Tract 114.18, Fulton County, Georgia",3619,3324,295,91.848576955,8.15142304504
3017,1500000US131210114191,131210114191,"Block Group 1, Census Tract 114.19, Fulton County, Georgia",1445,1406,39,97.3010380623,2.69896193772
3018,1500000US131210114192,131210114192,"Block Group 2, Census Tract 114.19, Fulton County, Georgia",1919,1779,140,92.7045336113,7.29546638874
3019,1500000US131210114193,131210114193,"Block Group 3, Census Tract 114.19, Fulton County, Georgia",2235,1954,281,87.4272930649,12.5727069351
3020,1500000US131210114201,131210114201,"Block Group 1, Census Tract 114.20, Fulton County, Georgia",1576,57,1519,3.61675126904,96.383248731
3021,1500000US131210114202,131210114202,"Block Group 2, Census Tract 114.20, Fulton County, Georgia",3989,158,3831,3.96089245425,96.0391075458
3022,1500000US131210114203,131210114203,"Block Group 3, Census Tract 114.20, Fulton County, Georgia",2261,559,1702,24.72357364,75.27642636
3023,1500000US131210114211,131210114211,"Block Group 1, Census Tract 114.21, Fulton County, Georgia",2274,625,1649,27.4846086192,72.5153913808
3024,1500000US131210114212,131210114212,"Block Group 2, Census Tract 114.21, Fulton County, Georgia",1569,40,1529,2.5493945188,97.4506054812
3025,1500000US131210114221,131210114221,"Block Group 1, Census Tract 114.22, Fulton County, Georgia",3039,1177,1862,38.7298453439,61.2701546561
3026,1500000US131210114222,131210114222,"Block Group 2, Census Tract 114.22, Fulton County, Georgia",1043,875,168,83.8926174497,16.1073825503
3027,1500000US131210114231,131210114231,"Block Group 1, Census Tract 114.23, Fulton County, Georgia",1110,939,171,84.5945945946,15.4054054054
3028,1500000US131210114232,131210114232,"Block Group 2, Census Tract 114.23, Fulton County, Georgia",1495,1415,80,94.6488294314,5.35117056856
3029,1500000US131210114233,131210114233,"Block Group 3, Census Tract 114.23, Fulton County, Georgia",1427,961,466,67.3440784863,32.6559215137
3030,1500000US131210114234,131210114234,"Block Group 4, Census Tract 114.23, Fulton County, Georgia",957,757,200,79.1013584117,20.8986415883
3031,1500000US131210114241,131210114241,"Block Group 1, Census Tract 114.24, Fulton County, Georgia",3680,3189,491,86.6576086957,13.3423913043
3032,1500000US131210114242,131210114242,"Block Group 2, Census Tract 114.24, Fulton County, Georgia",1995,1498,497,75.0877192982,24.9122807018
3033,1500000US131210114251,131210114251,"Block Group 1, Census Tract 114.25, Fulton County, Georgia",2279,2222,57,97.4989030276,2.50109697236
3034,1500000US131210114252,131210114252,"Block Group 2, Census Tract 114.25, Fulton County, Georgia",3037,2523,514,83.0754033586,16.9245966414
3035,1500000US131210114253,131210114253,"Block Group 3, Census Tract 114.25, Fulton County, Georgia",1922,1671,251,86.9406867846,13.0593132154
3036,1500000US131210114261,131210114261,"Block Group 1, Census Tract 114.26, Fulton County, Georgia",2555,2056,499,80.469667319,19.530332681
3037,1500000US131210114271,131210114271,"Block Group 1, Census Tract 114.27, Fulton County, Georgia",2468,2182,286,88.4116693679,11.5883306321
3038,1500000US131210114272,131210114272,"Block Group 2, Census Tract 114.27, Fulton County, Georgia",3025,2782,243,91.9669421488,8.03305785124
3039,1500000US131210114273,131210114273,"Block Group 3, Census Tract 114.27, Fulton County, Georgia",2287,2148,139,93.9221687801,6.07783121994
3040,1500000US131210115031,131210115031,"Block Group 1, Census Tract 115.03, Fulton County, Georgia",2036,2018,18,99.115913556,0.884086444008
3041,1500000US131210115032,131210115032,"Block Group 2, Census Tract 115.03, Fulton County, Georgia",2095,2079,16,99.2362768496,0.763723150358
3042,1500000US131210115033,131210115033,"Block Group 3, Census Tract 115.03, Fulton County, Georgia",5914,5221,693,88.2820426108,11.7179573892
3043,1500000US131210115041,131210115041,"Block Group 1, Census Tract 115.04, Fulton County, Georgia",3411,3182,229,93.286426268,6.71357373204
3044,1500000US131210115042,131210115042,"Block Group 2, Census Tract 115.04, Fulton County, Georgia",2225,2225,0,100.0,0.0
3045,1500000US131210115043,131210115043,"Block Group 3, Census Tract 115.04, Fulton County, Georgia",4255,3967,288,93.2314923619,6.76850763807
3046,1500000US131210115044,131210115044,"Block Group 4, Census Tract 115.04, Fulton County, Georgia",2930,2371,559,80.9215017065,19.0784982935
3047,1500000US131210115051,131210115051,"Block Group 1, Census Tract 115.05, Fulton County, Georgia",2564,2253,311,87.8705148206,12.1294851794
3048,1500000US131210115052,131210115052,"Block Group 2, Census Tract 115.05, Fulton County, Georgia",1967,1887,80,95.93289273,4.06710726995
3049,1500000US131210115061,131210115061,"Block Group 1, Census Tract 115.06, Fulton County, Georgia",1953,1782,171,91.2442396313,8.75576036866
3050,1500000US131210115062,131210115062,"Block Group 2, Census Tract 115.06, Fulton County, Georgia",2790,2637,153,94.5161290323,5.48387096774
3051,1500000US131210115063,131210115063,"Block Group 3, Census Tract 115.06, Fulton County, Georgia",1594,1594,0,100.0,0.0
3052,1500000US131210116101,131210116101,"Block Group 1, Census Tract 116.10, Fulton County, Georgia",2811,2595,216,92.3159018143,7.6840981857
3053,1500000US131210116102,131210116102,"Block Group 2, Census Tract 116.10, Fulton County, Georgia",3028,1722,1306,56.8692206077,43.1307793923
3054,1500000US131210116111,131210116111,"Block Group 1, Census Tract 116.11, Fulton County, Georgia",2665,752,1913,28.2176360225,71.7823639775
3055,1500000US131210116112,131210116112,"Block Group 2, Census Tract 116.11, Fulton County, Georgia",1395,1128,267,80.8602150538,19.1397849462
3056,1500000US131210116113,131210116113,"Block Group 3, Census Tract 116.11, Fulton County, Georgia",3108,719,2389,23.1338481338,76.8661518662
3057,1500000US131210116121,131210116121,"Block Group 1, Census Tract 116.12, Fulton County, Georgia",2534,2338,196,92.2651933702,7.73480662983
3058,1500000US131210116122,131210116122,"Block Group 2, Census Tract 116.12, Fulton County, Georgia",847,683,164,80.6375442739,19.3624557261
3059,1500000US131210116131,131210116131,"Block Group 1, Census Tract 116.13, Fulton County, Georgia",3677,2662,1015,72.3959749796,27.6040250204
3060,1500000US131210116132,131210116132,"Block Group 2, Census Tract 116.13, Fulton County, Georgia",3242,1891,1351,58.3281924738,41.6718075262
3061,1500000US131210116141,131210116141,"Block Group 1, Census Tract 116.14, Fulton County, Georgia",2896,1031,1865,35.6008287293,64.3991712707
3062,1500000US131210116142,131210116142,"Block Group 2, Census Tract 116.14, Fulton County, Georgia",5129,2247,2882,43.809709495,56.190290505
3063,1500000US131210116143,131210116143,"Block Group 3, Census Tract 116.14, Fulton County, Georgia",6452,2979,3473,46.1717296962,53.8282703038
3064,1500000US131210116151,131210116151,"Block Group 1, Census Tract 116.15, Fulton County, Georgia",3881,3501,380,90.2087090956,9.79129090441
3065,1500000US131210116152,131210116152,"Block Group 2, Census Tract 116.15, Fulton County, Georgia",2023,2023,0,100.0,0.0
3066,1500000US131210116153,131210116153,"Block Group 3, Census Tract 116.15, Fulton County, Georgia",4069,2881,1188,70.8036372573,29.1963627427
3067,1500000US131210116161,131210116161,"Block Group 1, Census Tract 116.16, Fulton County, Georgia",2068,842,1226,40.7156673114,59.2843326886
3068,1500000US131210116162,131210116162,"Block Group 2, Census Tract 116.16, Fulton County, Georgia",1669,0,1669,0.0,100.0
3069,1500000US131210116163,131210116163,"Block Group 3, Census Tract 116.16, Fulton County, Georgia",1180,591,589,50.0847457627,49.9152542373
3070,1500000US131210116171,131210116171,"Block Group 1, Census Tract 116.17, Fulton County, Georgia",2625,2130,495,81.1428571429,18.8571428571
3071,1500000US131210116172,131210116172,"Block Group 2, Census Tract 116.17, Fulton County, Georgia",2447,1808,639,73.8863914998,26.1136085002
3072,1500000US131210116173,131210116173,"Block Group 3, Census Tract 116.17, Fulton County, Georgia",2606,2535,71,97.2755180353,2.7244819647
3073,1500000US131210116181,131210116181,"Block Group 1, Census Tract 116.18, Fulton County, Georgia",4416,2912,1504,65.9420289855,34.0579710145
3074,1500000US131210116191,131210116191,"Block Group 1, Census Tract 116.19, Fulton County, Georgia",2791,11,2780,0.394123969903,99.6058760301
3075,1500000US131210116192,131210116192,"Block Group 2, Census Tract 116.19, Fulton County, Georgia",2382,1132,1250,47.5230898405,52.4769101595
3076,1500000US131210116193,131210116193,"Block Group 3, Census Tract 116.19, Fulton County, Georgia",3221,1889,1332,58.6463831108,41.3536168892
3077,1500000US131210116201,131210116201,"Block Group 1, Census Tract 116.20, Fulton County, Georgia",3201,3035,166,94.8141205873,5.18587941268
3078,1500000US131210116202,131210116202,"Block Group 2, Census Tract 116.20, Fulton County, Georgia",4324,4278,46,98.9361702128,1.06382978723
3079,1500000US131210116203,131210116203,"Block Group 3, Census Tract 116.20, Fulton County, Georgia",3104,1998,1106,64.368556701,35.631443299
3080,1500000US131210116211,131210116211,"Block Group 1, Census Tract 116.21, Fulton County, Georgia",828,0,828,0.0,100.0
3081,1500000US131210116212,131210116212,"Block Group 2, Census Tract 116.21, Fulton County, Georgia",2359,2091,268,88.6392539212,11.3607460788
3082,1500000US131210116213,131210116213,"Block Group 3, Census Tract 116.21, Fulton County, Georgia",4031,3381,650,83.8749689903,16.1250310097
3083,1500000US131210116221,131210116221,"Block Group 1, Census Tract 116.22, Fulton County, Georgia",3922,3922,0,100.0,0.0
3084,1500000US131210116222,131210116222,"Block Group 2, Census Tract 116.22, Fulton County, Georgia",3196,3139,57,98.2165206508,1.78347934919
3085,1500000US131210116223,131210116223,"Block Group 3, Census Tract 116.22, Fulton County, Georgia",2896,2745,151,94.7859116022,5.21408839779
3086,1500000US131210116231,131210116231,"Block Group 1, Census Tract 116.23, Fulton County, Georgia",3451,3347,104,96.9863807592,3.0136192408
3087,1500000US131210116232,131210116232,"Block Group 2, Census Tract 116.23, Fulton County, Georgia",4570,2660,1910,58.2056892779,41.7943107221
3088,1500000US131210116233,131210116233,"Block Group 3, Census Tract 116.23, Fulton County, Georgia",1035,986,49,95.2657004831,4.73429951691
3089,1500000US131210116234,131210116234,"Block Group 4, Census Tract 116.23, Fulton County, Georgia",2945,1976,969,67.0967741935,32.9032258065
3090,1500000US131210116241,131210116241,"Block Group 1, Census Tract 116.24, Fulton County, Georgia",2535,2415,120,95.2662721893,4.73372781065
3091,1500000US131210116242,131210116242,"Block Group 2, Census Tract 116.24, Fulton County, Georgia",1766,1654,112,93.657984145,6.34201585504
3092,1500000US131210116251,131210116251,"Block Group 1, Census Tract 116.25, Fulton County, Georgia",2646,679,1967,25.6613756614,74.3386243386
3093,1500000US131210116252,131210116252,"Block Group 2, Census Tract 116.25, Fulton County, Georgia",2011,1955,56,97.2153157633,2.7846842367
3094,1500000US131210116253,131210116253,"Block Group 3, Census Tract 116.25, Fulton County, Georgia",2937,2435,502,82.9077289751,17.0922710249
3095,1500000US131210116261,131210116261,"Block Group 1, Census Tract 116.26, Fulton County, Georgia",5100,2692,2408,52.7843137255,47.2156862745
3096,1500000US131210116262,131210116262,"Block Group 2, Census Tract 116.26, Fulton County, Georgia",4199,2637,1562,62.8006668254,37.1993331746
3097,1500000US131210118001,131210118001,"Block Group 1, Census Tract 118, Fulton County, Georgia",290,76,214,26.2068965517,73.7931034483
3098,1500000US131210118002,131210118002,"Block Group 2, Census Tract 118, Fulton County, Georgia",1889,119,1770,6.29962943356,93.7003705664
3099,1500000US131210118003,131210118003,"Block Group 3, Census Tract 118, Fulton County, Georgia",708,49,659,6.9209039548,93.0790960452
3100,1500000US131210119001,131210119001,"Block Group 1, Census Tract 119, Fulton County, Georgia",1174,44,1130,3.74787052811,96.2521294719
3101,1500000US131210119002,131210119002,"Block Group 2, Census Tract 119, Fulton County, Georgia",1318,208,1110,15.7814871017,84.2185128983
3102,1500000US131210120001,131210120001,"Block Group 1, Census Tract 120, Fulton County, Georgia",1329,290,1039,21.8209179834,78.1790820166
3103,1500000US131210120002,131210120002,"Block Group 2, Census Tract 120, Fulton County, Georgia",1355,559,796,41.2546125461,58.7453874539
3104,1500000US131210123001,131210123001,"Block Group 1, Census Tract 123, Fulton County, Georgia",974,422,552,43.3264887064,56.6735112936
3105,1500000US131210123002,131210123002,"Block Group 2, Census Tract 123, Fulton County, Georgia",825,190,635,23.0303030303,76.9696969697
3106,1500000US131210123003,131210123003,"Block Group 3, Census Tract 123, Fulton County, Georgia",656,469,187,71.493902439,28.506097561
3107,1500000US131219800001,131219800001,"Block Group 1, Census Tract 9800, Fulton County, Georgia",0,0,0,,
3108,1500000US131230801001,131230801001,"Block Group 1, Census Tract 801, Gilmer County, Georgia",1762,1317,445,74.7446083995,25.2553916005
3109,1500000US131230801002,131230801002,"Block Group 2, Census Tract 801, Gilmer County, Georgia",1427,1305,122,91.4505956552,8.54940434478
3110,1500000US131230801003,131230801003,"Block Group 3, Census Tract 801, Gilmer County, Georgia",818,727,91,88.8753056235,11.1246943765
3111,1500000US131230802001,131230802001,"Block Group 1, Census Tract 802, Gilmer County, Georgia",1182,1133,49,95.8544839255,4.14551607445
3112,1500000US131230802002,131230802002,"Block Group 2, Census Tract 802, Gilmer County, Georgia",2106,1855,251,88.081671415,11.918328585
3113,1500000US131230802003,131230802003,"Block Group 3, Census Tract 802, Gilmer County, Georgia",2389,1989,400,83.2565927166,16.7434072834
3114,1500000US131230803001,131230803001,"Block Group 1, Census Tract 803, Gilmer County, Georgia",1457,637,820,43.7199725463,56.2800274537
3115,1500000US131230803002,131230803002,"Block Group 2, Census Tract 803, Gilmer County, Georgia",1556,778,778,50.0,50.0
3116,1500000US131230803003,131230803003,"Block Group 3, Census Tract 803, Gilmer County, Georgia",1545,989,556,64.0129449838,35.9870550162
3117,1500000US131230803004,131230803004,"Block Group 4, Census Tract 803, Gilmer County, Georgia",2061,1143,918,55.4585152838,44.5414847162
3118,1500000US131230804001,131230804001,"Block Group 1, Census Tract 804, Gilmer County, Georgia",2928,2421,507,82.6844262295,17.3155737705
3119,1500000US131230804002,131230804002,"Block Group 2, Census Tract 804, Gilmer County, Georgia",2955,2628,327,88.9340101523,11.0659898477
3120,1500000US131230804003,131230804003,"Block Group 3, Census Tract 804, Gilmer County, Georgia",2443,1476,967,60.4175194433,39.5824805567
3121,1500000US131230805001,131230805001,"Block Group 1, Census Tract 805, Gilmer County, Georgia",729,414,315,56.7901234568,43.2098765432
3122,1500000US131230805002,131230805002,"Block Group 2, Census Tract 805, Gilmer County, Georgia",1539,1278,261,83.0409356725,16.9590643275
3123,1500000US131230805003,131230805003,"Block Group 3, Census Tract 805, Gilmer County, Georgia",1497,1099,398,73.413493654,26.586506346
3124,1500000US131250101001,131250101001,"Block Group 1, Census Tract 101, Glascock County, Georgia",1119,802,317,71.6711349419,28.3288650581
3125,1500000US131250101002,131250101002,"Block Group 2, Census Tract 101, Glascock County, Georgia",946,736,210,77.8012684989,22.1987315011
3126,1500000US131250101003,131250101003,"Block Group 3, Census Tract 101, Glascock County, Georgia",927,730,197,78.7486515642,21.2513484358
3127,1500000US131270001011,131270001011,"Block Group 1, Census Tract 1.01, Glynn County, Georgia",677,473,204,69.8670605613,30.1329394387
3128,1500000US131270001012,131270001012,"Block Group 2, Census Tract 1.01, Glynn County, Georgia",544,455,89,83.6397058824,16.3602941176
3129,1500000US131270001021,131270001021,"Block Group 1, Census Tract 1.02, Glynn County, Georgia",1753,1026,727,58.5282373075,41.4717626925
3130,1500000US131270001022,131270001022,"Block Group 2, Census Tract 1.02, Glynn County, Georgia",744,443,301,59.5430107527,40.4569892473
3131,1500000US131270001023,131270001023,"Block Group 3, Census Tract 1.02, Glynn County, Georgia",977,641,336,65.6090071648,34.3909928352
3132,1500000US131270002001,131270002001,"Block Group 1, Census Tract 2, Glynn County, Georgia",1448,1160,288,80.1104972376,19.8895027624
3133,1500000US131270002002,131270002002,"Block Group 2, Census Tract 2, Glynn County, Georgia",1598,1193,405,74.6558197747,25.3441802253
3134,1500000US131270002003,131270002003,"Block Group 3, Census Tract 2, Glynn County, Georgia",1664,1376,288,82.6923076923,17.3076923077
3135,1500000US131270003001,131270003001,"Block Group 1, Census Tract 3, Glynn County, Georgia",2463,1949,514,79.1311408851,20.8688591149
3136,1500000US131270003002,131270003002,"Block Group 2, Census Tract 3, Glynn County, Georgia",1045,677,368,64.7846889952,35.2153110048
3137,1500000US131270003003,131270003003,"Block Group 3, Census Tract 3, Glynn County, Georgia",2164,1664,500,76.8946395564,23.1053604436
3138,1500000US131270003004,131270003004,"Block Group 4, Census Tract 3, Glynn County, Georgia",630,552,78,87.619047619,12.380952381
3139,1500000US131270004011,131270004011,"Block Group 1, Census Tract 4.01, Glynn County, Georgia",3757,2534,1223,67.4474314613,32.5525685387
3140,1500000US131270004012,131270004012,"Block Group 2, Census Tract 4.01, Glynn County, Georgia",1079,893,186,82.7618164968,17.2381835032
3141,1500000US131270004013,131270004013,"Block Group 3, Census Tract 4.01, Glynn County, Georgia",3097,2990,107,96.5450435906,3.45495640943
3142,1500000US131270004031,131270004031,"Block Group 1, Census Tract 4.03, Glynn County, Georgia",1619,1018,601,62.8783199506,37.1216800494
3143,1500000US131270004032,131270004032,"Block Group 2, Census Tract 4.03, Glynn County, Georgia",1521,1409,112,92.6364234057,7.36357659435
3144,1500000US131270004041,131270004041,"Block Group 1, Census Tract 4.04, Glynn County, Georgia",910,845,65,92.8571428571,7.14285714286
3145,1500000US131270004042,131270004042,"Block Group 2, Census Tract 4.04, Glynn County, Georgia",5287,2775,2512,52.4872328353,47.5127671647
3146,1500000US131270004043,131270004043,"Block Group 3, Census Tract 4.04, Glynn County, Georgia",5181,3229,1952,62.3238756997,37.6761243003
3147,1500000US131270005011,131270005011,"Block Group 1, Census Tract 5.01, Glynn County, Georgia",675,153,522,22.6666666667,77.3333333333
3148,1500000US131270005012,131270005012,"Block Group 2, Census Tract 5.01, Glynn County, Georgia",1903,1030,873,54.1250656858,45.8749343142
3149,1500000US131270005013,131270005013,"Block Group 3, Census Tract 5.01, Glynn County, Georgia",1118,279,839,24.9552772809,75.0447227191
3150,1500000US131270005031,131270005031,"Block Group 1, Census Tract 5.03, Glynn County, Georgia",1042,412,630,39.5393474088,60.4606525912
3151,1500000US131270005032,131270005032,"Block Group 2, Census Tract 5.03, Glynn County, Georgia",1129,85,1044,7.52878653676,92.4712134632
3152,1500000US131270005033,131270005033,"Block Group 3, Census Tract 5.03, Glynn County, Georgia",1818,549,1269,30.198019802,69.801980198
3153,1500000US131270005041,131270005041,"Block Group 1, Census Tract 5.04, Glynn County, Georgia",598,346,252,57.8595317726,42.1404682274
3154,1500000US131270005042,131270005042,"Block Group 2, Census Tract 5.04, Glynn County, Georgia",983,808,175,82.1973550356,17.8026449644
3155,1500000US131270005043,131270005043,"Block Group 3, Census Tract 5.04, Glynn County, Georgia",1845,534,1311,28.9430894309,71.0569105691
3156,1500000US131270006001,131270006001,"Block Group 1, Census Tract 6, Glynn County, Georgia",1509,778,731,51.5573227303,48.4426772697
3157,1500000US131270006002,131270006002,"Block Group 2, Census Tract 6, Glynn County, Georgia",1604,824,780,51.3715710723,48.6284289277
3158,1500000US131270006003,131270006003,"Block Group 3, Census Tract 6, Glynn County, Georgia",1122,756,366,67.3796791444,32.6203208556
3159,1500000US131270006004,131270006004,"Block Group 4, Census Tract 6, Glynn County, Georgia",1522,1202,320,78.9750328515,21.0249671485
3160,1500000US131270007001,131270007001,"Block Group 1, Census Tract 7, Glynn County, Georgia",2442,720,1722,29.484029484,70.515970516
3161,1500000US131270007002,131270007002,"Block Group 2, Census Tract 7, Glynn County, Georgia",992,859,133,86.5927419355,13.4072580645
3162,1500000US131270007003,131270007003,"Block Group 3, Census Tract 7, Glynn County, Georgia",773,381,392,49.2884864166,50.7115135834
3163,1500000US131270007004,131270007004,"Block Group 4, Census Tract 7, Glynn County, Georgia",1213,675,538,55.647155812,44.352844188
3164,1500000US131270007005,131270007005,"Block Group 5, Census Tract 7, Glynn County, Georgia",666,203,463,30.4804804805,69.5195195195
3165,1500000US131270007006,131270007006,"Block Group 6, Census Tract 7, Glynn County, Georgia",582,353,229,60.6529209622,39.3470790378
3166,1500000US131270007007,131270007007,"Block Group 7, Census Tract 7, Glynn County, Georgia",334,201,133,60.1796407186,39.8203592814
3167,1500000US131270007008,131270007008,"Block Group 8, Census Tract 7, Glynn County, Georgia",690,329,361,47.6811594203,52.3188405797
3168,1500000US131270008001,131270008001,"Block Group 1, Census Tract 8, Glynn County, Georgia",498,247,251,49.5983935743,50.4016064257
3169,1500000US131270008002,131270008002,"Block Group 2, Census Tract 8, Glynn County, Georgia",1355,481,874,35.4981549815,64.5018450185
3170,1500000US131270008003,131270008003,"Block Group 3, Census Tract 8, Glynn County, Georgia",854,88,766,10.3044496487,89.6955503513
3171,1500000US131270008004,131270008004,"Block Group 4, Census Tract 8, Glynn County, Georgia",1011,100,911,9.89119683482,90.1088031652
3172,1500000US131270009001,131270009001,"Block Group 1, Census Tract 9, Glynn County, Georgia",597,191,406,31.9932998325,68.0067001675
3173,1500000US131270009002,131270009002,"Block Group 2, Census Tract 9, Glynn County, Georgia",466,183,283,39.2703862661,60.7296137339
3174,1500000US131270009003,131270009003,"Block Group 3, Census Tract 9, Glynn County, Georgia",901,418,483,46.3928967814,53.6071032186
3175,1500000US131270009004,131270009004,"Block Group 4, Census Tract 9, Glynn County, Georgia",1388,626,762,45.1008645533,54.8991354467
3176,1500000US131270009005,131270009005,"Block Group 5, Census Tract 9, Glynn County, Georgia",1179,545,634,46.2256149279,53.7743850721
3177,1500000US131270010001,131270010001,"Block Group 1, Census Tract 10, Glynn County, Georgia",588,393,195,66.8367346939,33.1632653061
3178,1500000US131270010002,131270010002,"Block Group 2, Census Tract 10, Glynn County, Georgia",2552,1857,695,72.7664576803,27.2335423197
3179,1500000US131270010003,131270010003,"Block Group 3, Census Tract 10, Glynn County, Georgia",2216,1938,278,87.4548736462,12.5451263538
3180,1500000US131270010004,131270010004,"Block Group 4, Census Tract 10, Glynn County, Georgia",4107,3268,839,79.5714633552,20.4285366448
3181,1500000US131279900000,131279900000,"Block Group 0, Census Tract 9900, Glynn County, Georgia",0,0,0,,
3182,1500000US131299701001,131299701001,"Block Group 1, Census Tract 9701, Gordon County, Georgia",1256,944,312,75.1592356688,24.8407643312
3183,1500000US131299701002,131299701002,"Block Group 2, Census Tract 9701, Gordon County, Georgia",1501,1228,273,81.8121252498,18.1878747502
3184,1500000US131299701003,131299701003,"Block Group 3, Census Tract 9701, Gordon County, Georgia",3554,2493,1061,70.1463140124,29.8536859876
3185,1500000US131299702001,131299702001,"Block Group 1, Census Tract 9702, Gordon County, Georgia",1364,906,458,66.42228739,33.57771261
3186,1500000US131299702002,131299702002,"Block Group 2, Census Tract 9702, Gordon County, Georgia",1304,781,523,59.8926380368,40.1073619632
3187,1500000US131299702003,131299702003,"Block Group 3, Census Tract 9702, Gordon County, Georgia",2429,1413,1016,58.1720872787,41.8279127213
3188,1500000US131299702004,131299702004,"Block Group 4, Census Tract 9702, Gordon County, Georgia",2036,1642,394,80.6483300589,19.3516699411
3189,1500000US131299703001,131299703001,"Block Group 1, Census Tract 9703, Gordon County, Georgia",1102,862,240,78.221415608,21.778584392
3190,1500000US131299703002,131299703002,"Block Group 2, Census Tract 9703, Gordon County, Georgia",2605,1585,1020,60.8445297505,39.1554702495
3191,1500000US131299703003,131299703003,"Block Group 3, Census Tract 9703, Gordon County, Georgia",3872,1465,2407,37.8357438017,62.1642561983
3192,1500000US131299703004,131299703004,"Block Group 4, Census Tract 9703, Gordon County, Georgia",1116,263,853,23.5663082437,76.4336917563
3193,1500000US131299704001,131299704001,"Block Group 1, Census Tract 9704, Gordon County, Georgia",2451,1770,681,72.2154222766,27.7845777234
3194,1500000US131299704002,131299704002,"Block Group 2, Census Tract 9704, Gordon County, Georgia",1518,409,1109,26.9433465086,73.0566534914
3195,1500000US131299704003,131299704003,"Block Group 3, Census Tract 9704, Gordon County, Georgia",1008,446,562,44.246031746,55.753968254
3196,1500000US131299705001,131299705001,"Block Group 1, Census Tract 9705, Gordon County, Georgia",2031,1067,964,52.5356967011,47.4643032989
3197,1500000US131299705002,131299705002,"Block Group 2, Census Tract 9705, Gordon County, Georgia",1326,816,510,61.5384615385,38.4615384615
3198,1500000US131299705003,131299705003,"Block Group 3, Census Tract 9705, Gordon County, Georgia",1410,534,876,37.8723404255,62.1276595745
3199,1500000US131299706001,131299706001,"Block Group 1, Census Tract 9706, Gordon County, Georgia",634,131,503,20.6624605678,79.3375394322
3200,1500000US131299706002,131299706002,"Block Group 2, Census Tract 9706, Gordon County, Georgia",2122,1408,714,66.3524976437,33.6475023563
3201,1500000US131299706003,131299706003,"Block Group 3, Census Tract 9706, Gordon County, Georgia",3642,1337,2305,36.7105985722,63.2894014278
3202,1500000US131299707001,131299707001,"Block Group 1, Census Tract 9707, Gordon County, Georgia",1682,1438,244,85.4934601665,14.5065398335
3203,1500000US131299707002,131299707002,"Block Group 2, Census Tract 9707, Gordon County, Georgia",902,545,357,60.421286031,39.578713969
3204,1500000US131299707003,131299707003,"Block Group 3, Census Tract 9707, Gordon County, Georgia",1680,1040,640,61.9047619048,38.0952380952
3205,1500000US131299708001,131299708001,"Block Group 1, Census Tract 9708, Gordon County, Georgia",1160,981,179,84.5689655172,15.4310344828
3206,1500000US131299708002,131299708002,"Block Group 2, Census Tract 9708, Gordon County, Georgia",1900,1729,171,91.0,9.0
3207,1500000US131299708003,131299708003,"Block Group 3, Census Tract 9708, Gordon County, Georgia",2760,2401,359,86.9927536232,13.0072463768
3208,1500000US131299709001,131299709001,"Block Group 1, Census Tract 9709, Gordon County, Georgia",1650,989,661,59.9393939394,40.0606060606
3209,1500000US131299709002,131299709002,"Block Group 2, Census Tract 9709, Gordon County, Georgia",1408,1076,332,76.4204545455,23.5795454545
3210,1500000US131299709003,131299709003,"Block Group 3, Census Tract 9709, Gordon County, Georgia",3842,3250,592,84.5913586674,15.4086413326
3211,1500000US131319501001,131319501001,"Block Group 1, Census Tract 9501, Grady County, Georgia",1311,874,437,66.6666666667,33.3333333333
3212,1500000US131319501002,131319501002,"Block Group 2, Census Tract 9501, Grady County, Georgia",823,463,360,56.2575941677,43.7424058323
3213,1500000US131319502001,131319502001,"Block Group 1, Census Tract 9502, Grady County, Georgia",1361,1109,252,81.4842027921,18.5157972079
3214,1500000US131319502002,131319502002,"Block Group 2, Census Tract 9502, Grady County, Georgia",1361,958,403,70.3894195445,29.6105804555
3215,1500000US131319503001,131319503001,"Block Group 1, Census Tract 9503, Grady County, Georgia",1729,1106,623,63.967611336,36.032388664
3216,1500000US131319503002,131319503002,"Block Group 2, Census Tract 9503, Grady County, Georgia",1172,413,759,35.2389078498,64.7610921502
3217,1500000US131319503003,131319503003,"Block Group 3, Census Tract 9503, Grady County, Georgia",643,209,434,32.5038880249,67.4961119751
3218,1500000US131319503004,131319503004,"Block Group 4, Census Tract 9503, Grady County, Georgia",865,357,508,41.2716763006,58.7283236994
3219,1500000US131319504001,131319504001,"Block Group 1, Census Tract 9504, Grady County, Georgia",2412,1426,986,59.1210613599,40.8789386401
3220,1500000US131319504002,131319504002,"Block Group 2, Census Tract 9504, Grady County, Georgia",1774,978,796,55.1296505073,44.8703494927
3221,1500000US131319504003,131319504003,"Block Group 3, Census Tract 9504, Grady County, Georgia",1700,511,1189,30.0588235294,69.9411764706
3222,1500000US131319504004,131319504004,"Block Group 4, Census Tract 9504, Grady County, Georgia",673,0,673,0.0,100.0
3223,1500000US131319505001,131319505001,"Block Group 1, Census Tract 9505, Grady County, Georgia",2680,1463,1217,54.5895522388,45.4104477612
3224,1500000US131319505002,131319505002,"Block Group 2, Census Tract 9505, Grady County, Georgia",1215,437,778,35.9670781893,64.0329218107
3225,1500000US131319505003,131319505003,"Block Group 3, Census Tract 9505, Grady County, Georgia",1573,815,758,51.8118245391,48.1881754609
3226,1500000US131319505004,131319505004,"Block Group 4, Census Tract 9505, Grady County, Georgia",1439,536,903,37.2480889507,62.7519110493
3227,1500000US131319506001,131319506001,"Block Group 1, Census Tract 9506, Grady County, Georgia",2324,1707,617,73.4509466437,26.5490533563
3228,1500000US131339501001,131339501001,"Block Group 1, Census Tract 9501, Greene County, Georgia",1154,1096,58,94.9740034662,5.0259965338
3229,1500000US131339501002,131339501002,"Block Group 2, Census Tract 9501, Greene County, Georgia",1069,636,433,59.4948550047,40.5051449953
3230,1500000US131339502001,131339502001,"Block Group 1, Census Tract 9502, Greene County, Georgia",715,363,352,50.7692307692,49.2307692308
3231,1500000US131339502002,131339502002,"Block Group 2, Census Tract 9502, Greene County, Georgia",795,565,230,71.0691823899,28.9308176101
3232,1500000US131339502003,131339502003,"Block Group 3, Census Tract 9502, Greene County, Georgia",583,353,230,60.5488850772,39.4511149228
3233,1500000US131339503011,131339503011,"Block Group 1, Census Tract 9503.01, Greene County, Georgia",849,838,11,98.7043580683,1.29564193168
3234,1500000US131339503012,131339503012,"Block Group 2, Census Tract 9503.01, Greene County, Georgia",718,703,15,97.9108635097,2.08913649025
3235,1500000US131339503013,131339503013,"Block Group 3, Census Tract 9503.01, Greene County, Georgia",472,381,91,80.7203389831,19.2796610169
3236,1500000US131339503014,131339503014,"Block Group 4, Census Tract 9503.01, Greene County, Georgia",371,364,7,98.1132075472,1.88679245283
3237,1500000US131339503021,131339503021,"Block Group 1, Census Tract 9503.02, Greene County, Georgia",1771,1442,329,81.4229249012,18.5770750988
3238,1500000US131339503022,131339503022,"Block Group 2, Census Tract 9503.02, Greene County, Georgia",755,714,41,94.5695364238,5.43046357616
3239,1500000US131339503031,131339503031,"Block Group 1, Census Tract 9503.03, Greene County, Georgia",800,582,218,72.75,27.25
3240,1500000US131339503032,131339503032,"Block Group 2, Census Tract 9503.03, Greene County, Georgia",1342,373,969,27.7943368107,72.2056631893
3241,1500000US131339503033,131339503033,"Block Group 3, Census Tract 9503.03, Greene County, Georgia",1487,475,1012,31.9435104237,68.0564895763
3242,1500000US131339503034,131339503034,"Block Group 4, Census Tract 9503.03, Greene County, Georgia",237,85,152,35.864978903,64.135021097
3243,1500000US131339503035,131339503035,"Block Group 5, Census Tract 9503.03, Greene County, Georgia",278,99,179,35.6115107914,64.3884892086
3244,1500000US131339504001,131339504001,"Block Group 1, Census Tract 9504, Greene County, Georgia",1325,943,382,71.1698113208,28.8301886792
3245,1500000US131339505001,131339505001,"Block Group 1, Census Tract 9505, Greene County, Georgia",637,615,22,96.546310832,3.45368916797
3246,1500000US131339505002,131339505002,"Block Group 2, Census Tract 9505, Greene County, Georgia",763,588,175,77.0642201835,22.9357798165
3247,1500000US131350501031,131350501031,"Block Group 1, Census Tract 501.03, Gwinnett County, Georgia",4562,4088,474,89.6098202543,10.3901797457
3248,1500000US131350501032,131350501032,"Block Group 2, Census Tract 501.03, Gwinnett County, Georgia",1455,790,665,54.295532646,45.704467354
3249,1500000US131350501033,131350501033,"Block Group 3, Census Tract 501.03, Gwinnett County, Georgia",4397,3131,1266,71.2076415738,28.7923584262
3250,1500000US131350501051,131350501051,"Block Group 1, Census Tract 501.05, Gwinnett County, Georgia",571,220,351,38.5288966725,61.4711033275
3251,1500000US131350501052,131350501052,"Block Group 2, Census Tract 501.05, Gwinnett County, Georgia",1320,686,634,51.9696969697,48.0303030303
3252,1500000US131350501053,131350501053,"Block Group 3, Census Tract 501.05, Gwinnett County, Georgia",1934,869,1065,44.9327817994,55.0672182006
3253,1500000US131350501061,131350501061,"Block Group 1, Census Tract 501.06, Gwinnett County, Georgia",5086,3572,1514,70.2320094377,29.7679905623
3254,1500000US131350501062,131350501062,"Block Group 2, Census Tract 501.06, Gwinnett County, Georgia",1644,1351,293,82.1776155718,17.8223844282
3255,1500000US131350501063,131350501063,"Block Group 3, Census Tract 501.06, Gwinnett County, Georgia",2149,1781,368,82.8757561657,17.1242438343
3256,1500000US131350501064,131350501064,"Block Group 4, Census Tract 501.06, Gwinnett County, Georgia",2543,492,2051,19.3472276838,80.6527723162
3257,1500000US131350501071,131350501071,"Block Group 1, Census Tract 501.07, Gwinnett County, Georgia",7312,6503,809,88.9359956236,11.0640043764
3258,1500000US131350501081,131350501081,"Block Group 1, Census Tract 501.08, Gwinnett County, Georgia",6628,6541,87,98.6873868437,1.31261315631
3259,1500000US131350501082,131350501082,"Block Group 2, Census Tract 501.08, Gwinnett County, Georgia",3007,2629,378,87.4293315597,12.5706684403
3260,1500000US131350501091,131350501091,"Block Group 1, Census Tract 501.09, Gwinnett County, Georgia",2960,2557,403,86.3851351351,13.6148648649
3261,1500000US131350501092,131350501092,"Block Group 2, Census Tract 501.09, Gwinnett County, Georgia",4911,2881,2030,58.6642231725,41.3357768275
3262,1500000US131350502051,131350502051,"Block Group 1, Census Tract 502.05, Gwinnett County, Georgia",2535,1633,902,64.4181459566,35.5818540434
3263,1500000US131350502052,131350502052,"Block Group 2, Census Tract 502.05, Gwinnett County, Georgia",1724,278,1446,16.1252900232,83.8747099768
3264,1500000US131350502081,131350502081,"Block Group 1, Census Tract 502.08, Gwinnett County, Georgia",3294,2194,1100,66.6059502125,33.3940497875
3265,1500000US131350502082,131350502082,"Block Group 2, Census Tract 502.08, Gwinnett County, Georgia",3277,1559,1718,47.5740006103,52.4259993897
3266,1500000US131350502091,131350502091,"Block Group 1, Census Tract 502.09, Gwinnett County, Georgia",4434,1688,2746,38.0694632386,61.9305367614
3267,1500000US131350502092,131350502092,"Block Group 2, Census Tract 502.09, Gwinnett County, Georgia",2737,468,2269,17.0990135185,82.9009864815
3268,1500000US131350502093,131350502093,"Block Group 3, Census Tract 502.09, Gwinnett County, Georgia",2858,2578,280,90.2029391183,9.79706088174
3269,1500000US131350502101,131350502101,"Block Group 1, Census Tract 502.10, Gwinnett County, Georgia",3024,1987,1037,65.7076719577,34.2923280423
3270,1500000US131350502102,131350502102,"Block Group 2, Census Tract 502.10, Gwinnett County, Georgia",3881,1591,2290,40.9945890234,59.0054109766
3271,1500000US131350502111,131350502111,"Block Group 1, Census Tract 502.11, Gwinnett County, Georgia",1351,26,1325,1.9245003701,98.0754996299
3272,1500000US131350502112,131350502112,"Block Group 2, Census Tract 502.11, Gwinnett County, Georgia",1087,7,1080,0.64397424103,99.356025759
3273,1500000US131350502113,131350502113,"Block Group 3, Census Tract 502.11, Gwinnett County, Georgia",2814,1389,1425,49.3603411514,50.6396588486
3274,1500000US131350502121,131350502121,"Block Group 1, Census Tract 502.12, Gwinnett County, Georgia",3116,3042,74,97.6251604621,2.37483953787
3275,1500000US131350502122,131350502122,"Block Group 2, Census Tract 502.12, Gwinnett County, Georgia",2652,2313,339,87.2171945701,12.7828054299
3276,1500000US131350502123,131350502123,"Block Group 3, Census Tract 502.12, Gwinnett County, Georgia",6965,6652,313,95.5061019383,4.49389806174
3277,1500000US131350502131,131350502131,"Block Group 1, Census Tract 502.13, Gwinnett County, Georgia",5111,4008,1103,78.4190960673,21.5809039327
3278,1500000US131350502132,131350502132,"Block Group 2, Census Tract 502.13, Gwinnett County, Georgia",7897,6940,957,87.8814739775,12.1185260225
3279,1500000US131350502141,131350502141,"Block Group 1, Census Tract 502.14, Gwinnett County, Georgia",2210,1861,349,84.2081447964,15.7918552036
3280,1500000US131350502142,131350502142,"Block Group 2, Census Tract 502.14, Gwinnett County, Georgia",4908,2805,2103,57.1515892421,42.8484107579
3281,1500000US131350502143,131350502143,"Block Group 3, Census Tract 502.14, Gwinnett County, Georgia",1637,1637,0,100.0,0.0
3282,1500000US131350502151,131350502151,"Block Group 1, Census Tract 502.15, Gwinnett County, Georgia",3363,695,2668,20.6660719596,79.3339280404
3283,1500000US131350502161,131350502161,"Block Group 1, Census Tract 502.16, Gwinnett County, Georgia",2471,1560,911,63.132335087,36.867664913
3284,1500000US131350502162,131350502162,"Block Group 2, Census Tract 502.16, Gwinnett County, Georgia",2795,2761,34,98.7835420394,1.21645796064
3285,1500000US131350502163,131350502163,"Block Group 3, Census Tract 502.16, Gwinnett County, Georgia",3758,2812,946,74.8270356573,25.1729643427
3286,1500000US131350502171,131350502171,"Block Group 1, Census Tract 502.17, Gwinnett County, Georgia",8288,4317,3971,52.0873552124,47.9126447876
3287,1500000US131350502172,131350502172,"Block Group 2, Census Tract 502.17, Gwinnett County, Georgia",1873,1815,58,96.9033635878,3.09663641217
3288,1500000US131350502181,131350502181,"Block Group 1, Census Tract 502.18, Gwinnett County, Georgia",2458,1278,1180,51.9934906428,48.0065093572
3289,1500000US131350502182,131350502182,"Block Group 2, Census Tract 502.18, Gwinnett County, Georgia",1493,651,842,43.6034829203,56.3965170797
3290,1500000US131350502191,131350502191,"Block Group 1, Census Tract 502.19, Gwinnett County, Georgia",849,555,294,65.371024735,34.628975265
3291,1500000US131350502192,131350502192,"Block Group 2, Census Tract 502.19, Gwinnett County, Georgia",2888,2040,848,70.6371191136,29.3628808864
3292,1500000US131350502201,131350502201,"Block Group 1, Census Tract 502.20, Gwinnett County, Georgia",2130,1042,1088,48.9201877934,51.0798122066
3293,1500000US131350502202,131350502202,"Block Group 2, Census Tract 502.20, Gwinnett County, Georgia",2990,113,2877,3.77926421405,96.220735786
3294,1500000US131350502203,131350502203,"Block Group 3, Census Tract 502.20, Gwinnett County, Georgia",1115,342,773,30.6726457399,69.3273542601
3295,1500000US131350503041,131350503041,"Block Group 1, Census Tract 503.04, Gwinnett County, Georgia",2501,524,1977,20.9516193523,79.0483806477
3296,1500000US131350503042,131350503042,"Block Group 2, Census Tract 503.04, Gwinnett County, Georgia",1629,612,1017,37.5690607735,62.4309392265
3297,1500000US131350503043,131350503043,"Block Group 3, Census Tract 503.04, Gwinnett County, Georgia",889,7,882,0.787401574803,99.2125984252
3298,1500000US131350503061,131350503061,"Block Group 1, Census Tract 503.06, Gwinnett County, Georgia",2717,1155,1562,42.5101214575,57.4898785425
3299,1500000US131350503062,131350503062,"Block Group 2, Census Tract 503.06, Gwinnett County, Georgia",2151,1047,1104,48.6750348675,51.3249651325
3300,1500000US131350503081,131350503081,"Block Group 1, Census Tract 503.08, Gwinnett County, Georgia",2037,1833,204,89.9852724595,10.0147275405
3301,1500000US131350503082,131350503082,"Block Group 2, Census Tract 503.08, Gwinnett County, Georgia",1890,1697,193,89.7883597884,10.2116402116
3302,1500000US131350503091,131350503091,"Block Group 1, Census Tract 503.09, Gwinnett County, Georgia",2074,1920,154,92.574734812,7.42526518804
3303,1500000US131350503092,131350503092,"Block Group 2, Census Tract 503.09, Gwinnett County, Georgia",2038,662,1376,32.4828263003,67.5171736997
3304,1500000US131350503093,131350503093,"Block Group 3, Census Tract 503.09, Gwinnett County, Georgia",1666,1540,126,92.4369747899,7.56302521008
3305,1500000US131350503094,131350503094,"Block Group 4, Census Tract 503.09, Gwinnett County, Georgia",2338,1452,886,62.1043627032,37.8956372968
3306,1500000US131350503101,131350503101,"Block Group 1, Census Tract 503.10, Gwinnett County, Georgia",2026,1100,926,54.2941757157,45.7058242843
3307,1500000US131350503102,131350503102,"Block Group 2, Census Tract 503.10, Gwinnett County, Georgia",739,622,117,84.1677943166,15.8322056834
3308,1500000US131350503103,131350503103,"Block Group 3, Census Tract 503.10, Gwinnett County, Georgia",2564,2015,549,78.5881435257,21.4118564743
3309,1500000US131350503111,131350503111,"Block Group 1, Census Tract 503.11, Gwinnett County, Georgia",1907,1549,358,81.2270582066,18.7729417934
3310,1500000US131350503112,131350503112,"Block Group 2, Census Tract 503.11, Gwinnett County, Georgia",825,596,229,72.2424242424,27.7575757576
3311,1500000US131350503131,131350503131,"Block Group 1, Census Tract 503.13, Gwinnett County, Georgia",1827,1008,819,55.1724137931,44.8275862069
3312,1500000US131350503132,131350503132,"Block Group 2, Census Tract 503.13, Gwinnett County, Georgia",1895,1306,589,68.9182058047,31.0817941953
3313,1500000US131350503133,131350503133,"Block Group 3, Census Tract 503.13, Gwinnett County, Georgia",820,820,0,100.0,0.0
3314,1500000US131350503134,131350503134,"Block Group 4, Census Tract 503.13, Gwinnett County, Georgia",982,982,0,100.0,0.0
3315,1500000US131350503135,131350503135,"Block Group 5, Census Tract 503.13, Gwinnett County, Georgia",1044,867,177,83.0459770115,16.9540229885
3316,1500000US131350503136,131350503136,"Block Group 6, Census Tract 503.13, Gwinnett County, Georgia",1533,295,1238,19.2433137639,80.7566862361
3317,1500000US131350503141,131350503141,"Block Group 1, Census Tract 503.14, Gwinnett County, Georgia",2706,2196,510,81.1529933481,18.8470066519
3318,1500000US131350503142,131350503142,"Block Group 2, Census Tract 503.14, Gwinnett County, Georgia",4831,612,4219,12.6681846409,87.3318153591
3319,1500000US131350503143,131350503143,"Block Group 3, Census Tract 503.14, Gwinnett County, Georgia",1391,721,670,51.8332135155,48.1667864845
3320,1500000US131350503144,131350503144,"Block Group 4, Census Tract 503.14, Gwinnett County, Georgia",1169,1057,112,90.4191616766,9.58083832335
3321,1500000US131350503151,131350503151,"Block Group 1, Census Tract 503.15, Gwinnett County, Georgia",1534,742,792,48.370273794,51.629726206
3322,1500000US131350503152,131350503152,"Block Group 2, Census Tract 503.15, Gwinnett County, Georgia",3476,191,3285,5.49482163406,94.5051783659
3323,1500000US131350503153,131350503153,"Block Group 3, Census Tract 503.15, Gwinnett County, Georgia",714,665,49,93.137254902,6.86274509804
3324,1500000US131350503171,131350503171,"Block Group 1, Census Tract 503.17, Gwinnett County, Georgia",390,0,390,0.0,100.0
3325,1500000US131350503172,131350503172,"Block Group 2, Census Tract 503.17, Gwinnett County, Georgia",2086,8,2078,0.383509108341,99.6164908917
3326,1500000US131350503173,131350503173,"Block Group 3, Census Tract 503.17, Gwinnett County, Georgia",1217,166,1051,13.6400986031,86.3599013969
3327,1500000US131350503181,131350503181,"Block Group 1, Census Tract 503.18, Gwinnett County, Georgia",1905,386,1519,20.2624671916,79.7375328084
3328,1500000US131350503182,131350503182,"Block Group 2, Census Tract 503.18, Gwinnett County, Georgia",1088,0,1088,0.0,100.0
3329,1500000US131350503191,131350503191,"Block Group 1, Census Tract 503.19, Gwinnett County, Georgia",3564,1181,2383,33.1369248036,66.8630751964
3330,1500000US131350503192,131350503192,"Block Group 2, Census Tract 503.19, Gwinnett County, Georgia",2861,663,2198,23.1737154841,76.8262845159
3331,1500000US131350503201,131350503201,"Block Group 1, Census Tract 503.20, Gwinnett County, Georgia",1801,1028,773,57.0794003331,42.9205996669
3332,1500000US131350503202,131350503202,"Block Group 2, Census Tract 503.20, Gwinnett County, Georgia",3162,262,2900,8.28589500316,91.7141049968
3333,1500000US131350503203,131350503203,"Block Group 3, Census Tract 503.20, Gwinnett County, Georgia",1283,739,544,57.5993764614,42.4006235386
3334,1500000US131350503211,131350503211,"Block Group 1, Census Tract 503.21, Gwinnett County, Georgia",2079,2070,9,99.5670995671,0.4329004329
3335,1500000US131350503212,131350503212,"Block Group 2, Census Tract 503.21, Gwinnett County, Georgia",2424,2184,240,90.099009901,9.90099009901
3336,1500000US131350503221,131350503221,"Block Group 1, Census Tract 503.22, Gwinnett County, Georgia",1164,1164,0,100.0,0.0
3337,1500000US131350503222,131350503222,"Block Group 2, Census Tract 503.22, Gwinnett County, Georgia",2623,2423,200,92.3751429661,7.62485703393
3338,1500000US131350503223,131350503223,"Block Group 3, Census Tract 503.22, Gwinnett County, Georgia",949,846,103,89.1464699684,10.8535300316
3339,1500000US131350504101,131350504101,"Block Group 1, Census Tract 504.10, Gwinnett County, Georgia",1810,454,1356,25.0828729282,74.9171270718
3340,1500000US131350504102,131350504102,"Block Group 2, Census Tract 504.10, Gwinnett County, Georgia",2532,948,1584,37.4407582938,62.5592417062
3341,1500000US131350504103,131350504103,"Block Group 3, Census Tract 504.10, Gwinnett County, Georgia",1271,991,280,77.9701022817,22.0298977183
3342,1500000US131350504151,131350504151,"Block Group 1, Census Tract 504.15, Gwinnett County, Georgia",874,695,179,79.5194508009,20.4805491991
3343,1500000US131350504152,131350504152,"Block Group 2, Census Tract 504.15, Gwinnett County, Georgia",1135,1103,32,97.1806167401,2.81938325991
3344,1500000US131350504153,131350504153,"Block Group 3, Census Tract 504.15, Gwinnett County, Georgia",1632,1239,393,75.9191176471,24.0808823529
3345,1500000US131350504161,131350504161,"Block Group 1, Census Tract 504.16, Gwinnett County, Georgia",2827,1902,925,67.2798019102,32.7201980898
3346,1500000US131350504162,131350504162,"Block Group 2, Census Tract 504.16, Gwinnett County, Georgia",693,598,95,86.2914862915,13.7085137085
3347,1500000US131350504171,131350504171,"Block Group 1, Census Tract 504.17, Gwinnett County, Georgia",2431,960,1471,39.4899218429,60.5100781571
3348,1500000US131350504172,131350504172,"Block Group 2, Census Tract 504.17, Gwinnett County, Georgia",1494,0,1494,0.0,100.0
3349,1500000US131350504173,131350504173,"Block Group 3, Census Tract 504.17, Gwinnett County, Georgia",2095,526,1569,25.107398568,74.892601432
3350,1500000US131350504181,131350504181,"Block Group 1, Census Tract 504.18, Gwinnett County, Georgia",3046,871,2175,28.5948785292,71.4051214708
3351,1500000US131350504182,131350504182,"Block Group 2, Census Tract 504.18, Gwinnett County, Georgia",2562,682,1880,26.6198282592,73.3801717408
3352,1500000US131350504183,131350504183,"Block Group 3, Census Tract 504.18, Gwinnett County, Georgia",1646,0,1646,0.0,100.0
3353,1500000US131350504191,131350504191,"Block Group 1, Census Tract 504.19, Gwinnett County, Georgia",2342,385,1957,16.438941076,83.561058924
3354,1500000US131350504192,131350504192,"Block Group 2, Census Tract 504.19, Gwinnett County, Georgia",2654,2112,542,79.5779954785,20.4220045215
3355,1500000US131350504193,131350504193,"Block Group 3, Census Tract 504.19, Gwinnett County, Georgia",2903,1518,1385,52.2907337237,47.7092662763
3356,1500000US131350504211,131350504211,"Block Group 1, Census Tract 504.21, Gwinnett County, Georgia",2909,477,2432,16.3973874184,83.6026125816
3357,1500000US131350504212,131350504212,"Block Group 2, Census Tract 504.21, Gwinnett County, Georgia",1218,507,711,41.6256157635,58.3743842365
3358,1500000US131350504213,131350504213,"Block Group 3, Census Tract 504.21, Gwinnett County, Georgia",3171,1204,1967,37.9690949227,62.0309050773
3359,1500000US131350504221,131350504221,"Block Group 1, Census Tract 504.22, Gwinnett County, Georgia",1945,616,1329,31.6709511568,68.3290488432
3360,1500000US131350504222,131350504222,"Block Group 2, Census Tract 504.22, Gwinnett County, Georgia",2418,610,1808,25.2274607113,74.7725392887
3361,1500000US131350504223,131350504223,"Block Group 3, Census Tract 504.22, Gwinnett County, Georgia",4135,1577,2558,38.1378476421,61.8621523579
3362,1500000US131350504231,131350504231,"Block Group 1, Census Tract 504.23, Gwinnett County, Georgia",2621,2052,569,78.2907287295,21.7092712705
3363,1500000US131350504232,131350504232,"Block Group 2, Census Tract 504.23, Gwinnett County, Georgia",2380,95,2285,3.99159663866,96.0084033613
3364,1500000US131350504233,131350504233,"Block Group 3, Census Tract 504.23, Gwinnett County, Georgia",2325,1685,640,72.4731182796,27.5268817204
3365,1500000US131350504241,131350504241,"Block Group 1, Census Tract 504.24, Gwinnett County, Georgia",2332,515,1817,22.0840480274,77.9159519726
3366,1500000US131350504242,131350504242,"Block Group 2, Census Tract 504.24, Gwinnett County, Georgia",3930,1549,2381,39.4147582697,60.5852417303
3367,1500000US131350504243,131350504243,"Block Group 3, Census Tract 504.24, Gwinnett County, Georgia",1649,1160,489,70.3456640388,29.6543359612
3368,1500000US131350504251,131350504251,"Block Group 1, Census Tract 504.25, Gwinnett County, Georgia",1351,1091,260,80.754996299,19.245003701
3369,1500000US131350504252,131350504252,"Block Group 2, Census Tract 504.25, Gwinnett County, Georgia",1633,1507,126,92.2841396203,7.71586037967
3370,1500000US131350504253,131350504253,"Block Group 3, Census Tract 504.25, Gwinnett County, Georgia",2454,2040,414,83.1295843521,16.8704156479
3371,1500000US131350504261,131350504261,"Block Group 1, Census Tract 504.26, Gwinnett County, Georgia",1717,1479,238,86.1386138614,13.8613861386
3372,1500000US131350504262,131350504262,"Block Group 2, Census Tract 504.26, Gwinnett County, Georgia",760,619,141,81.4473684211,18.5526315789
3373,1500000US131350504263,131350504263,"Block Group 3, Census Tract 504.26, Gwinnett County, Georgia",928,594,334,64.0086206897,35.9913793103
3374,1500000US131350504264,131350504264,"Block Group 4, Census Tract 504.26, Gwinnett County, Georgia",1599,1125,474,70.3564727955,29.6435272045
3375,1500000US131350504265,131350504265,"Block Group 5, Census Tract 504.26, Gwinnett County, Georgia",1801,1592,209,88.3953359245,11.6046640755
3376,1500000US131350504271,131350504271,"Block Group 1, Census Tract 504.27, Gwinnett County, Georgia",3043,2088,955,68.6164968781,31.3835031219
3377,1500000US131350504272,131350504272,"Block Group 2, Census Tract 504.27, Gwinnett County, Georgia",2031,1483,548,73.0182176268,26.9817823732
3378,1500000US131350504273,131350504273,"Block Group 3, Census Tract 504.27, Gwinnett County, Georgia",1052,916,136,87.072243346,12.927756654
3379,1500000US131350504281,131350504281,"Block Group 1, Census Tract 504.28, Gwinnett County, Georgia",1695,1503,192,88.6725663717,11.3274336283
3380,1500000US131350504282,131350504282,"Block Group 2, Census Tract 504.28, Gwinnett County, Georgia",1092,864,228,79.1208791209,20.8791208791
3381,1500000US131350504283,131350504283,"Block Group 3, Census Tract 504.28, Gwinnett County, Georgia",2339,2069,270,88.4566053869,11.5433946131
3382,1500000US131350504284,131350504284,"Block Group 4, Census Tract 504.28, Gwinnett County, Georgia",1645,1393,252,84.6808510638,15.3191489362
3383,1500000US131350504291,131350504291,"Block Group 1, Census Tract 504.29, Gwinnett County, Georgia",2348,1726,622,73.5093696763,26.4906303237
3384,1500000US131350504292,131350504292,"Block Group 2, Census Tract 504.29, Gwinnett County, Georgia",3166,3065,101,96.8098547063,3.19014529375
3385,1500000US131350504293,131350504293,"Block Group 3, Census Tract 504.29, Gwinnett County, Georgia",1785,1654,131,92.6610644258,7.33893557423
3386,1500000US131350504301,131350504301,"Block Group 1, Census Tract 504.30, Gwinnett County, Georgia",1452,649,803,44.696969697,55.303030303
3387,1500000US131350504302,131350504302,"Block Group 2, Census Tract 504.30, Gwinnett County, Georgia",1327,1066,261,80.3315749812,19.6684250188
3388,1500000US131350504303,131350504303,"Block Group 3, Census Tract 504.30, Gwinnett County, Georgia",2675,2321,354,86.7663551402,13.2336448598
3389,1500000US131350504311,131350504311,"Block Group 1, Census Tract 504.31, Gwinnett County, Georgia",1067,341,726,31.9587628866,68.0412371134
3390,1500000US131350504312,131350504312,"Block Group 2, Census Tract 504.31, Gwinnett County, Georgia",3099,31,3068,1.00032268474,98.9996773153
3391,1500000US131350504313,131350504313,"Block Group 3, Census Tract 504.31, Gwinnett County, Georgia",4222,3877,345,91.8285172904,8.17148270962
3392,1500000US131350504321,131350504321,"Block Group 1, Census Tract 504.32, Gwinnett County, Georgia",1382,968,414,70.0434153401,29.9565846599
3393,1500000US131350504322,131350504322,"Block Group 2, Census Tract 504.32, Gwinnett County, Georgia",1860,1032,828,55.4838709677,44.5161290323
3394,1500000US131350504323,131350504323,"Block Group 3, Census Tract 504.32, Gwinnett County, Georgia",2824,2285,539,80.9135977337,19.0864022663
3395,1500000US131350504331,131350504331,"Block Group 1, Census Tract 504.33, Gwinnett County, Georgia",2337,842,1495,36.0290971331,63.9709028669
3396,1500000US131350504341,131350504341,"Block Group 1, Census Tract 504.34, Gwinnett County, Georgia",2005,403,1602,20.0997506234,79.9002493766
3397,1500000US131350504342,131350504342,"Block Group 2, Census Tract 504.34, Gwinnett County, Georgia",4658,956,3702,20.5238299699,79.4761700301
3398,1500000US131350504343,131350504343,"Block Group 3, Census Tract 504.34, Gwinnett County, Georgia",1251,731,520,58.4332533973,41.5667466027
3399,1500000US131350504351,131350504351,"Block Group 1, Census Tract 504.35, Gwinnett County, Georgia",2451,1385,1066,56.5075479396,43.4924520604
3400,1500000US131350504352,131350504352,"Block Group 2, Census Tract 504.35, Gwinnett County, Georgia",1067,746,321,69.915651359,30.084348641
3401,1500000US131350504361,131350504361,"Block Group 1, Census Tract 504.36, Gwinnett County, Georgia",1351,0,1351,0.0,100.0
3402,1500000US131350504362,131350504362,"Block Group 2, Census Tract 504.36, Gwinnett County, Georgia",1544,925,619,59.9093264249,40.0906735751
3403,1500000US131350504363,131350504363,"Block Group 3, Census Tract 504.36, Gwinnett County, Georgia",1394,717,677,51.4347202296,48.5652797704
3404,1500000US131350504364,131350504364,"Block Group 4, Census Tract 504.36, Gwinnett County, Georgia",856,738,118,86.214953271,13.785046729
3405,1500000US131350504365,131350504365,"Block Group 5, Census Tract 504.36, Gwinnett County, Georgia",1454,802,652,55.1581843191,44.8418156809
3406,1500000US131350505111,131350505111,"Block Group 1, Census Tract 505.11, Gwinnett County, Georgia",2537,2188,349,86.243594797,13.756405203
3407,1500000US131350505112,131350505112,"Block Group 2, Census Tract 505.11, Gwinnett County, Georgia",3386,1796,1590,53.0419373892,46.9580626108
3408,1500000US131350505113,131350505113,"Block Group 3, Census Tract 505.11, Gwinnett County, Georgia",5263,3472,1791,65.9699790994,34.0300209006
3409,1500000US131350505201,131350505201,"Block Group 1, Census Tract 505.20, Gwinnett County, Georgia",1771,1265,506,71.4285714286,28.5714285714
3410,1500000US131350505202,131350505202,"Block Group 2, Census Tract 505.20, Gwinnett County, Georgia",1315,93,1222,7.07224334601,92.927756654
3411,1500000US131350505203,131350505203,"Block Group 3, Census Tract 505.20, Gwinnett County, Georgia",1710,42,1668,2.45614035088,97.5438596491
3412,1500000US131350505211,131350505211,"Block Group 1, Census Tract 505.21, Gwinnett County, Georgia",620,145,475,23.3870967742,76.6129032258
3413,1500000US131350505212,131350505212,"Block Group 2, Census Tract 505.21, Gwinnett County, Georgia",1471,1240,231,84.2963970088,15.7036029912
3414,1500000US131350505213,131350505213,"Block Group 3, Census Tract 505.21, Gwinnett County, Georgia",1952,1309,643,67.0594262295,32.9405737705
3415,1500000US131350505214,131350505214,"Block Group 4, Census Tract 505.21, Gwinnett County, Georgia",1382,187,1195,13.5311143271,86.4688856729
3416,1500000US131350505221,131350505221,"Block Group 1, Census Tract 505.22, Gwinnett County, Georgia",1299,909,390,69.9769053118,30.0230946882
3417,1500000US131350505222,131350505222,"Block Group 2, Census Tract 505.22, Gwinnett County, Georgia",4029,1946,2083,48.2998262596,51.7001737404
3418,1500000US131350505231,131350505231,"Block Group 1, Census Tract 505.23, Gwinnett County, Georgia",3229,371,2858,11.489625271,88.510374729
3419,1500000US131350505232,131350505232,"Block Group 2, Census Tract 505.23, Gwinnett County, Georgia",828,140,688,16.9082125604,83.0917874396
3420,1500000US131350505233,131350505233,"Block Group 3, Census Tract 505.23, Gwinnett County, Georgia",2844,2495,349,87.7285513361,12.2714486639
3421,1500000US131350505241,131350505241,"Block Group 1, Census Tract 505.24, Gwinnett County, Georgia",3164,1124,2040,35.5246523388,64.4753476612
3422,1500000US131350505242,131350505242,"Block Group 2, Census Tract 505.24, Gwinnett County, Georgia",2912,1175,1737,40.3502747253,59.6497252747
3423,1500000US131350505251,131350505251,"Block Group 1, Census Tract 505.25, Gwinnett County, Georgia",2430,1859,571,76.5020576132,23.4979423868
3424,1500000US131350505252,131350505252,"Block Group 2, Census Tract 505.25, Gwinnett County, Georgia",1626,1206,420,74.1697416974,25.8302583026
3425,1500000US131350505253,131350505253,"Block Group 3, Census Tract 505.25, Gwinnett County, Georgia",2677,2522,155,94.2099364961,5.79006350392
3426,1500000US131350505254,131350505254,"Block Group 4, Census Tract 505.25, Gwinnett County, Georgia",1465,1197,268,81.7064846416,18.2935153584
3427,1500000US131350505261,131350505261,"Block Group 1, Census Tract 505.26, Gwinnett County, Georgia",3034,1530,1504,50.4284772577,49.5715227423
3428,1500000US131350505262,131350505262,"Block Group 2, Census Tract 505.26, Gwinnett County, Georgia",1796,417,1379,23.2182628062,76.7817371938
3429,1500000US131350505271,131350505271,"Block Group 1, Census Tract 505.27, Gwinnett County, Georgia",2379,1704,675,71.6267339218,28.3732660782
3430,1500000US131350505272,131350505272,"Block Group 2, Census Tract 505.27, Gwinnett County, Georgia",2239,1734,505,77.445288075,22.554711925
3431,1500000US131350505273,131350505273,"Block Group 3, Census Tract 505.27, Gwinnett County, Georgia",1720,1615,105,93.8953488372,6.10465116279
3432,1500000US131350505281,131350505281,"Block Group 1, Census Tract 505.28, Gwinnett County, Georgia",3367,2897,470,86.040986041,13.959013959
3433,1500000US131350505282,131350505282,"Block Group 2, Census Tract 505.28, Gwinnett County, Georgia",1851,1802,49,97.3527822798,2.64721772015
3434,1500000US131350505291,131350505291,"Block Group 1, Census Tract 505.29, Gwinnett County, Georgia",2487,1833,654,73.7032569361,26.2967430639
3435,1500000US131350505292,131350505292,"Block Group 2, Census Tract 505.29, Gwinnett County, Georgia",1528,1101,427,72.054973822,27.945026178
3436,1500000US131350505301,131350505301,"Block Group 1, Census Tract 505.30, Gwinnett County, Georgia",4076,3551,525,87.1197252208,12.8802747792
3437,1500000US131350505302,131350505302,"Block Group 2, Census Tract 505.30, Gwinnett County, Georgia",1296,1103,193,85.1080246914,14.8919753086
3438,1500000US131350505303,131350505303,"Block Group 3, Census Tract 505.30, Gwinnett County, Georgia",682,559,123,81.9648093842,18.0351906158
3439,1500000US131350505311,131350505311,"Block Group 1, Census Tract 505.31, Gwinnett County, Georgia",2928,1885,1043,64.3784153005,35.6215846995
3440,1500000US131350505312,131350505312,"Block Group 2, Census Tract 505.31, Gwinnett County, Georgia",2252,583,1669,25.8880994671,74.1119005329
3441,1500000US131350505313,131350505313,"Block Group 3, Census Tract 505.31, Gwinnett County, Georgia",3492,2311,1181,66.1798396334,33.8201603666
3442,1500000US131350505321,131350505321,"Block Group 1, Census Tract 505.32, Gwinnett County, Georgia",3842,2307,1535,60.0468505986,39.9531494014
3443,1500000US131350505322,131350505322,"Block Group 2, Census Tract 505.32, Gwinnett County, Georgia",4096,3204,892,78.22265625,21.77734375
3444,1500000US131350505331,131350505331,"Block Group 1, Census Tract 505.33, Gwinnett County, Georgia",1837,1519,318,82.6891671203,17.3108328797
3445,1500000US131350505332,131350505332,"Block Group 2, Census Tract 505.33, Gwinnett County, Georgia",4290,3098,1192,72.2144522145,27.7855477855
3446,1500000US131350505333,131350505333,"Block Group 3, Census Tract 505.33, Gwinnett County, Georgia",1839,769,1070,41.8162044589,58.1837955411
3447,1500000US131350505341,131350505341,"Block Group 1, Census Tract 505.34, Gwinnett County, Georgia",3977,1848,2129,46.4671863213,53.5328136787
3448,1500000US131350505342,131350505342,"Block Group 2, Census Tract 505.34, Gwinnett County, Georgia",2076,1448,628,69.7495183044,30.2504816956
3449,1500000US131350505343,131350505343,"Block Group 3, Census Tract 505.34, Gwinnett County, Georgia",2312,1694,618,73.2698961938,26.7301038062
3450,1500000US131350505351,131350505351,"Block Group 1, Census Tract 505.35, Gwinnett County, Georgia",3055,2726,329,89.2307692308,10.7692307692
3451,1500000US131350505352,131350505352,"Block Group 2, Census Tract 505.35, Gwinnett County, Georgia",4064,2565,1499,63.1151574803,36.8848425197
3452,1500000US131350505361,131350505361,"Block Group 1, Census Tract 505.36, Gwinnett County, Georgia",1522,1382,140,90.8015768725,9.19842312746
3453,1500000US131350505362,131350505362,"Block Group 2, Census Tract 505.36, Gwinnett County, Georgia",1124,768,356,68.3274021352,31.6725978648
3454,1500000US131350505363,131350505363,"Block Group 3, Census Tract 505.36, Gwinnett County, Georgia",2397,1415,982,59.0321234877,40.9678765123
3455,1500000US131350505371,131350505371,"Block Group 1, Census Tract 505.37, Gwinnett County, Georgia",1827,243,1584,13.3004926108,86.6995073892
3456,1500000US131350505372,131350505372,"Block Group 2, Census Tract 505.37, Gwinnett County, Georgia",3008,691,2317,22.9720744681,77.0279255319
3457,1500000US131350505381,131350505381,"Block Group 1, Census Tract 505.38, Gwinnett County, Georgia",2196,2057,139,93.6703096539,6.32969034608
3458,1500000US131350505382,131350505382,"Block Group 2, Census Tract 505.38, Gwinnett County, Georgia",3659,3312,347,90.5165345723,9.48346542771
3459,1500000US131350505383,131350505383,"Block Group 3, Census Tract 505.38, Gwinnett County, Georgia",1983,1653,330,83.3585476551,16.6414523449
3460,1500000US131350505391,131350505391,"Block Group 1, Census Tract 505.39, Gwinnett County, Georgia",3114,828,2286,26.5895953757,73.4104046243
3461,1500000US131350505392,131350505392,"Block Group 2, Census Tract 505.39, Gwinnett County, Georgia",1919,1237,682,64.460656592,35.539343408
3462,1500000US131350505401,131350505401,"Block Group 1, Census Tract 505.40, Gwinnett County, Georgia",2901,996,1905,34.3329886246,65.6670113754
3463,1500000US131350505402,131350505402,"Block Group 2, Census Tract 505.40, Gwinnett County, Georgia",1984,0,1984,0.0,100.0
3464,1500000US131350505403,131350505403,"Block Group 3, Census Tract 505.40, Gwinnett County, Georgia",2159,1877,282,86.9383974062,13.0616025938
3465,1500000US131350505411,131350505411,"Block Group 1, Census Tract 505.41, Gwinnett County, Georgia",2176,16,2160,0.735294117647,99.2647058824
3466,1500000US131350505412,131350505412,"Block Group 2, Census Tract 505.41, Gwinnett County, Georgia",1547,9,1538,0.581771170006,99.41822883
3467,1500000US131350505413,131350505413,"Block Group 3, Census Tract 505.41, Gwinnett County, Georgia",2270,18,2252,0.79295154185,99.2070484581
3468,1500000US131350505421,131350505421,"Block Group 1, Census Tract 505.42, Gwinnett County, Georgia",4793,777,4016,16.2111412477,83.7888587523
3469,1500000US131350505431,131350505431,"Block Group 1, Census Tract 505.43, Gwinnett County, Georgia",3786,2695,1091,71.1833069202,28.8166930798
3470,1500000US131350505432,131350505432,"Block Group 2, Census Tract 505.43, Gwinnett County, Georgia",3337,2953,384,88.4926580761,11.5073419239
3471,1500000US131350505441,131350505441,"Block Group 1, Census Tract 505.44, Gwinnett County, Georgia",4025,3540,485,87.950310559,12.049689441
3472,1500000US131350505442,131350505442,"Block Group 2, Census Tract 505.44, Gwinnett County, Georgia",3506,3151,355,89.8745008557,10.1254991443
3473,1500000US131350505443,131350505443,"Block Group 3, Census Tract 505.44, Gwinnett County, Georgia",4308,2711,1597,62.9294336119,37.0705663881
3474,1500000US131350505451,131350505451,"Block Group 1, Census Tract 505.45, Gwinnett County, Georgia",2692,2044,648,75.9286775632,24.0713224368
3475,1500000US131350505452,131350505452,"Block Group 2, Census Tract 505.45, Gwinnett County, Georgia",4137,3972,165,96.0116026106,3.98839738941
3476,1500000US131350505453,131350505453,"Block Group 3, Census Tract 505.45, Gwinnett County, Georgia",4558,2786,1772,61.1232996928,38.8767003072
3477,1500000US131350505461,131350505461,"Block Group 1, Census Tract 505.46, Gwinnett County, Georgia",10226,9212,1014,90.0840993546,9.91590064541
3478,1500000US131350505462,131350505462,"Block Group 2, Census Tract 505.46, Gwinnett County, Georgia",2949,1564,1385,53.0349270939,46.9650729061
3479,1500000US131350505463,131350505463,"Block Group 3, Census Tract 505.46, Gwinnett County, Georgia",3677,3577,100,97.2803916236,2.71960837639
3480,1500000US131350505471,131350505471,"Block Group 1, Census Tract 505.47, Gwinnett County, Georgia",5168,3938,1230,76.1996904025,23.8003095975
3481,1500000US131350505472,131350505472,"Block Group 2, Census Tract 505.47, Gwinnett County, Georgia",2995,2770,225,92.4874791319,7.51252086811
3482,1500000US131350505481,131350505481,"Block Group 1, Census Tract 505.48, Gwinnett County, Georgia",2419,1430,989,59.1153369161,40.8846630839
3483,1500000US131350505482,131350505482,"Block Group 2, Census Tract 505.48, Gwinnett County, Georgia",2622,2486,136,94.8131197559,5.18688024409
3484,1500000US131350505483,131350505483,"Block Group 3, Census Tract 505.48, Gwinnett County, Georgia",3933,3786,147,96.2623951182,3.73760488177
3485,1500000US131350505491,131350505491,"Block Group 1, Census Tract 505.49, Gwinnett County, Georgia",3726,3222,504,86.4734299517,13.5265700483
3486,1500000US131350505492,131350505492,"Block Group 2, Census Tract 505.49, Gwinnett County, Georgia",1465,1048,417,71.5358361775,28.4641638225
3487,1500000US131350506051,131350506051,"Block Group 1, Census Tract 506.05, Gwinnett County, Georgia",7977,6721,1256,84.2547323555,15.7452676445
3488,1500000US131350506052,131350506052,"Block Group 2, Census Tract 506.05, Gwinnett County, Georgia",2045,1660,385,81.173594132,18.826405868
3489,1500000US131350506053,131350506053,"Block Group 3, Census Tract 506.05, Gwinnett County, Georgia",4473,2612,1861,58.3948133244,41.6051866756
3490,1500000US131350506061,131350506061,"Block Group 1, Census Tract 506.06, Gwinnett County, Georgia",6434,5926,508,92.1044451352,7.89555486478
3491,1500000US131350506062,131350506062,"Block Group 2, Census Tract 506.06, Gwinnett County, Georgia",6115,5381,734,87.996729354,12.003270646
3492,1500000US131350506063,131350506063,"Block Group 3, Census Tract 506.06, Gwinnett County, Georgia",9639,5933,3706,61.5520282187,38.4479717813
3493,1500000US131350506071,131350506071,"Block Group 1, Census Tract 506.07, Gwinnett County, Georgia",10219,7843,2376,76.7491926803,23.2508073197
3494,1500000US131350506072,131350506072,"Block Group 2, Census Tract 506.07, Gwinnett County, Georgia",6940,5654,1286,81.469740634,18.530259366
3495,1500000US131350506081,131350506081,"Block Group 1, Census Tract 506.08, Gwinnett County, Georgia",8285,6666,1619,80.4586602293,19.5413397707
3496,1500000US131350506082,131350506082,"Block Group 2, Census Tract 506.08, Gwinnett County, Georgia",6437,5773,664,89.6846356999,10.3153643001
3497,1500000US131350506083,131350506083,"Block Group 3, Census Tract 506.08, Gwinnett County, Georgia",2633,2310,323,87.7326243828,12.2673756172
3498,1500000US131350506091,131350506091,"Block Group 1, Census Tract 506.09, Gwinnett County, Georgia",2052,1863,189,90.7894736842,9.21052631579
3499,1500000US131350506092,131350506092,"Block Group 2, Census Tract 506.09, Gwinnett County, Georgia",6445,5161,1284,80.077579519,19.922420481
3500,1500000US131350506093,131350506093,"Block Group 3, Census Tract 506.09, Gwinnett County, Georgia",3035,2894,141,95.3542009885,4.64579901153
3501,1500000US131350506101,131350506101,"Block Group 1, Census Tract 506.10, Gwinnett County, Georgia",5186,5089,97,98.1295796375,1.87042036251
3502,1500000US131350506102,131350506102,"Block Group 2, Census Tract 506.10, Gwinnett County, Georgia",4387,3254,1133,74.173695008,25.826304992
3503,1500000US131350506103,131350506103,"Block Group 3, Census Tract 506.10, Gwinnett County, Georgia",3456,3124,332,90.3935185185,9.60648148148
3504,1500000US131350506104,131350506104,"Block Group 4, Census Tract 506.10, Gwinnett County, Georgia",3796,3554,242,93.6248682824,6.3751317176
3505,1500000US131350507091,131350507091,"Block Group 1, Census Tract 507.09, Gwinnett County, Georgia",5528,4210,1318,76.1577424023,23.8422575977
3506,1500000US131350507092,131350507092,"Block Group 2, Census Tract 507.09, Gwinnett County, Georgia",2693,1547,1146,57.4452283698,42.5547716302
3507,1500000US131350507093,131350507093,"Block Group 3, Census Tract 507.09, Gwinnett County, Georgia",4372,3009,1363,68.824336688,31.175663312
3508,1500000US131350507121,131350507121,"Block Group 1, Census Tract 507.12, Gwinnett County, Georgia",1703,1422,281,83.4997064005,16.5002935995
3509,1500000US131350507122,131350507122,"Block Group 2, Census Tract 507.12, Gwinnett County, Georgia",1666,1541,125,92.4969987995,7.50300120048
3510,1500000US131350507123,131350507123,"Block Group 3, Census Tract 507.12, Gwinnett County, Georgia",2054,1849,205,90.0194741967,9.98052580331
3511,1500000US131350507124,131350507124,"Block Group 4, Census Tract 507.12, Gwinnett County, Georgia",1351,1235,116,91.4137675796,8.58623242043
3512,1500000US131350507131,131350507131,"Block Group 1, Census Tract 507.13, Gwinnett County, Georgia",4348,3808,540,87.5804967801,12.4195032199
3513,1500000US131350507132,131350507132,"Block Group 2, Census Tract 507.13, Gwinnett County, Georgia",659,659,0,100.0,0.0
3514,1500000US131350507133,131350507133,"Block Group 3, Census Tract 507.13, Gwinnett County, Georgia",1553,1553,0,100.0,0.0
3515,1500000US131350507134,131350507134,"Block Group 4, Census Tract 507.13, Gwinnett County, Georgia",1092,1057,35,96.7948717949,3.20512820513
3516,1500000US131350507141,131350507141,"Block Group 1, Census Tract 507.14, Gwinnett County, Georgia",2476,2260,216,91.2762520194,8.72374798061
3517,1500000US131350507142,131350507142,"Block Group 2, Census Tract 507.14, Gwinnett County, Georgia",2982,2103,879,70.523138833,29.476861167
3518,1500000US131350507151,131350507151,"Block Group 1, Census Tract 507.15, Gwinnett County, Georgia",2844,1983,861,69.7257383966,30.2742616034
3519,1500000US131350507152,131350507152,"Block Group 2, Census Tract 507.15, Gwinnett County, Georgia",1529,1204,325,78.7442773054,21.2557226946
3520,1500000US131350507153,131350507153,"Block Group 3, Census Tract 507.15, Gwinnett County, Georgia",1432,927,505,64.7346368715,35.2653631285
3521,1500000US131350507181,131350507181,"Block Group 1, Census Tract 507.18, Gwinnett County, Georgia",2334,1681,653,72.0222793488,27.9777206512
3522,1500000US131350507182,131350507182,"Block Group 2, Census Tract 507.18, Gwinnett County, Georgia",2426,2011,415,82.8936521022,17.1063478978
3523,1500000US131350507183,131350507183,"Block Group 3, Census Tract 507.18, Gwinnett County, Georgia",530,469,61,88.4905660377,11.5094339623
3524,1500000US131350507184,131350507184,"Block Group 4, Census Tract 507.18, Gwinnett County, Georgia",2914,2678,236,91.9011667811,8.09883321894
3525,1500000US131350507191,131350507191,"Block Group 1, Census Tract 507.19, Gwinnett County, Georgia",3265,1740,1525,53.2924961715,46.7075038285
3526,1500000US131350507192,131350507192,"Block Group 2, Census Tract 507.19, Gwinnett County, Georgia",2172,608,1564,27.9926335175,72.0073664825
3527,1500000US131350507201,131350507201,"Block Group 1, Census Tract 507.20, Gwinnett County, Georgia",2002,1793,209,89.5604395604,10.4395604396
3528,1500000US131350507202,131350507202,"Block Group 2, Census Tract 507.20, Gwinnett County, Georgia",2677,1929,748,72.0582741875,27.9417258125
3529,1500000US131350507203,131350507203,"Block Group 3, Census Tract 507.20, Gwinnett County, Georgia",1677,1258,419,75.014907573,24.985092427
3530,1500000US131350507204,131350507204,"Block Group 4, Census Tract 507.20, Gwinnett County, Georgia",1522,971,551,63.7976346912,36.2023653088
3531,1500000US131350507211,131350507211,"Block Group 1, Census Tract 507.21, Gwinnett County, Georgia",2968,2456,512,82.7493261456,17.2506738544
3532,1500000US131350507212,131350507212,"Block Group 2, Census Tract 507.21, Gwinnett County, Georgia",813,622,191,76.5067650677,23.4932349323
3533,1500000US131350507213,131350507213,"Block Group 3, Census Tract 507.21, Gwinnett County, Georgia",2637,2125,512,80.5839969662,19.4160030338
3534,1500000US131350507214,131350507214,"Block Group 4, Census Tract 507.21, Gwinnett County, Georgia",3104,3094,10,99.6778350515,0.322164948454
3535,1500000US131350507221,131350507221,"Block Group 1, Census Tract 507.22, Gwinnett County, Georgia",3694,2644,1050,71.5755278831,28.4244721169
3536,1500000US131350507231,131350507231,"Block Group 1, Census Tract 507.23, Gwinnett County, Georgia",1124,873,251,77.6690391459,22.3309608541
3537,1500000US131350507232,131350507232,"Block Group 2, Census Tract 507.23, Gwinnett County, Georgia",3258,2947,311,90.4542664211,9.54573357888
3538,1500000US131350507233,131350507233,"Block Group 3, Census Tract 507.23, Gwinnett County, Georgia",3035,2493,542,82.1416803954,17.8583196046
3539,1500000US131350507241,131350507241,"Block Group 1, Census Tract 507.24, Gwinnett County, Georgia",4711,3039,1672,64.5085969009,35.4914030991
3540,1500000US131350507242,131350507242,"Block Group 2, Census Tract 507.24, Gwinnett County, Georgia",5445,4280,1165,78.6042240588,21.3957759412
3541,1500000US131350507243,131350507243,"Block Group 3, Census Tract 507.24, Gwinnett County, Georgia",5693,4410,1283,77.4635517302,22.5364482698
3542,1500000US131350507251,131350507251,"Block Group 1, Census Tract 507.25, Gwinnett County, Georgia",2455,1862,593,75.8452138493,24.1547861507
3543,1500000US131350507252,131350507252,"Block Group 2, Census Tract 507.25, Gwinnett County, Georgia",2469,1574,895,63.7505062778,36.2494937222
3544,1500000US131350507253,131350507253,"Block Group 3, Census Tract 507.25, Gwinnett County, Georgia",997,858,139,86.0581745236,13.9418254764
3545,1500000US131350507261,131350507261,"Block Group 1, Census Tract 507.26, Gwinnett County, Georgia",4070,3101,969,76.1916461916,23.8083538084
3546,1500000US131350507262,131350507262,"Block Group 2, Census Tract 507.26, Gwinnett County, Georgia",5283,4249,1034,80.4277872421,19.5722127579
3547,1500000US131350507271,131350507271,"Block Group 1, Census Tract 507.27, Gwinnett County, Georgia",2051,1224,827,59.6782057533,40.3217942467
3548,1500000US131350507272,131350507272,"Block Group 2, Census Tract 507.27, Gwinnett County, Georgia",4446,4285,161,96.3787674314,3.6212325686
3549,1500000US131350507273,131350507273,"Block Group 3, Census Tract 507.27, Gwinnett County, Georgia",3993,3896,97,97.5707488104,2.42925118958
3550,1500000US131350507281,131350507281,"Block Group 1, Census Tract 507.28, Gwinnett County, Georgia",5096,4376,720,85.8712715856,14.1287284144
3551,1500000US131350507282,131350507282,"Block Group 2, Census Tract 507.28, Gwinnett County, Georgia",3721,2901,820,77.9629131954,22.0370868046
3552,1500000US131350507283,131350507283,"Block Group 3, Census Tract 507.28, Gwinnett County, Georgia",3011,2314,697,76.8515443374,23.1484556626
3553,1500000US131350507284,131350507284,"Block Group 4, Census Tract 507.28, Gwinnett County, Georgia",1879,1494,385,79.5103778606,20.4896221394
3554,1500000US131350507291,131350507291,"Block Group 1, Census Tract 507.29, Gwinnett County, Georgia",791,507,284,64.0960809102,35.9039190898
3555,1500000US131350507292,131350507292,"Block Group 2, Census Tract 507.29, Gwinnett County, Georgia",2491,1208,1283,48.4945804898,51.5054195102
3556,1500000US131350507301,131350507301,"Block Group 1, Census Tract 507.30, Gwinnett County, Georgia",3827,2079,1748,54.3245361902,45.6754638098
3557,1500000US131350507302,131350507302,"Block Group 2, Census Tract 507.30, Gwinnett County, Georgia",3239,2464,775,76.0728619944,23.9271380056
3558,1500000US131350507311,131350507311,"Block Group 1, Census Tract 507.31, Gwinnett County, Georgia",4948,4725,223,95.4931285368,4.50687146322
3559,1500000US131350507312,131350507312,"Block Group 2, Census Tract 507.31, Gwinnett County, Georgia",4429,3734,695,84.3079701964,15.6920298036
3560,1500000US131370001001,131370001001,"Block Group 1, Census Tract 1, Habersham County, Georgia",1491,1198,293,80.348759222,19.651240778
3561,1500000US131370001002,131370001002,"Block Group 2, Census Tract 1, Habersham County, Georgia",2318,1918,400,82.7437446074,17.2562553926
3562,1500000US131370002011,131370002011,"Block Group 1, Census Tract 2.01, Habersham County, Georgia",1940,1790,150,92.2680412371,7.73195876289
3563,1500000US131370002012,131370002012,"Block Group 2, Census Tract 2.01, Habersham County, Georgia",1967,1729,238,87.9003558719,12.0996441281
3564,1500000US131370002021,131370002021,"Block Group 1, Census Tract 2.02, Habersham County, Georgia",1201,860,341,71.6069941715,28.3930058285
3565,1500000US131370002022,131370002022,"Block Group 2, Census Tract 2.02, Habersham County, Georgia",2130,1893,237,88.8732394366,11.1267605634
3566,1500000US131370002023,131370002023,"Block Group 3, Census Tract 2.02, Habersham County, Georgia",1859,1667,192,89.6718665949,10.3281334051
3567,1500000US131370003001,131370003001,"Block Group 1, Census Tract 3, Habersham County, Georgia",1351,778,573,57.5869726129,42.4130273871
3568,1500000US131370003002,131370003002,"Block Group 2, Census Tract 3, Habersham County, Georgia",1364,876,488,64.2228739003,35.7771260997
3569,1500000US131370003003,131370003003,"Block Group 3, Census Tract 3, Habersham County, Georgia",1165,732,433,62.8326180258,37.1673819742
3570,1500000US131370004001,131370004001,"Block Group 1, Census Tract 4, Habersham County, Georgia",3343,2875,468,86.000598265,13.999401735
3571,1500000US131370004002,131370004002,"Block Group 2, Census Tract 4, Habersham County, Georgia",1190,923,267,77.5630252101,22.4369747899
3572,1500000US131370004003,131370004003,"Block Group 3, Census Tract 4, Habersham County, Georgia",980,760,220,77.5510204082,22.4489795918
3573,1500000US131370005001,131370005001,"Block Group 1, Census Tract 5, Habersham County, Georgia",1801,1449,352,80.4553026097,19.5446973903
3574,1500000US131370005002,131370005002,"Block Group 2, Census Tract 5, Habersham County, Georgia",1693,801,892,47.3124630833,52.6875369167
3575,1500000US131370005003,131370005003,"Block Group 3, Census Tract 5, Habersham County, Georgia",1164,654,510,56.1855670103,43.8144329897
3576,1500000US131370005004,131370005004,"Block Group 4, Census Tract 5, Habersham County, Georgia",537,474,63,88.2681564246,11.7318435754
3577,1500000US131370005005,131370005005,"Block Group 5, Census Tract 5, Habersham County, Georgia",898,645,253,71.8262806236,28.1737193764
3578,1500000US131370006011,131370006011,"Block Group 1, Census Tract 6.01, Habersham County, Georgia",1798,1687,111,93.8264738598,6.17352614016
3579,1500000US131370006012,131370006012,"Block Group 2, Census Tract 6.01, Habersham County, Georgia",1526,1214,312,79.5543905636,20.4456094364
3580,1500000US131370006013,131370006013,"Block Group 3, Census Tract 6.01, Habersham County, Georgia",606,479,127,79.0429042904,20.9570957096
3581,1500000US131370006021,131370006021,"Block Group 1, Census Tract 6.02, Habersham County, Georgia",1235,1119,116,90.6072874494,9.39271255061
3582,1500000US131370006022,131370006022,"Block Group 2, Census Tract 6.02, Habersham County, Georgia",1829,1256,573,68.6714051394,31.3285948606
3583,1500000US131370006023,131370006023,"Block Group 3, Census Tract 6.02, Habersham County, Georgia",2834,1294,1540,45.6598447424,54.3401552576
3584,1500000US131370006024,131370006024,"Block Group 4, Census Tract 6.02, Habersham County, Georgia",1491,428,1063,28.7055667337,71.2944332663
3585,1500000US131370006025,131370006025,"Block Group 5, Census Tract 6.02, Habersham County, Georgia",953,564,389,59.1815320042,40.8184679958
3586,1500000US131390001011,131390001011,"Block Group 1, Census Tract 1.01, Hall County, Georgia",1943,1516,427,78.0236747298,21.9763252702
3587,1500000US131390001012,131390001012,"Block Group 2, Census Tract 1.01, Hall County, Georgia",2642,2036,606,77.0628311885,22.9371688115
3588,1500000US131390001021,131390001021,"Block Group 1, Census Tract 1.02, Hall County, Georgia",2121,1655,466,78.0292314946,21.9707685054
3589,1500000US131390001022,131390001022,"Block Group 2, Census Tract 1.02, Hall County, Georgia",1347,1153,194,85.5976243504,14.4023756496
3590,1500000US131390002011,131390002011,"Block Group 1, Census Tract 2.01, Hall County, Georgia",2057,1360,697,66.1157024793,33.8842975207
3591,1500000US131390002012,131390002012,"Block Group 2, Census Tract 2.01, Hall County, Georgia",1220,957,263,78.4426229508,21.5573770492
3592,1500000US131390002013,131390002013,"Block Group 3, Census Tract 2.01, Hall County, Georgia",2466,1237,1229,50.1622060016,49.8377939984
3593,1500000US131390002031,131390002031,"Block Group 1, Census Tract 2.03, Hall County, Georgia",2204,1671,533,75.8166969147,24.1833030853
3594,1500000US131390002032,131390002032,"Block Group 2, Census Tract 2.03, Hall County, Georgia",2187,2026,161,92.6383173297,7.36168267032
3595,1500000US131390002041,131390002041,"Block Group 1, Census Tract 2.04, Hall County, Georgia",1899,1751,148,92.2064244339,7.79357556609
3596,1500000US131390002042,131390002042,"Block Group 2, Census Tract 2.04, Hall County, Georgia",2088,1439,649,68.9176245211,31.0823754789
3597,1500000US131390003021,131390003021,"Block Group 1, Census Tract 3.02, Hall County, Georgia",1471,958,513,65.1257647859,34.8742352141
3598,1500000US131390003022,131390003022,"Block Group 2, Census Tract 3.02, Hall County, Georgia",2994,2058,936,68.7374749499,31.2625250501
3599,1500000US131390003023,131390003023,"Block Group 3, Census Tract 3.02, Hall County, Georgia",1193,1035,158,86.7560771165,13.2439228835
3600,1500000US131390003024,131390003024,"Block Group 4, Census Tract 3.02, Hall County, Georgia",1194,772,422,64.6566164154,35.3433835846
3601,1500000US131390003031,131390003031,"Block Group 1, Census Tract 3.03, Hall County, Georgia",1948,1121,827,57.546201232,42.453798768
3602,1500000US131390003032,131390003032,"Block Group 2, Census Tract 3.03, Hall County, Georgia",777,417,360,53.667953668,46.332046332
3603,1500000US131390003041,131390003041,"Block Group 1, Census Tract 3.04, Hall County, Georgia",1990,1137,853,57.135678392,42.864321608
3604,1500000US131390003042,131390003042,"Block Group 2, Census Tract 3.04, Hall County, Georgia",1519,1354,165,89.1375905201,10.8624094799
3605,1500000US131390003051,131390003051,"Block Group 1, Census Tract 3.05, Hall County, Georgia",1161,829,332,71.4039621016,28.5960378984
3606,1500000US131390003052,131390003052,"Block Group 2, Census Tract 3.05, Hall County, Georgia",3112,2126,986,68.3161953728,31.6838046272
3607,1500000US131390003053,131390003053,"Block Group 3, Census Tract 3.05, Hall County, Georgia",598,540,58,90.3010033445,9.69899665552
3608,1500000US131390004001,131390004001,"Block Group 1, Census Tract 4, Hall County, Georgia",1884,1441,443,76.4861995754,23.5138004246
3609,1500000US131390004002,131390004002,"Block Group 2, Census Tract 4, Hall County, Georgia",1466,1063,403,72.5102319236,27.4897680764
3610,1500000US131390004003,131390004003,"Block Group 3, Census Tract 4, Hall County, Georgia",1484,1155,329,77.8301886792,22.1698113208
3611,1500000US131390004004,131390004004,"Block Group 4, Census Tract 4, Hall County, Georgia",1872,449,1423,23.985042735,76.014957265
3612,1500000US131390005001,131390005001,"Block Group 1, Census Tract 5, Hall County, Georgia",891,854,37,95.847362514,4.15263748597
3613,1500000US131390005002,131390005002,"Block Group 2, Census Tract 5, Hall County, Georgia",2067,1088,979,52.6366715046,47.3633284954
3614,1500000US131390005003,131390005003,"Block Group 3, Census Tract 5, Hall County, Georgia",499,266,233,53.3066132265,46.6933867735
3615,1500000US131390005004,131390005004,"Block Group 4, Census Tract 5, Hall County, Georgia",2515,1949,566,77.4950298211,22.5049701789
3616,1500000US131390005005,131390005005,"Block Group 5, Census Tract 5, Hall County, Georgia",1111,851,260,76.597659766,23.402340234
3617,1500000US131390006001,131390006001,"Block Group 1, Census Tract 6, Hall County, Georgia",1361,598,763,43.938280676,56.061719324
3618,1500000US131390006002,131390006002,"Block Group 2, Census Tract 6, Hall County, Georgia",2148,1452,696,67.5977653631,32.4022346369
3619,1500000US131390006003,131390006003,"Block Group 3, Census Tract 6, Hall County, Georgia",1937,1062,875,54.8270521425,45.1729478575
3620,1500000US131390007011,131390007011,"Block Group 1, Census Tract 7.01, Hall County, Georgia",2420,1479,941,61.1157024793,38.8842975207
3621,1500000US131390007012,131390007012,"Block Group 2, Census Tract 7.01, Hall County, Georgia",4002,1821,2181,45.5022488756,54.4977511244
3622,1500000US131390007021,131390007021,"Block Group 1, Census Tract 7.02, Hall County, Georgia",3020,2666,354,88.2781456954,11.7218543046
3623,1500000US131390007022,131390007022,"Block Group 2, Census Tract 7.02, Hall County, Georgia",2670,1661,1009,62.2097378277,37.7902621723
3624,1500000US131390008001,131390008001,"Block Group 1, Census Tract 8, Hall County, Georgia",915,490,425,53.5519125683,46.4480874317
3625,1500000US131390008002,131390008002,"Block Group 2, Census Tract 8, Hall County, Georgia",754,252,502,33.4217506631,66.5782493369
3626,1500000US131390008003,131390008003,"Block Group 3, Census Tract 8, Hall County, Georgia",1327,380,947,28.6360211002,71.3639788998
3627,1500000US131390009001,131390009001,"Block Group 1, Census Tract 9, Hall County, Georgia",1188,534,654,44.9494949495,55.0505050505
3628,1500000US131390009002,131390009002,"Block Group 2, Census Tract 9, Hall County, Georgia",1498,816,682,54.4726301736,45.5273698264
3629,1500000US131390009003,131390009003,"Block Group 3, Census Tract 9, Hall County, Georgia",1464,847,617,57.8551912568,42.1448087432
3630,1500000US131390009004,131390009004,"Block Group 4, Census Tract 9, Hall County, Georgia",1048,95,953,9.06488549618,90.9351145038
3631,1500000US131390010021,131390010021,"Block Group 1, Census Tract 10.02, Hall County, Georgia",1231,757,474,61.49471974,38.50528026
3632,1500000US131390010022,131390010022,"Block Group 2, Census Tract 10.02, Hall County, Georgia",2310,1483,827,64.1991341991,35.8008658009
3633,1500000US131390010023,131390010023,"Block Group 3, Census Tract 10.02, Hall County, Georgia",3322,2631,691,79.1992775436,20.8007224564
3634,1500000US131390010031,131390010031,"Block Group 1, Census Tract 10.03, Hall County, Georgia",2537,183,2354,7.21324398896,92.786756011
3635,1500000US131390010032,131390010032,"Block Group 2, Census Tract 10.03, Hall County, Georgia",3219,630,2589,19.5712954334,80.4287045666
3636,1500000US131390010033,131390010033,"Block Group 3, Census Tract 10.03, Hall County, Georgia",860,0,860,0.0,100.0
3637,1500000US131390010041,131390010041,"Block Group 1, Census Tract 10.04, Hall County, Georgia",3205,516,2689,16.0998439938,83.9001560062
3638,1500000US131390011011,131390011011,"Block Group 1, Census Tract 11.01, Hall County, Georgia",1372,84,1288,6.12244897959,93.8775510204
3639,1500000US131390011012,131390011012,"Block Group 2, Census Tract 11.01, Hall County, Georgia",1675,476,1199,28.4179104478,71.5820895522
3640,1500000US131390011013,131390011013,"Block Group 3, Census Tract 11.01, Hall County, Georgia",1448,234,1214,16.1602209945,83.8397790055
3641,1500000US131390011021,131390011021,"Block Group 1, Census Tract 11.02, Hall County, Georgia",4460,2630,1830,58.9686098655,41.0313901345
3642,1500000US131390012011,131390012011,"Block Group 1, Census Tract 12.01, Hall County, Georgia",1651,1326,325,80.3149606299,19.6850393701
3643,1500000US131390012012,131390012012,"Block Group 2, Census Tract 12.01, Hall County, Georgia",2104,422,1682,20.0570342205,79.9429657795
3644,1500000US131390012013,131390012013,"Block Group 3, Census Tract 12.01, Hall County, Georgia",3339,2489,850,74.5432764301,25.4567235699
3645,1500000US131390012021,131390012021,"Block Group 1, Census Tract 12.02, Hall County, Georgia",4632,3186,1446,68.7823834197,31.2176165803
3646,1500000US131390012022,131390012022,"Block Group 2, Census Tract 12.02, Hall County, Georgia",2089,1296,793,62.0392532312,37.9607467688
3647,1500000US131390013011,131390013011,"Block Group 1, Census Tract 13.01, Hall County, Georgia",1972,1934,38,98.0730223124,1.92697768763
3648,1500000US131390013012,131390013012,"Block Group 2, Census Tract 13.01, Hall County, Georgia",1395,1178,217,84.4444444444,15.5555555556
3649,1500000US131390013013,131390013013,"Block Group 3, Census Tract 13.01, Hall County, Georgia",2619,1518,1101,57.9610538373,42.0389461627
3650,1500000US131390013021,131390013021,"Block Group 1, Census Tract 13.02, Hall County, Georgia",2656,2279,377,85.8057228916,14.1942771084
3651,1500000US131390013022,131390013022,"Block Group 2, Census Tract 13.02, Hall County, Georgia",2568,2365,203,92.0950155763,7.90498442368
3652,1500000US131390014021,131390014021,"Block Group 1, Census Tract 14.02, Hall County, Georgia",1013,965,48,95.2615992103,4.73840078973
3653,1500000US131390014022,131390014022,"Block Group 2, Census Tract 14.02, Hall County, Georgia",2114,1926,188,91.1069063387,8.89309366131
3654,1500000US131390014023,131390014023,"Block Group 3, Census Tract 14.02, Hall County, Georgia",2402,2211,191,92.0482930891,7.95170691091
3655,1500000US131390014031,131390014031,"Block Group 1, Census Tract 14.03, Hall County, Georgia",1649,843,806,51.1218920558,48.8781079442
3656,1500000US131390014032,131390014032,"Block Group 2, Census Tract 14.03, Hall County, Georgia",1990,844,1146,42.4120603015,57.5879396985
3657,1500000US131390014041,131390014041,"Block Group 1, Census Tract 14.04, Hall County, Georgia",3635,1951,1684,53.6726272352,46.3273727648
3658,1500000US131390014042,131390014042,"Block Group 2, Census Tract 14.04, Hall County, Georgia",742,214,528,28.8409703504,71.1590296496
3659,1500000US131390014043,131390014043,"Block Group 3, Census Tract 14.04, Hall County, Georgia",815,573,242,70.3067484663,29.6932515337
3660,1500000US131390015011,131390015011,"Block Group 1, Census Tract 15.01, Hall County, Georgia",3026,2834,192,93.6549900859,6.34500991408
3661,1500000US131390015012,131390015012,"Block Group 2, Census Tract 15.01, Hall County, Georgia",1577,947,630,60.0507292327,39.9492707673
3662,1500000US131390015021,131390015021,"Block Group 1, Census Tract 15.02, Hall County, Georgia",2135,1927,208,90.2576112412,9.74238875878
3663,1500000US131390015022,131390015022,"Block Group 2, Census Tract 15.02, Hall County, Georgia",2825,2369,456,83.8584070796,16.1415929204
3664,1500000US131390016031,131390016031,"Block Group 1, Census Tract 16.03, Hall County, Georgia",3067,2696,371,87.9034887512,12.0965112488
3665,1500000US131390016032,131390016032,"Block Group 2, Census Tract 16.03, Hall County, Georgia",2247,1683,564,74.8998664887,25.1001335113
3666,1500000US131390016041,131390016041,"Block Group 1, Census Tract 16.04, Hall County, Georgia",3136,2189,947,69.8022959184,30.1977040816
3667,1500000US131390016042,131390016042,"Block Group 2, Census Tract 16.04, Hall County, Georgia",3589,3134,455,87.3223739203,12.6776260797
3668,1500000US131390016051,131390016051,"Block Group 1, Census Tract 16.05, Hall County, Georgia",1605,1290,315,80.3738317757,19.6261682243
3669,1500000US131390016052,131390016052,"Block Group 2, Census Tract 16.05, Hall County, Georgia",3748,3314,434,88.4204909285,11.5795090715
3670,1500000US131390016061,131390016061,"Block Group 1, Census Tract 16.06, Hall County, Georgia",1573,1337,236,84.9968213605,15.0031786395
3671,1500000US131390016062,131390016062,"Block Group 2, Census Tract 16.06, Hall County, Georgia",2159,517,1642,23.946271422,76.053728578
3672,1500000US131390016071,131390016071,"Block Group 1, Census Tract 16.07, Hall County, Georgia",1569,813,756,51.8164435946,48.1835564054
3673,1500000US131390016072,131390016072,"Block Group 2, Census Tract 16.07, Hall County, Georgia",1853,1691,162,91.2574203994,8.74257960065
3674,1500000US131390016073,131390016073,"Block Group 3, Census Tract 16.07, Hall County, Georgia",1364,1196,168,87.6832844575,12.3167155425
3675,1500000US131390016081,131390016081,"Block Group 1, Census Tract 16.08, Hall County, Georgia",5525,4928,597,89.1945701357,10.8054298643
3676,1500000US131414803001,131414803001,"Block Group 1, Census Tract 4803, Hancock County, Georgia",1823,1745,78,95.7213384531,4.2786615469
3677,1500000US131414803002,131414803002,"Block Group 2, Census Tract 4803, Hancock County, Georgia",472,443,29,93.8559322034,6.14406779661
3678,1500000US131414804001,131414804001,"Block Group 1, Census Tract 4804, Hancock County, Georgia",1298,1113,185,85.7473035439,14.2526964561
3679,1500000US131414804002,131414804002,"Block Group 2, Census Tract 4804, Hancock County, Georgia",452,405,47,89.6017699115,10.3982300885
3680,1500000US131414804003,131414804003,"Block Group 3, Census Tract 4804, Hancock County, Georgia",918,457,461,49.7821350763,50.2178649237
3681,1500000US131414804004,131414804004,"Block Group 4, Census Tract 4804, Hancock County, Georgia",1052,577,475,54.8479087452,45.1520912548
3682,1500000US131414804005,131414804005,"Block Group 5, Census Tract 4804, Hancock County, Georgia",993,468,525,47.1299093656,52.8700906344
3683,1500000US131430101001,131430101001,"Block Group 1, Census Tract 101, Haralson County, Georgia",1871,1412,459,75.4676643506,24.5323356494
3684,1500000US131430101002,131430101002,"Block Group 2, Census Tract 101, Haralson County, Georgia",1514,1277,237,84.3461030383,15.6538969617
3685,1500000US131430102001,131430102001,"Block Group 1, Census Tract 102, Haralson County, Georgia",849,810,39,95.406360424,4.59363957597
3686,1500000US131430102002,131430102002,"Block Group 2, Census Tract 102, Haralson County, Georgia",1937,1775,162,91.6365513681,8.36344863191
3687,1500000US131430102003,131430102003,"Block Group 3, Census Tract 102, Haralson County, Georgia",2631,1545,1086,58.7229190422,41.2770809578
3688,1500000US131430102004,131430102004,"Block Group 4, Census Tract 102, Haralson County, Georgia",782,620,162,79.283887468,20.716112532
3689,1500000US131430103011,131430103011,"Block Group 1, Census Tract 103.01, Haralson County, Georgia",1414,1038,376,73.4087694484,26.5912305516
3690,1500000US131430103012,131430103012,"Block Group 2, Census Tract 103.01, Haralson County, Georgia",1918,1309,609,68.2481751825,31.7518248175
3691,1500000US131430103021,131430103021,"Block Group 1, Census Tract 103.02, Haralson County, Georgia",1484,654,830,44.0700808625,55.9299191375
3692,1500000US131430103022,131430103022,"Block Group 2, Census Tract 103.02, Haralson County, Georgia",1746,1271,475,72.7949599084,27.2050400916
3693,1500000US131430103023,131430103023,"Block Group 3, Census Tract 103.02, Haralson County, Georgia",1634,1071,563,65.5446756426,34.4553243574
3694,1500000US131430103024,131430103024,"Block Group 4, Census Tract 103.02, Haralson County, Georgia",458,369,89,80.5676855895,19.4323144105
3695,1500000US131430103025,131430103025,"Block Group 5, Census Tract 103.02, Haralson County, Georgia",1610,1306,304,81.1180124224,18.8819875776
3696,1500000US131430103026,131430103026,"Block Group 6, Census Tract 103.02, Haralson County, Georgia",613,613,0,100.0,0.0
3697,1500000US131430104001,131430104001,"Block Group 1, Census Tract 104, Haralson County, Georgia",2971,1758,1213,59.171995961,40.828004039
3698,1500000US131430104002,131430104002,"Block Group 2, Census Tract 104, Haralson County, Georgia",2224,1457,767,65.5125899281,34.4874100719
3699,1500000US131430104003,131430104003,"Block Group 3, Census Tract 104, Haralson County, Georgia",2529,1869,660,73.9027283511,26.0972716489
3700,1500000US131451201981,131451201981,"Block Group 1, Census Tract 1201.98, Harris County, Georgia",2181,1374,807,62.9986244842,37.0013755158
3701,1500000US131451201982,131451201982,"Block Group 2, Census Tract 1201.98, Harris County, Georgia",1391,1237,154,88.9288281812,11.0711718188
3702,1500000US131451201983,131451201983,"Block Group 3, Census Tract 1201.98, Harris County, Georgia",575,487,88,84.6956521739,15.3043478261
3703,1500000US131451201984,131451201984,"Block Group 4, Census Tract 1201.98, Harris County, Georgia",986,617,369,62.5760649087,37.4239350913
3704,1500000US131451202001,131451202001,"Block Group 1, Census Tract 1202, Harris County, Georgia",1742,1220,522,70.0344431688,29.9655568312
3705,1500000US131451202002,131451202002,"Block Group 2, Census Tract 1202, Harris County, Georgia",1929,1497,432,77.6049766719,22.3950233281
3706,1500000US131451203001,131451203001,"Block Group 1, Census Tract 1203, Harris County, Georgia",1256,843,413,67.1178343949,32.8821656051
3707,1500000US131451203002,131451203002,"Block Group 2, Census Tract 1203, Harris County, Georgia",1776,1529,247,86.0923423423,13.9076576577
3708,1500000US131451203003,131451203003,"Block Group 3, Census Tract 1203, Harris County, Georgia",2320,1948,372,83.9655172414,16.0344827586
3709,1500000US131451203004,131451203004,"Block Group 4, Census Tract 1203, Harris County, Georgia",872,794,78,91.0550458716,8.94495412844
3710,1500000US131451203005,131451203005,"Block Group 5, Census Tract 1203, Harris County, Georgia",2730,2398,332,87.8388278388,12.1611721612
3711,1500000US131451204011,131451204011,"Block Group 1, Census Tract 1204.01, Harris County, Georgia",2754,2554,200,92.7378358751,7.26216412491
3712,1500000US131451204012,131451204012,"Block Group 2, Census Tract 1204.01, Harris County, Georgia",3748,3430,318,91.51547492,8.48452508004
3713,1500000US131451204021,131451204021,"Block Group 1, Census Tract 1204.02, Harris County, Georgia",1081,815,266,75.3931544866,24.6068455134
3714,1500000US131451204022,131451204022,"Block Group 2, Census Tract 1204.02, Harris County, Georgia",4930,4325,605,87.7281947262,12.2718052738
3715,1500000US131451204023,131451204023,"Block Group 3, Census Tract 1204.02, Harris County, Georgia",2035,1832,203,90.0245700246,9.97542997543
3716,1500000US131479601001,131479601001,"Block Group 1, Census Tract 9601, Hart County, Georgia",1512,1253,259,82.8703703704,17.1296296296
3717,1500000US131479601002,131479601002,"Block Group 2, Census Tract 9601, Hart County, Georgia",833,742,91,89.0756302521,10.9243697479
3718,1500000US131479601003,131479601003,"Block Group 3, Census Tract 9601, Hart County, Georgia",1327,1030,297,77.6186887717,22.3813112283
3719,1500000US131479601004,131479601004,"Block Group 4, Census Tract 9601, Hart County, Georgia",856,383,473,44.7429906542,55.2570093458
3720,1500000US131479601005,131479601005,"Block Group 5, Census Tract 9601, Hart County, Georgia",1152,1125,27,97.65625,2.34375
3721,1500000US131479602001,131479602001,"Block Group 1, Census Tract 9602, Hart County, Georgia",1481,1300,181,87.7785280216,12.2214719784
3722,1500000US131479602002,131479602002,"Block Group 2, Census Tract 9602, Hart County, Georgia",1112,731,381,65.7374100719,34.2625899281
3723,1500000US131479602003,131479602003,"Block Group 3, Census Tract 9602, Hart County, Georgia",723,704,19,97.3720608575,2.62793914246
3724,1500000US131479603001,131479603001,"Block Group 1, Census Tract 9603, Hart County, Georgia",1808,1309,499,72.4004424779,27.5995575221
3725,1500000US131479603002,131479603002,"Block Group 2, Census Tract 9603, Hart County, Georgia",1456,738,718,50.6868131868,49.3131868132
3726,1500000US131479604001,131479604001,"Block Group 1, Census Tract 9604, Hart County, Georgia",1455,988,467,67.9037800687,32.0962199313
3727,1500000US131479604002,131479604002,"Block Group 2, Census Tract 9604, Hart County, Georgia",2156,1635,521,75.8348794063,24.1651205937
3728,1500000US131479604003,131479604003,"Block Group 3, Census Tract 9604, Hart County, Georgia",634,316,318,49.8422712934,50.1577287066
3729,1500000US131479604004,131479604004,"Block Group 4, Census Tract 9604, Hart County, Georgia",919,381,538,41.4581066376,58.5418933624
3730,1500000US131479605001,131479605001,"Block Group 1, Census Tract 9605, Hart County, Georgia",1386,996,390,71.8614718615,28.1385281385
3731,1500000US131479605002,131479605002,"Block Group 2, Census Tract 9605, Hart County, Georgia",1558,1207,351,77.4711168164,22.5288831836
3732,1500000US131479605003,131479605003,"Block Group 3, Census Tract 9605, Hart County, Georgia",892,333,559,37.331838565,62.668161435
3733,1500000US131479605004,131479605004,"Block Group 4, Census Tract 9605, Hart County, Georgia",1442,930,512,64.4937586685,35.5062413315
3734,1500000US131479605005,131479605005,"Block Group 5, Census Tract 9605, Hart County, Georgia",1948,1441,507,73.9733059548,26.0266940452
3735,1500000US131499701001,131499701001,"Block Group 1, Census Tract 9701, Heard County, Georgia",1462,1116,346,76.3337893297,23.6662106703
3736,1500000US131499701002,131499701002,"Block Group 2, Census Tract 9701, Heard County, Georgia",1555,831,724,53.4405144695,46.5594855305
3737,1500000US131499701003,131499701003,"Block Group 3, Census Tract 9701, Heard County, Georgia",1345,995,350,73.9776951673,26.0223048327
3738,1500000US131499702001,131499702001,"Block Group 1, Census Tract 9702, Heard County, Georgia",1882,1290,592,68.5441020191,31.4558979809
3739,1500000US131499702002,131499702002,"Block Group 2, Census Tract 9702, Heard County, Georgia",1259,1048,211,83.2406671962,16.7593328038
3740,1500000US131499702003,131499702003,"Block Group 3, Census Tract 9702, Heard County, Georgia",1052,931,121,88.4980988593,11.5019011407
3741,1500000US131499703001,131499703001,"Block Group 1, Census Tract 9703, Heard County, Georgia",1151,833,318,72.3718505647,27.6281494353
3742,1500000US131499703002,131499703002,"Block Group 2, Census Tract 9703, Heard County, Georgia",1768,1392,376,78.7330316742,21.2669683258
3743,1500000US131510701041,131510701041,"Block Group 1, Census Tract 701.04, Henry County, Georgia",5921,4578,1343,77.3180206046,22.6819793954
3744,1500000US131510701042,131510701042,"Block Group 2, Census Tract 701.04, Henry County, Georgia",2559,2155,404,84.2125830403,15.7874169597
3745,1500000US131510701043,131510701043,"Block Group 3, Census Tract 701.04, Henry County, Georgia",3857,2273,1584,58.9318122893,41.0681877107
3746,1500000US131510701061,131510701061,"Block Group 1, Census Tract 701.06, Henry County, Georgia",3445,2079,1366,60.3483309144,39.6516690856
3747,1500000US131510701062,131510701062,"Block Group 2, Census Tract 701.06, Henry County, Georgia",3035,2226,809,73.3443163097,26.6556836903
3748,1500000US131510701071,131510701071,"Block Group 1, Census Tract 701.07, Henry County, Georgia",2434,2011,423,82.6211996713,17.3788003287
3749,1500000US131510701072,131510701072,"Block Group 2, Census Tract 701.07, Henry County, Georgia",2318,2017,301,87.0146678171,12.9853321829
3750,1500000US131510701073,131510701073,"Block Group 3, Census Tract 701.07, Henry County, Georgia",2425,1916,509,79.0103092784,20.9896907216
3751,1500000US131510701081,131510701081,"Block Group 1, Census Tract 701.08, Henry County, Georgia",3026,2787,239,92.101784534,7.89821546596
3752,1500000US131510701082,131510701082,"Block Group 2, Census Tract 701.08, Henry County, Georgia",2139,1342,797,62.739597943,37.260402057
3753,1500000US131510701091,131510701091,"Block Group 1, Census Tract 701.09, Henry County, Georgia",2183,2065,118,94.5945945946,5.40540540541
3754,1500000US131510701092,131510701092,"Block Group 2, Census Tract 701.09, Henry County, Georgia",1427,1077,350,75.4730203224,24.5269796776
3755,1500000US131510701101,131510701101,"Block Group 1, Census Tract 701.10, Henry County, Georgia",1770,1164,606,65.7627118644,34.2372881356
3756,1500000US131510701102,131510701102,"Block Group 2, Census Tract 701.10, Henry County, Georgia",3080,2937,143,95.3571428571,4.64285714286
3757,1500000US131510701103,131510701103,"Block Group 3, Census Tract 701.10, Henry County, Georgia",2680,2436,244,90.8955223881,9.10447761194
3758,1500000US131510701111,131510701111,"Block Group 1, Census Tract 701.11, Henry County, Georgia",3174,1313,1861,41.3673597984,58.6326402016
3759,1500000US131510701112,131510701112,"Block Group 2, Census Tract 701.11, Henry County, Georgia",3363,2553,810,75.9143621766,24.0856378234
3760,1500000US131510701113,131510701113,"Block Group 3, Census Tract 701.11, Henry County, Georgia",2416,1820,596,75.3311258278,24.6688741722
3761,1500000US131510701131,131510701131,"Block Group 1, Census Tract 701.13, Henry County, Georgia",1721,1317,404,76.5252760023,23.4747239977
3762,1500000US131510701132,131510701132,"Block Group 2, Census Tract 701.13, Henry County, Georgia",2112,1025,1087,48.5321969697,51.4678030303
3763,1500000US131510701141,131510701141,"Block Group 1, Census Tract 701.14, Henry County, Georgia",2733,1383,1350,50.6037321625,49.3962678375
3764,1500000US131510701142,131510701142,"Block Group 2, Census Tract 701.14, Henry County, Georgia",2514,342,2172,13.6038186158,86.3961813842
3765,1500000US131510702021,131510702021,"Block Group 1, Census Tract 702.02, Henry County, Georgia",3235,3104,131,95.9505409583,4.04945904173
3766,1500000US131510702022,131510702022,"Block Group 2, Census Tract 702.02, Henry County, Georgia",4274,3862,412,90.3603182031,9.63968179691
3767,1500000US131510702023,131510702023,"Block Group 3, Census Tract 702.02, Henry County, Georgia",3269,3089,180,94.4937289691,5.5062710309
3768,1500000US131510702031,131510702031,"Block Group 1, Census Tract 702.03, Henry County, Georgia",4820,4310,510,89.4190871369,10.5809128631
3769,1500000US131510702032,131510702032,"Block Group 2, Census Tract 702.03, Henry County, Georgia",4964,3751,1213,75.5640612409,24.4359387591
3770,1500000US131510702033,131510702033,"Block Group 3, Census Tract 702.03, Henry County, Georgia",4768,4035,733,84.6266778523,15.3733221477
3771,1500000US131510702041,131510702041,"Block Group 1, Census Tract 702.04, Henry County, Georgia",2490,2208,282,88.6746987952,11.3253012048
3772,1500000US131510702042,131510702042,"Block Group 2, Census Tract 702.04, Henry County, Georgia",2000,1778,222,88.9,11.1
3773,1500000US131510702051,131510702051,"Block Group 1, Census Tract 702.05, Henry County, Georgia",2844,2297,547,80.7665260197,19.2334739803
3774,1500000US131510702052,131510702052,"Block Group 2, Census Tract 702.05, Henry County, Georgia",3752,2223,1529,59.2484008529,40.7515991471
3775,1500000US131510702053,131510702053,"Block Group 3, Census Tract 702.05, Henry County, Georgia",4452,2918,1534,65.5435759209,34.4564240791
3776,1500000US131510703041,131510703041,"Block Group 1, Census Tract 703.04, Henry County, Georgia",2462,708,1754,28.7571080422,71.2428919578
3777,1500000US131510703042,131510703042,"Block Group 2, Census Tract 703.04, Henry County, Georgia",3373,1692,1681,50.1630595909,49.8369404091
3778,1500000US131510703043,131510703043,"Block Group 3, Census Tract 703.04, Henry County, Georgia",5216,2876,2340,55.1380368098,44.8619631902
3779,1500000US131510703051,131510703051,"Block Group 1, Census Tract 703.05, Henry County, Georgia",4869,4463,406,91.6615321421,8.33846785788
3780,1500000US131510703052,131510703052,"Block Group 2, Census Tract 703.05, Henry County, Georgia",2595,2387,208,91.9845857418,8.01541425819
3781,1500000US131510703053,131510703053,"Block Group 3, Census Tract 703.05, Henry County, Georgia",1923,1704,219,88.6115444618,11.3884555382
3782,1500000US131510703061,131510703061,"Block Group 1, Census Tract 703.06, Henry County, Georgia",9651,6053,3598,62.7188892343,37.2811107657
3783,1500000US131510703071,131510703071,"Block Group 1, Census Tract 703.07, Henry County, Georgia",4432,3310,1122,74.6841155235,25.3158844765
3784,1500000US131510703091,131510703091,"Block Group 1, Census Tract 703.09, Henry County, Georgia",3186,2256,930,70.8097928437,29.1902071563
3785,1500000US131510703092,131510703092,"Block Group 2, Census Tract 703.09, Henry County, Georgia",4143,3701,442,89.3314023654,10.6685976346
3786,1500000US131510703101,131510703101,"Block Group 1, Census Tract 703.10, Henry County, Georgia",1735,1509,226,86.9740634006,13.0259365994
3787,1500000US131510703102,131510703102,"Block Group 2, Census Tract 703.10, Henry County, Georgia",1267,925,342,73.0071033938,26.9928966062
3788,1500000US131510703103,131510703103,"Block Group 3, Census Tract 703.10, Henry County, Georgia",879,571,308,64.960182025,35.039817975
3789,1500000US131510703111,131510703111,"Block Group 1, Census Tract 703.11, Henry County, Georgia",2918,389,2529,13.3310486635,86.6689513365
3790,1500000US131510703112,131510703112,"Block Group 2, Census Tract 703.11, Henry County, Georgia",4261,2164,2097,50.7862004224,49.2137995776
3791,1500000US131510703113,131510703113,"Block Group 3, Census Tract 703.11, Henry County, Georgia",5213,2088,3125,40.0537118742,59.9462881258
3792,1500000US131510704021,131510704021,"Block Group 1, Census Tract 704.02, Henry County, Georgia",4978,3823,1155,76.7979108076,23.2020891924
3793,1500000US131510704022,131510704022,"Block Group 2, Census Tract 704.02, Henry County, Georgia",3877,3378,499,87.1292236265,12.8707763735
3794,1500000US131510704023,131510704023,"Block Group 3, Census Tract 704.02, Henry County, Georgia",3111,2895,216,93.0568948891,6.9431051109
3795,1500000US131510704031,131510704031,"Block Group 1, Census Tract 704.03, Henry County, Georgia",3825,3395,430,88.7581699346,11.2418300654
3796,1500000US131510704032,131510704032,"Block Group 2, Census Tract 704.03, Henry County, Georgia",3634,2356,1278,64.8321408916,35.1678591084
3797,1500000US131510704033,131510704033,"Block Group 3, Census Tract 704.03, Henry County, Georgia",3203,2845,358,88.8229784577,11.1770215423
3798,1500000US131510704041,131510704041,"Block Group 1, Census Tract 704.04, Henry County, Georgia",3264,2453,811,75.1531862745,24.8468137255
3799,1500000US131510704042,131510704042,"Block Group 2, Census Tract 704.04, Henry County, Georgia",2854,1586,1268,55.5711282411,44.4288717589
3800,1500000US131510704043,131510704043,"Block Group 3, Census Tract 704.04, Henry County, Georgia",1078,818,260,75.8812615955,24.1187384045
3801,1500000US131510705011,131510705011,"Block Group 1, Census Tract 705.01, Henry County, Georgia",5716,3759,1957,65.7627711686,34.2372288314
3802,1500000US131510705012,131510705012,"Block Group 2, Census Tract 705.01, Henry County, Georgia",1653,705,948,42.6497277677,57.3502722323
3803,1500000US131510705021,131510705021,"Block Group 1, Census Tract 705.02, Henry County, Georgia",4194,3384,810,80.686695279,19.313304721
3804,1500000US131510705022,131510705022,"Block Group 2, Census Tract 705.02, Henry County, Georgia",8707,7753,954,89.0432984955,10.9567015045
3805,1500000US131510705023,131510705023,"Block Group 3, Census Tract 705.02, Henry County, Georgia",1126,1106,20,98.2238010657,1.77619893428
3806,1500000US131530201051,131530201051,"Block Group 1, Census Tract 201.05, Houston County, Georgia",2110,958,1152,45.4028436019,54.5971563981
3807,1500000US131530201052,131530201052,"Block Group 2, Census Tract 201.05, Houston County, Georgia",2041,736,1305,36.0607545321,63.9392454679
3808,1500000US131530201053,131530201053,"Block Group 3, Census Tract 201.05, Houston County, Georgia",1904,1525,379,80.0945378151,19.9054621849
3809,1500000US131530201061,131530201061,"Block Group 1, Census Tract 201.06, Houston County, Georgia",3109,2408,701,77.4525570923,22.5474429077
3810,1500000US131530201081,131530201081,"Block Group 1, Census Tract 201.08, Houston County, Georgia",1858,980,878,52.7448869752,47.2551130248
3811,1500000US131530201082,131530201082,"Block Group 2, Census Tract 201.08, Houston County, Georgia",2307,1189,1118,51.5387949718,48.4612050282
3812,1500000US131530201083,131530201083,"Block Group 3, Census Tract 201.08, Houston County, Georgia",1820,1211,609,66.5384615385,33.4615384615
3813,1500000US131530201091,131530201091,"Block Group 1, Census Tract 201.09, Houston County, Georgia",5023,3109,1914,61.8952817042,38.1047182958
3814,1500000US131530201092,131530201092,"Block Group 2, Census Tract 201.09, Houston County, Georgia",4068,2474,1594,60.8161258604,39.1838741396
3815,1500000US131530202001,131530202001,"Block Group 1, Census Tract 202, Houston County, Georgia",1538,506,1032,32.899869961,67.100130039
3816,1500000US131530202002,131530202002,"Block Group 2, Census Tract 202, Houston County, Georgia",840,538,302,64.0476190476,35.9523809524
3817,1500000US131530202003,131530202003,"Block Group 3, Census Tract 202, Houston County, Georgia",1702,922,780,54.1715628672,45.8284371328
3818,1500000US131530202004,131530202004,"Block Group 4, Census Tract 202, Houston County, Georgia",1194,743,451,62.2278056951,37.7721943049
3819,1500000US131530203001,131530203001,"Block Group 1, Census Tract 203, Houston County, Georgia",390,20,370,5.12820512821,94.8717948718
3820,1500000US131530203002,131530203002,"Block Group 2, Census Tract 203, Houston County, Georgia",1520,431,1089,28.3552631579,71.6447368421
3821,1500000US131530203003,131530203003,"Block Group 3, Census Tract 203, Houston County, Georgia",1372,138,1234,10.0583090379,89.9416909621
3822,1500000US131530203004,131530203004,"Block Group 4, Census Tract 203, Houston County, Georgia",2566,1058,1508,41.2314886984,58.7685113016
3823,1500000US131530203005,131530203005,"Block Group 5, Census Tract 203, Houston County, Georgia",626,195,431,31.1501597444,68.8498402556
3824,1500000US131530204001,131530204001,"Block Group 1, Census Tract 204, Houston County, Georgia",1075,506,569,47.0697674419,52.9302325581
3825,1500000US131530204002,131530204002,"Block Group 2, Census Tract 204, Houston County, Georgia",2192,409,1783,18.6587591241,81.3412408759
3826,1500000US131530206001,131530206001,"Block Group 1, Census Tract 206, Houston County, Georgia",830,0,830,0.0,100.0
3827,1500000US131530206002,131530206002,"Block Group 2, Census Tract 206, Houston County, Georgia",238,4,234,1.68067226891,98.3193277311
3828,1500000US131530207001,131530207001,"Block Group 1, Census Tract 207, Houston County, Georgia",1273,267,1006,20.9740769835,79.0259230165
3829,1500000US131530207002,131530207002,"Block Group 2, Census Tract 207, Houston County, Georgia",1144,161,983,14.0734265734,85.9265734266
3830,1500000US131530207003,131530207003,"Block Group 3, Census Tract 207, Houston County, Georgia",968,352,616,36.3636363636,63.6363636364
3831,1500000US131530208001,131530208001,"Block Group 1, Census Tract 208, Houston County, Georgia",1364,0,1364,0.0,100.0
3832,1500000US131530208002,131530208002,"Block Group 2, Census Tract 208, Houston County, Georgia",1048,395,653,37.6908396947,62.3091603053
3833,1500000US131530209001,131530209001,"Block Group 1, Census Tract 209, Houston County, Georgia",995,805,190,80.9045226131,19.0954773869
3834,1500000US131530209002,131530209002,"Block Group 2, Census Tract 209, Houston County, Georgia",1626,948,678,58.3025830258,41.6974169742
3835,1500000US131530209003,131530209003,"Block Group 3, Census Tract 209, Houston County, Georgia",915,456,459,49.8360655738,50.1639344262
3836,1500000US131530209004,131530209004,"Block Group 4, Census Tract 209, Houston County, Georgia",723,523,200,72.3374827109,27.6625172891
3837,1500000US131530210001,131530210001,"Block Group 1, Census Tract 210, Houston County, Georgia",1525,1084,441,71.0819672131,28.9180327869
3838,1500000US131530210002,131530210002,"Block Group 2, Census Tract 210, Houston County, Georgia",1655,830,825,50.1510574018,49.8489425982
3839,1500000US131530210003,131530210003,"Block Group 3, Census Tract 210, Houston County, Georgia",1708,716,992,41.9203747073,58.0796252927
3840,1500000US131530210004,131530210004,"Block Group 4, Census Tract 210, Houston County, Georgia",2157,1599,558,74.1307371349,25.8692628651
3841,1500000US131530211031,131530211031,"Block Group 1, Census Tract 211.03, Houston County, Georgia",2713,2405,308,88.6472539624,11.3527460376
3842,1500000US131530211032,131530211032,"Block Group 2, Census Tract 211.03, Houston County, Georgia",2735,1893,842,69.2138939671,30.7861060329
3843,1500000US131530211033,131530211033,"Block Group 3, Census Tract 211.03, Houston County, Georgia",5061,4624,437,91.3653428176,8.63465718238
3844,1500000US131530211034,131530211034,"Block Group 4, Census Tract 211.03, Houston County, Georgia",552,514,38,93.115942029,6.88405797101
3845,1500000US131530211041,131530211041,"Block Group 1, Census Tract 211.04, Houston County, Georgia",708,229,479,32.3446327684,67.6553672316
3846,1500000US131530211042,131530211042,"Block Group 2, Census Tract 211.04, Houston County, Georgia",3301,1884,1417,57.0736140563,42.9263859437
3847,1500000US131530211043,131530211043,"Block Group 3, Census Tract 211.04, Houston County, Georgia",1304,1124,180,86.1963190184,13.8036809816
3848,1500000US131530211044,131530211044,"Block Group 4, Census Tract 211.04, Houston County, Georgia",1415,893,522,63.109540636,36.890459364
3849,1500000US131530211045,131530211045,"Block Group 5, Census Tract 211.04, Houston County, Georgia",650,375,275,57.6923076923,42.3076923077
3850,1500000US131530211051,131530211051,"Block Group 1, Census Tract 211.05, Houston County, Georgia",1252,128,1124,10.2236421725,89.7763578275
3851,1500000US131530211052,131530211052,"Block Group 2, Census Tract 211.05, Houston County, Georgia",3048,1477,1571,48.4580052493,51.5419947507
3852,1500000US131530211053,131530211053,"Block Group 3, Census Tract 211.05, Houston County, Georgia",1236,358,878,28.9644012945,71.0355987055
3853,1500000US131530211054,131530211054,"Block Group 4, Census Tract 211.05, Houston County, Georgia",1225,555,670,45.306122449,54.693877551
3854,1500000US131530211071,131530211071,"Block Group 1, Census Tract 211.07, Houston County, Georgia",1213,1032,181,85.0783182193,14.9216817807
3855,1500000US131530211072,131530211072,"Block Group 2, Census Tract 211.07, Houston County, Georgia",3231,1782,1449,55.1532033426,44.8467966574
3856,1500000US131530211073,131530211073,"Block Group 3, Census Tract 211.07, Houston County, Georgia",1619,1561,58,96.4175416924,3.5824583076
3857,1500000US131530211074,131530211074,"Block Group 4, Census Tract 211.07, Houston County, Georgia",2623,2075,548,79.107891727,20.892108273
3858,1500000US131530211081,131530211081,"Block Group 1, Census Tract 211.08, Houston County, Georgia",4507,3788,719,84.047037941,15.952962059
3859,1500000US131530211082,131530211082,"Block Group 2, Census Tract 211.08, Houston County, Georgia",1682,1066,616,63.3769322235,36.6230677765
3860,1500000US131530211131,131530211131,"Block Group 1, Census Tract 211.13, Houston County, Georgia",4957,4841,116,97.6598749243,2.34012507565
3861,1500000US131530211132,131530211132,"Block Group 2, Census Tract 211.13, Houston County, Georgia",9813,8515,1298,86.7726485275,13.2273514725
3862,1500000US131530211133,131530211133,"Block Group 3, Census Tract 211.13, Houston County, Georgia",2471,2471,0,100.0,0.0
3863,1500000US131530212011,131530212011,"Block Group 1, Census Tract 212.01, Houston County, Georgia",7113,5434,1679,76.3953324898,23.6046675102
3864,1500000US131530212012,131530212012,"Block Group 2, Census Tract 212.01, Houston County, Georgia",990,893,97,90.202020202,9.79797979798
3865,1500000US131530212021,131530212021,"Block Group 1, Census Tract 212.02, Houston County, Georgia",1387,652,735,47.0079307859,52.9920692141
3866,1500000US131530212022,131530212022,"Block Group 2, Census Tract 212.02, Houston County, Georgia",1294,459,835,35.4714064915,64.5285935085
3867,1500000US131530212023,131530212023,"Block Group 3, Census Tract 212.02, Houston County, Georgia",3041,2447,594,80.4669516606,19.5330483394
3868,1500000US131530212024,131530212024,"Block Group 4, Census Tract 212.02, Houston County, Georgia",546,404,142,73.9926739927,26.0073260073
3869,1500000US131530213001,131530213001,"Block Group 1, Census Tract 213, Houston County, Georgia",1372,980,392,71.4285714286,28.5714285714
3870,1500000US131530213002,131530213002,"Block Group 2, Census Tract 213, Houston County, Georgia",494,209,285,42.3076923077,57.6923076923
3871,1500000US131530213003,131530213003,"Block Group 3, Census Tract 213, Houston County, Georgia",1010,755,255,74.7524752475,25.2475247525
3872,1500000US131530213004,131530213004,"Block Group 4, Census Tract 213, Houston County, Georgia",1498,702,796,46.8624833111,53.1375166889
3873,1500000US131530214001,131530214001,"Block Group 1, Census Tract 214, Houston County, Georgia",1774,1565,209,88.2187147689,11.7812852311
3874,1500000US131530214002,131530214002,"Block Group 2, Census Tract 214, Houston County, Georgia",964,624,340,64.7302904564,35.2697095436
3875,1500000US131530214003,131530214003,"Block Group 3, Census Tract 214, Houston County, Georgia",1201,451,750,37.5520399667,62.4479600333
3876,1500000US131530214004,131530214004,"Block Group 4, Census Tract 214, Houston County, Georgia",4378,3299,1079,75.354042942,24.645957058
3877,1500000US131530215001,131530215001,"Block Group 1, Census Tract 215, Houston County, Georgia",1088,904,184,83.0882352941,16.9117647059
3878,1500000US131530215002,131530215002,"Block Group 2, Census Tract 215, Houston County, Georgia",1773,1472,301,83.0231246475,16.9768753525
3879,1500000US131530215003,131530215003,"Block Group 3, Census Tract 215, Houston County, Georgia",1337,1089,248,81.4510097233,18.5489902767
3880,1500000US131559501001,131559501001,"Block Group 1, Census Tract 9501, Irwin County, Georgia",1308,1208,100,92.3547400612,7.64525993884
3881,1500000US131559501002,131559501002,"Block Group 2, Census Tract 9501, Irwin County, Georgia",1114,803,311,72.0825852783,27.9174147217
3882,1500000US131559502001,131559502001,"Block Group 1, Census Tract 9502, Irwin County, Georgia",721,405,316,56.1719833564,43.8280166436
3883,1500000US131559502002,131559502002,"Block Group 2, Census Tract 9502, Irwin County, Georgia",1279,817,462,63.8780297107,36.1219702893
3884,1500000US131559502003,131559502003,"Block Group 3, Census Tract 9502, Irwin County, Georgia",631,418,213,66.2440570523,33.7559429477
3885,1500000US131559502004,131559502004,"Block Group 4, Census Tract 9502, Irwin County, Georgia",1324,1015,309,76.6616314199,23.3383685801
3886,1500000US131559502005,131559502005,"Block Group 5, Census Tract 9502, Irwin County, Georgia",1734,1342,392,77.3933102653,22.6066897347
3887,1500000US131559502006,131559502006,"Block Group 6, Census Tract 9502, Irwin County, Georgia",739,512,227,69.2828146143,30.7171853857
3888,1500000US131570101011,131570101011,"Block Group 1, Census Tract 101.01, Jackson County, Georgia",2809,2617,192,93.1648273407,6.83517265931
3889,1500000US131570101012,131570101012,"Block Group 2, Census Tract 101.01, Jackson County, Georgia",2652,1862,790,70.2111613876,29.7888386124
3890,1500000US131570101021,131570101021,"Block Group 1, Census Tract 101.02, Jackson County, Georgia",2708,2258,450,83.3825701625,16.6174298375
3891,1500000US131570101022,131570101022,"Block Group 2, Census Tract 101.02, Jackson County, Georgia",4241,3992,249,94.1287432209,5.87125677906
3892,1500000US131570101031,131570101031,"Block Group 1, Census Tract 101.03, Jackson County, Georgia",3676,2921,755,79.4613710555,20.5386289445
3893,1500000US131570101032,131570101032,"Block Group 2, Census Tract 101.03, Jackson County, Georgia",1756,1489,267,84.7949886105,15.2050113895
3894,1500000US131570102001,131570102001,"Block Group 1, Census Tract 102, Jackson County, Georgia",2533,1669,864,65.8902487169,34.1097512831
3895,1500000US131570102002,131570102002,"Block Group 2, Census Tract 102, Jackson County, Georgia",2433,2144,289,88.1216605014,11.8783394986
3896,1500000US131570103001,131570103001,"Block Group 1, Census Tract 103, Jackson County, Georgia",941,554,387,58.8735387885,41.1264612115
3897,1500000US131570103002,131570103002,"Block Group 2, Census Tract 103, Jackson County, Georgia",987,399,588,40.4255319149,59.5744680851
3898,1500000US131570103003,131570103003,"Block Group 3, Census Tract 103, Jackson County, Georgia",2301,1323,978,57.4967405476,42.5032594524
3899,1500000US131570104001,131570104001,"Block Group 1, Census Tract 104, Jackson County, Georgia",1340,667,673,49.776119403,50.223880597
3900,1500000US131570104002,131570104002,"Block Group 2, Census Tract 104, Jackson County, Georgia",1199,768,431,64.0533778148,35.9466221852
3901,1500000US131570104003,131570104003,"Block Group 3, Census Tract 104, Jackson County, Georgia",904,708,196,78.3185840708,21.6814159292
3902,1500000US131570104004,131570104004,"Block Group 4, Census Tract 104, Jackson County, Georgia",1269,694,575,54.6887312845,45.3112687155
3903,1500000US131570105001,131570105001,"Block Group 1, Census Tract 105, Jackson County, Georgia",624,495,129,79.3269230769,20.6730769231
3904,1500000US131570105002,131570105002,"Block Group 2, Census Tract 105, Jackson County, Georgia",2037,1616,421,79.3323514973,20.6676485027
3905,1500000US131570105003,131570105003,"Block Group 3, Census Tract 105, Jackson County, Georgia",2619,2316,303,88.43069874,11.56930126
3906,1500000US131570106001,131570106001,"Block Group 1, Census Tract 106, Jackson County, Georgia",1804,1051,753,58.2594235033,41.7405764967
3907,1500000US131570106002,131570106002,"Block Group 2, Census Tract 106, Jackson County, Georgia",1623,1134,489,69.8706099815,30.1293900185
3908,1500000US131570106003,131570106003,"Block Group 3, Census Tract 106, Jackson County, Georgia",1737,1405,332,80.8865860679,19.1134139321
3909,1500000US131570106004,131570106004,"Block Group 4, Census Tract 106, Jackson County, Georgia",1849,1541,308,83.3423472147,16.6576527853
3910,1500000US131570106005,131570106005,"Block Group 5, Census Tract 106, Jackson County, Georgia",1620,1136,484,70.1234567901,29.8765432099
3911,1500000US131570107011,131570107011,"Block Group 1, Census Tract 107.01, Jackson County, Georgia",1248,932,316,74.6794871795,25.3205128205
3912,1500000US131570107012,131570107012,"Block Group 2, Census Tract 107.01, Jackson County, Georgia",705,561,144,79.5744680851,20.4255319149
3913,1500000US131570107021,131570107021,"Block Group 1, Census Tract 107.02, Jackson County, Georgia",3021,2691,330,89.0764647468,10.9235352532
3914,1500000US131570107022,131570107022,"Block Group 2, Census Tract 107.02, Jackson County, Georgia",3217,2052,1165,63.7861361517,36.2138638483
3915,1500000US131570107023,131570107023,"Block Group 3, Census Tract 107.02, Jackson County, Georgia",3499,2905,594,83.0237210632,16.9762789368
3916,1500000US131570107031,131570107031,"Block Group 1, Census Tract 107.03, Jackson County, Georgia",3342,3041,301,90.9934171155,9.0065828845
3917,1500000US131590101001,131590101001,"Block Group 1, Census Tract 101, Jasper County, Georgia",2374,1880,494,79.1912384162,20.8087615838
3918,1500000US131590102001,131590102001,"Block Group 1, Census Tract 102, Jasper County, Georgia",2722,2086,636,76.6348273328,23.3651726672
3919,1500000US131590105001,131590105001,"Block Group 1, Census Tract 105, Jasper County, Georgia",1154,976,178,84.575389948,15.424610052
3920,1500000US131590105002,131590105002,"Block Group 2, Census Tract 105, Jasper County, Georgia",869,577,292,66.3981588032,33.6018411968
3921,1500000US131590105003,131590105003,"Block Group 3, Census Tract 105, Jasper County, Georgia",3311,2576,735,77.8012684989,22.1987315011
3922,1500000US131590105004,131590105004,"Block Group 4, Census Tract 105, Jasper County, Georgia",1699,781,918,45.968216598,54.031783402
3923,1500000US131590105005,131590105005,"Block Group 5, Census Tract 105, Jasper County, Georgia",1364,906,458,66.42228739,33.57771261
3924,1500000US131619601001,131619601001,"Block Group 1, Census Tract 9601, Jeff Davis County, Georgia",1746,1659,87,95.0171821306,4.98281786942
3925,1500000US131619601002,131619601002,"Block Group 2, Census Tract 9601, Jeff Davis County, Georgia",959,860,99,89.6767466111,10.3232533889
3926,1500000US131619601003,131619601003,"Block Group 3, Census Tract 9601, Jeff Davis County, Georgia",1147,841,306,73.3217088056,26.6782911944
3927,1500000US131619601004,131619601004,"Block Group 4, Census Tract 9601, Jeff Davis County, Georgia",1181,627,554,53.0906011854,46.9093988146
3928,1500000US131619601005,131619601005,"Block Group 5, Census Tract 9601, Jeff Davis County, Georgia",1478,968,510,65.4939106901,34.5060893099
3929,1500000US131619602001,131619602001,"Block Group 1, Census Tract 9602, Jeff Davis County, Georgia",1399,1227,172,87.7055039314,12.2944960686
3930,1500000US131619602002,131619602002,"Block Group 2, Census Tract 9602, Jeff Davis County, Georgia",2311,1684,627,72.8688879273,27.1311120727
3931,1500000US131619602003,131619602003,"Block Group 3, Census Tract 9602, Jeff Davis County, Georgia",881,748,133,84.9035187287,15.0964812713
3932,1500000US131619602004,131619602004,"Block Group 4, Census Tract 9602, Jeff Davis County, Georgia",1919,934,985,48.6711829078,51.3288170922
3933,1500000US131619603001,131619603001,"Block Group 1, Census Tract 9603, Jeff Davis County, Georgia",1014,761,253,75.0493096647,24.9506903353
3934,1500000US131619603002,131619603002,"Block Group 2, Census Tract 9603, Jeff Davis County, Georgia",831,650,181,78.2190132371,21.7809867629
3935,1500000US131639601001,131639601001,"Block Group 1, Census Tract 9601, Jefferson County, Georgia",1193,823,370,68.9857502096,31.0142497904
3936,1500000US131639601002,131639601002,"Block Group 2, Census Tract 9601, Jefferson County, Georgia",511,447,64,87.4755381605,12.5244618395
3937,1500000US131639601003,131639601003,"Block Group 3, Census Tract 9601, Jefferson County, Georgia",780,360,420,46.1538461538,53.8461538462
3938,1500000US131639601004,131639601004,"Block Group 4, Census Tract 9601, Jefferson County, Georgia",1154,909,245,78.7694974003,21.2305025997
3939,1500000US131639601005,131639601005,"Block Group 5, Census Tract 9601, Jefferson County, Georgia",1200,307,893,25.5833333333,74.4166666667
3940,1500000US131639602001,131639602001,"Block Group 1, Census Tract 9602, Jefferson County, Georgia",1192,1092,100,91.610738255,8.38926174497
3941,1500000US131639602002,131639602002,"Block Group 2, Census Tract 9602, Jefferson County, Georgia",991,766,225,77.2956609485,22.7043390515
3942,1500000US131639603001,131639603001,"Block Group 1, Census Tract 9603, Jefferson County, Georgia",763,518,245,67.8899082569,32.1100917431
3943,1500000US131639603002,131639603002,"Block Group 2, Census Tract 9603, Jefferson County, Georgia",466,222,244,47.6394849785,52.3605150215
3944,1500000US131639603003,131639603003,"Block Group 3, Census Tract 9603, Jefferson County, Georgia",1049,724,325,69.0181124881,30.9818875119
3945,1500000US131639603004,131639603004,"Block Group 4, Census Tract 9603, Jefferson County, Georgia",1345,732,613,54.4237918216,45.5762081784
3946,1500000US131639603005,131639603005,"Block Group 5, Census Tract 9603, Jefferson County, Georgia",1075,608,467,56.5581395349,43.4418604651
3947,1500000US131639603006,131639603006,"Block Group 6, Census Tract 9603, Jefferson County, Georgia",574,351,223,61.149825784,38.850174216
3948,1500000US131639604001,131639604001,"Block Group 1, Census Tract 9604, Jefferson County, Georgia",1165,749,416,64.2918454936,35.7081545064
3949,1500000US131639604002,131639604002,"Block Group 2, Census Tract 9604, Jefferson County, Georgia",822,463,359,56.3260340633,43.6739659367
3950,1500000US131639604003,131639604003,"Block Group 3, Census Tract 9604, Jefferson County, Georgia",812,362,450,44.5812807882,55.4187192118
3951,1500000US131639604004,131639604004,"Block Group 4, Census Tract 9604, Jefferson County, Georgia",699,592,107,84.6924177396,15.3075822604
3952,1500000US131659601001,131659601001,"Block Group 1, Census Tract 9601, Jenkins County, Georgia",2029,1466,563,72.2523410547,27.7476589453
3953,1500000US131659601002,131659601002,"Block Group 2, Census Tract 9601, Jenkins County, Georgia",1319,868,451,65.8074298711,34.1925701289
3954,1500000US131659601003,131659601003,"Block Group 3, Census Tract 9601, Jenkins County, Georgia",728,474,254,65.1098901099,34.8901098901
3955,1500000US131659601004,131659601004,"Block Group 4, Census Tract 9601, Jenkins County, Georgia",449,338,111,75.2783964365,24.7216035635
3956,1500000US131659601005,131659601005,"Block Group 5, Census Tract 9601, Jenkins County, Georgia",824,551,273,66.8689320388,33.1310679612
3957,1500000US131659601006,131659601006,"Block Group 6, Census Tract 9601, Jenkins County, Georgia",641,187,454,29.1731669267,70.8268330733
3958,1500000US131659602001,131659602001,"Block Group 1, Census Tract 9602, Jenkins County, Georgia",1298,784,514,60.4006163328,39.5993836672
3959,1500000US131659602002,131659602002,"Block Group 2, Census Tract 9602, Jenkins County, Georgia",1552,1187,365,76.4819587629,23.5180412371
3960,1500000US131679601001,131679601001,"Block Group 1, Census Tract 9601, Johnson County, Georgia",1260,1047,213,83.0952380952,16.9047619048
3961,1500000US131679601002,131679601002,"Block Group 2, Census Tract 9601, Johnson County, Georgia",1381,1106,275,80.0868935554,19.9131064446
3962,1500000US131679602001,131679602001,"Block Group 1, Census Tract 9602, Johnson County, Georgia",525,473,52,90.0952380952,9.90476190476
3963,1500000US131679602002,131679602002,"Block Group 2, Census Tract 9602, Johnson County, Georgia",1091,578,513,52.9789184235,47.0210815765
3964,1500000US131679602003,131679602003,"Block Group 3, Census Tract 9602, Johnson County, Georgia",1732,837,895,48.3256351039,51.6743648961
3965,1500000US131679602004,131679602004,"Block Group 4, Census Tract 9602, Johnson County, Georgia",1473,972,501,65.9877800407,34.0122199593
3966,1500000US131679603001,131679603001,"Block Group 1, Census Tract 9603, Johnson County, Georgia",962,935,27,97.1933471933,2.80665280665
3967,1500000US131679603002,131679603002,"Block Group 2, Census Tract 9603, Johnson County, Georgia",811,809,2,99.7533908755,0.246609124538
3968,1500000US131690301011,131690301011,"Block Group 1, Census Tract 301.01, Jones County, Georgia",2598,2372,226,91.3010007698,8.69899923018
3969,1500000US131690301031,131690301031,"Block Group 1, Census Tract 301.03, Jones County, Georgia",2474,2108,366,85.2061438965,14.7938561035
3970,1500000US131690301041,131690301041,"Block Group 1, Census Tract 301.04, Jones County, Georgia",4738,3438,1300,72.562262558,27.437737442
3971,1500000US131690301042,131690301042,"Block Group 2, Census Tract 301.04, Jones County, Georgia",2716,2276,440,83.7997054492,16.2002945508
3972,1500000US131690302001,131690302001,"Block Group 1, Census Tract 302, Jones County, Georgia",2059,1470,589,71.3938805245,28.6061194755
3973,1500000US131690302002,131690302002,"Block Group 2, Census Tract 302, Jones County, Georgia",1414,1250,164,88.4016973126,11.5983026874
3974,1500000US131690303011,131690303011,"Block Group 1, Census Tract 303.01, Jones County, Georgia",1991,1086,905,54.5454545455,45.4545454545
3975,1500000US131690303012,131690303012,"Block Group 2, Census Tract 303.01, Jones County, Georgia",4697,4126,571,87.8433042367,12.1566957633
3976,1500000US131690303021,131690303021,"Block Group 1, Census Tract 303.02, Jones County, Georgia",938,753,185,80.2771855011,19.7228144989
3977,1500000US131690303022,131690303022,"Block Group 2, Census Tract 303.02, Jones County, Georgia",2277,1816,461,79.7540623628,20.2459376372
3978,1500000US131690303023,131690303023,"Block Group 3, Census Tract 303.02, Jones County, Georgia",2586,2402,184,92.8847641145,7.11523588554
3979,1500000US131719701001,131719701001,"Block Group 1, Census Tract 9701, Lamar County, Georgia",2540,2220,320,87.4015748031,12.5984251969
3980,1500000US131719701002,131719701002,"Block Group 2, Census Tract 9701, Lamar County, Georgia",2789,2029,760,72.7500896379,27.2499103621
3981,1500000US131719701003,131719701003,"Block Group 3, Census Tract 9701, Lamar County, Georgia",1819,1741,78,95.7119296317,4.28807036833
3982,1500000US131719702001,131719702001,"Block Group 1, Census Tract 9702, Lamar County, Georgia",2356,1717,639,72.8777589134,27.1222410866
3983,1500000US131719702002,131719702002,"Block Group 2, Census Tract 9702, Lamar County, Georgia",646,286,360,44.2724458204,55.7275541796
3984,1500000US131719702003,131719702003,"Block Group 3, Census Tract 9702, Lamar County, Georgia",1324,882,442,66.6163141994,33.3836858006
3985,1500000US131719702004,131719702004,"Block Group 4, Census Tract 9702, Lamar County, Georgia",617,377,240,61.1021069692,38.8978930308
3986,1500000US131719702005,131719702005,"Block Group 5, Census Tract 9702, Lamar County, Georgia",701,413,288,58.9158345221,41.0841654779
3987,1500000US131719703001,131719703001,"Block Group 1, Census Tract 9703, Lamar County, Georgia",1214,379,835,31.2191103789,68.7808896211
3988,1500000US131719703002,131719703002,"Block Group 2, Census Tract 9703, Lamar County, Georgia",961,745,216,77.5234131113,22.4765868887
3989,1500000US131719703003,131719703003,"Block Group 3, Census Tract 9703, Lamar County, Georgia",854,351,503,41.1007025761,58.8992974239
3990,1500000US131719703004,131719703004,"Block Group 4, Census Tract 9703, Lamar County, Georgia",1002,460,542,45.9081836327,54.0918163673
3991,1500000US131739501001,131739501001,"Block Group 1, Census Tract 9501, Lanier County, Georgia",712,489,223,68.6797752809,31.3202247191
3992,1500000US131739501002,131739501002,"Block Group 2, Census Tract 9501, Lanier County, Georgia",1254,1087,167,86.68261563,13.31738437
3993,1500000US131739502001,131739502001,"Block Group 1, Census Tract 9502, Lanier County, Georgia",1279,643,636,50.2736512901,49.7263487099
3994,1500000US131739502002,131739502002,"Block Group 2, Census Tract 9502, Lanier County, Georgia",1548,790,758,51.0335917313,48.9664082687
3995,1500000US131739502003,131739502003,"Block Group 3, Census Tract 9502, Lanier County, Georgia",1137,366,771,32.1899736148,67.8100263852
3996,1500000US131739502004,131739502004,"Block Group 4, Census Tract 9502, Lanier County, Georgia",3063,2364,699,77.1792360431,22.8207639569
3997,1500000US131739502005,131739502005,"Block Group 5, Census Tract 9502, Lanier County, Georgia",1113,674,439,60.5570530099,39.4429469901
3998,1500000US131759501001,131759501001,"Block Group 1, Census Tract 9501, Laurens County, Georgia",1847,1249,598,67.6231727125,32.3768272875
3999,1500000US131759501002,131759501002,"Block Group 2, Census Tract 9501, Laurens County, Georgia",1317,1102,215,83.6750189825,16.3249810175
4000,1500000US131759502011,131759502011,"Block Group 1, Census Tract 9502.01, Laurens County, Georgia",1921,1521,400,79.1775117126,20.8224882874
4001,1500000US131759502012,131759502012,"Block Group 2, Census Tract 9502.01, Laurens County, Georgia",2750,1803,947,65.5636363636,34.4363636364
4002,1500000US131759502021,131759502021,"Block Group 1, Census Tract 9502.02, Laurens County, Georgia",2023,1444,579,71.3791398913,28.6208601087
4003,1500000US131759502022,131759502022,"Block Group 2, Census Tract 9502.02, Laurens County, Georgia",2321,1884,437,81.1719086601,18.8280913399
4004,1500000US131759503001,131759503001,"Block Group 1, Census Tract 9503, Laurens County, Georgia",1138,359,779,31.546572935,68.453427065
4005,1500000US131759503002,131759503002,"Block Group 2, Census Tract 9503, Laurens County, Georgia",551,232,319,42.1052631579,57.8947368421
4006,1500000US131759504001,131759504001,"Block Group 1, Census Tract 9504, Laurens County, Georgia",816,346,470,42.4019607843,57.5980392157
4007,1500000US131759504002,131759504002,"Block Group 2, Census Tract 9504, Laurens County, Georgia",1232,704,528,57.1428571429,42.8571428571
4008,1500000US131759504003,131759504003,"Block Group 3, Census Tract 9504, Laurens County, Georgia",1355,83,1272,6.12546125461,93.8745387454
4009,1500000US131759504004,131759504004,"Block Group 4, Census Tract 9504, Laurens County, Georgia",377,203,174,53.8461538462,46.1538461538
4010,1500000US131759505001,131759505001,"Block Group 1, Census Tract 9505, Laurens County, Georgia",701,404,297,57.6319543509,42.3680456491
4011,1500000US131759505002,131759505002,"Block Group 2, Census Tract 9505, Laurens County, Georgia",721,514,207,71.2898751734,28.7101248266
4012,1500000US131759505003,131759505003,"Block Group 3, Census Tract 9505, Laurens County, Georgia",2225,1270,955,57.0786516854,42.9213483146
4013,1500000US131759506001,131759506001,"Block Group 1, Census Tract 9506, Laurens County, Georgia",2129,1489,640,69.9389384688,30.0610615312
4014,1500000US131759507001,131759507001,"Block Group 1, Census Tract 9507, Laurens County, Georgia",1737,1266,471,72.884283247,27.115716753
4015,1500000US131759507002,131759507002,"Block Group 2, Census Tract 9507, Laurens County, Georgia",766,646,120,84.3342036554,15.6657963446
4016,1500000US131759508001,131759508001,"Block Group 1, Census Tract 9508, Laurens County, Georgia",1077,595,482,55.2460538533,44.7539461467
4017,1500000US131759508002,131759508002,"Block Group 2, Census Tract 9508, Laurens County, Georgia",654,269,385,41.1314984709,58.8685015291
4018,1500000US131759508003,131759508003,"Block Group 3, Census Tract 9508, Laurens County, Georgia",1025,659,366,64.2926829268,35.7073170732
4019,1500000US131759508004,131759508004,"Block Group 4, Census Tract 9508, Laurens County, Georgia",913,738,175,80.8324205915,19.1675794085
4020,1500000US131759509001,131759509001,"Block Group 1, Census Tract 9509, Laurens County, Georgia",930,79,851,8.49462365591,91.5053763441
4021,1500000US131759509002,131759509002,"Block Group 2, Census Tract 9509, Laurens County, Georgia",999,323,676,32.3323323323,67.6676676677
4022,1500000US131759509003,131759509003,"Block Group 3, Census Tract 9509, Laurens County, Georgia",721,280,441,38.8349514563,61.1650485437
4023,1500000US131759510001,131759510001,"Block Group 1, Census Tract 9510, Laurens County, Georgia",1188,1117,71,94.0235690236,5.97643097643
4024,1500000US131759510002,131759510002,"Block Group 2, Census Tract 9510, Laurens County, Georgia",375,243,132,64.8,35.2
4025,1500000US131759510003,131759510003,"Block Group 3, Census Tract 9510, Laurens County, Georgia",2250,1188,1062,52.8,47.2
4026,1500000US131759510004,131759510004,"Block Group 4, Census Tract 9510, Laurens County, Georgia",882,314,568,35.6009070295,64.3990929705
4027,1500000US131759510005,131759510005,"Block Group 5, Census Tract 9510, Laurens County, Georgia",954,545,409,57.1278825996,42.8721174004
4028,1500000US131759510006,131759510006,"Block Group 6, Census Tract 9510, Laurens County, Georgia",1871,1026,845,54.8369855692,45.1630144308
4029,1500000US131759511001,131759511001,"Block Group 1, Census Tract 9511, Laurens County, Georgia",3275,2474,801,75.5419847328,24.4580152672
4030,1500000US131759511002,131759511002,"Block Group 2, Census Tract 9511, Laurens County, Georgia",1313,1058,255,80.5788271135,19.4211728865
4031,1500000US131759514001,131759514001,"Block Group 1, Census Tract 9514, Laurens County, Georgia",983,878,105,89.3184130214,10.6815869786
4032,1500000US131759514002,131759514002,"Block Group 2, Census Tract 9514, Laurens County, Georgia",769,554,215,72.0416124837,27.9583875163
4033,1500000US131759514003,131759514003,"Block Group 3, Census Tract 9514, Laurens County, Georgia",634,488,146,76.9716088328,23.0283911672
4034,1500000US131770201001,131770201001,"Block Group 1, Census Tract 201, Lee County, Georgia",1533,1377,156,89.8238747554,10.1761252446
4035,1500000US131770201002,131770201002,"Block Group 2, Census Tract 201, Lee County, Georgia",2017,1451,566,71.9385225583,28.0614774417
4036,1500000US131770201003,131770201003,"Block Group 3, Census Tract 201, Lee County, Georgia",2866,2466,400,86.0432658758,13.9567341242
4037,1500000US131770202001,131770202001,"Block Group 1, Census Tract 202, Lee County, Georgia",1455,1076,379,73.9518900344,26.0481099656
4038,1500000US131770203001,131770203001,"Block Group 1, Census Tract 203, Lee County, Georgia",3462,2108,1354,60.8896591566,39.1103408434
4039,1500000US131770203002,131770203002,"Block Group 2, Census Tract 203, Lee County, Georgia",1659,1255,404,75.6479807113,24.3520192887
4040,1500000US131770203003,131770203003,"Block Group 3, Census Tract 203, Lee County, Georgia",535,454,81,84.8598130841,15.1401869159
4041,1500000US131770204021,131770204021,"Block Group 1, Census Tract 204.02, Lee County, Georgia",2483,1041,1442,41.9250906162,58.0749093838
4042,1500000US131770204022,131770204022,"Block Group 2, Census Tract 204.02, Lee County, Georgia",3401,1648,1753,48.4563363717,51.5436636283
4043,1500000US131770204023,131770204023,"Block Group 3, Census Tract 204.02, Lee County, Georgia",928,309,619,33.2974137931,66.7025862069
4044,1500000US131770204024,131770204024,"Block Group 4, Census Tract 204.02, Lee County, Georgia",1400,1379,21,98.5,1.5
4045,1500000US131770204031,131770204031,"Block Group 1, Census Tract 204.03, Lee County, Georgia",5050,4039,1011,79.9801980198,20.0198019802
4046,1500000US131770204032,131770204032,"Block Group 2, Census Tract 204.03, Lee County, Georgia",871,871,0,100.0,0.0
4047,1500000US131790101011,131790101011,"Block Group 1, Census Tract 101.01, Liberty County, Georgia",5182,17,5165,0.328058664608,99.6719413354
4048,1500000US131790101012,131790101012,"Block Group 2, Census Tract 101.01, Liberty County, Georgia",1267,0,1267,0.0,100.0
4049,1500000US131790101021,131790101021,"Block Group 1, Census Tract 101.02, Liberty County, Georgia",77,0,77,0.0,100.0
4050,1500000US131790101022,131790101022,"Block Group 2, Census Tract 101.02, Liberty County, Georgia",681,0,681,0.0,100.0
4051,1500000US131790101031,131790101031,"Block Group 1, Census Tract 101.03, Liberty County, Georgia",225,0,225,0.0,100.0
4052,1500000US131790101032,131790101032,"Block Group 2, Census Tract 101.03, Liberty County, Georgia",1065,16,1049,1.50234741784,98.4976525822
4053,1500000US131790102021,131790102021,"Block Group 1, Census Tract 102.02, Liberty County, Georgia",2749,1140,1609,41.4696253183,58.5303746817
4054,1500000US131790102022,131790102022,"Block Group 2, Census Tract 102.02, Liberty County, Georgia",1456,663,793,45.5357142857,54.4642857143
4055,1500000US131790102041,131790102041,"Block Group 1, Census Tract 102.04, Liberty County, Georgia",539,175,364,32.4675324675,67.5324675325
4056,1500000US131790102042,131790102042,"Block Group 2, Census Tract 102.04, Liberty County, Georgia",2302,953,1349,41.3987836664,58.6012163336
4057,1500000US131790102051,131790102051,"Block Group 1, Census Tract 102.05, Liberty County, Georgia",3606,1059,2547,29.3677204659,70.6322795341
4058,1500000US131790102052,131790102052,"Block Group 2, Census Tract 102.05, Liberty County, Georgia",2270,1608,662,70.8370044053,29.1629955947
4059,1500000US131790102061,131790102061,"Block Group 1, Census Tract 102.06, Liberty County, Georgia",1059,767,292,72.4268177526,27.5731822474
4060,1500000US131790102062,131790102062,"Block Group 2, Census Tract 102.06, Liberty County, Georgia",4075,1697,2378,41.6441717791,58.3558282209
4061,1500000US131790102071,131790102071,"Block Group 1, Census Tract 102.07, Liberty County, Georgia",2677,1492,1185,55.7340306313,44.2659693687
4062,1500000US131790102072,131790102072,"Block Group 2, Census Tract 102.07, Liberty County, Georgia",2758,982,1776,35.60551124,64.39448876
4063,1500000US131790102081,131790102081,"Block Group 1, Census Tract 102.08, Liberty County, Georgia",2288,1682,606,73.513986014,26.486013986
4064,1500000US131790102082,131790102082,"Block Group 2, Census Tract 102.08, Liberty County, Georgia",3591,1929,1662,53.7176274018,46.2823725982
4065,1500000US131790103001,131790103001,"Block Group 1, Census Tract 103, Liberty County, Georgia",866,718,148,82.9099307159,17.0900692841
4066,1500000US131790103002,131790103002,"Block Group 2, Census Tract 103, Liberty County, Georgia",2629,1025,1604,38.9882084443,61.0117915557
4067,1500000US131790103003,131790103003,"Block Group 3, Census Tract 103, Liberty County, Georgia",1215,177,1038,14.5679012346,85.4320987654
4068,1500000US131790103004,131790103004,"Block Group 4, Census Tract 103, Liberty County, Georgia",2185,1051,1134,48.1006864989,51.8993135011
4069,1500000US131790104001,131790104001,"Block Group 1, Census Tract 104, Liberty County, Georgia",2306,1583,723,68.6470078057,31.3529921943
4070,1500000US131790104002,131790104002,"Block Group 2, Census Tract 104, Liberty County, Georgia",1829,534,1295,29.1962821214,70.8037178786
4071,1500000US131790104003,131790104003,"Block Group 3, Census Tract 104, Liberty County, Georgia",3032,1675,1357,55.2440633245,44.7559366755
4072,1500000US131790105011,131790105011,"Block Group 1, Census Tract 105.01, Liberty County, Georgia",915,712,203,77.8142076503,22.1857923497
4073,1500000US131790105012,131790105012,"Block Group 2, Census Tract 105.01, Liberty County, Georgia",2569,1944,625,75.6714674971,24.3285325029
4074,1500000US131790105021,131790105021,"Block Group 1, Census Tract 105.02, Liberty County, Georgia",2731,1815,916,66.4591724643,33.5408275357
4075,1500000US131790105022,131790105022,"Block Group 2, Census Tract 105.02, Liberty County, Georgia",2384,1727,657,72.4412751678,27.5587248322
4076,1500000US131790106001,131790106001,"Block Group 1, Census Tract 106, Liberty County, Georgia",1066,663,403,62.1951219512,37.8048780488
4077,1500000US131790106002,131790106002,"Block Group 2, Census Tract 106, Liberty County, Georgia",836,647,189,77.3923444976,22.6076555024
4078,1500000US131799900000,131799900000,"Block Group 0, Census Tract 9900, Liberty County, Georgia",0,0,0,,
4079,1500000US131819701001,131819701001,"Block Group 1, Census Tract 9701, Lincoln County, Georgia",1344,1100,244,81.8452380952,18.1547619048
4080,1500000US131819701002,131819701002,"Block Group 2, Census Tract 9701, Lincoln County, Georgia",562,483,79,85.9430604982,14.0569395018
4081,1500000US131819701003,131819701003,"Block Group 3, Census Tract 9701, Lincoln County, Georgia",1133,712,421,62.8420123566,37.1579876434
4082,1500000US131819701004,131819701004,"Block Group 4, Census Tract 9701, Lincoln County, Georgia",620,399,221,64.3548387097,35.6451612903
4083,1500000US131819702001,131819702001,"Block Group 1, Census Tract 9702, Lincoln County, Georgia",1301,1043,258,80.1691006918,19.8308993082
4084,1500000US131819702002,131819702002,"Block Group 2, Census Tract 9702, Lincoln County, Georgia",700,600,100,85.7142857143,14.2857142857
4085,1500000US131819702003,131819702003,"Block Group 3, Census Tract 9702, Lincoln County, Georgia",1968,1511,457,76.7784552846,23.2215447154
4086,1500000US131839701001,131839701001,"Block Group 1, Census Tract 9701, Long County, Georgia",1957,1483,474,75.7792539601,24.2207460399
4087,1500000US131839701002,131839701002,"Block Group 2, Census Tract 9701, Long County, Georgia",4330,2867,1463,66.2124711316,33.7875288684
4088,1500000US131839701003,131839701003,"Block Group 3, Census Tract 9701, Long County, Georgia",3260,2071,1189,63.527607362,36.472392638
4089,1500000US131839702001,131839702001,"Block Group 1, Census Tract 9702, Long County, Georgia",904,423,481,46.7920353982,53.2079646018
4090,1500000US131839702002,131839702002,"Block Group 2, Census Tract 9702, Long County, Georgia",1659,1040,619,62.6883664858,37.3116335142
4091,1500000US131839702003,131839702003,"Block Group 3, Census Tract 9702, Long County, Georgia",4278,3085,1193,72.1131369799,27.8868630201
4092,1500000US131839800001,131839800001,"Block Group 1, Census Tract 9800, Long County, Georgia",0,0,0,,
4093,1500000US131850101011,131850101011,"Block Group 1, Census Tract 101.01, Lowndes County, Georgia",1094,874,220,79.8903107861,20.1096892139
4094,1500000US131850101012,131850101012,"Block Group 2, Census Tract 101.01, Lowndes County, Georgia",2938,1097,1841,37.3383253914,62.6616746086
4095,1500000US131850101021,131850101021,"Block Group 1, Census Tract 101.02, Lowndes County, Georgia",1574,1008,566,64.040660737,35.959339263
4096,1500000US131850101022,131850101022,"Block Group 2, Census Tract 101.02, Lowndes County, Georgia",1671,1268,403,75.8827049671,24.1172950329
4097,1500000US131850101023,131850101023,"Block Group 3, Census Tract 101.02, Lowndes County, Georgia",1183,570,613,48.1825866441,51.8174133559
4098,1500000US131850101024,131850101024,"Block Group 4, Census Tract 101.02, Lowndes County, Georgia",675,137,538,20.2962962963,79.7037037037
4099,1500000US131850101031,131850101031,"Block Group 1, Census Tract 101.03, Lowndes County, Georgia",2158,1720,438,79.703429101,20.296570899
4100,1500000US131850101032,131850101032,"Block Group 2, Census Tract 101.03, Lowndes County, Georgia",1264,823,441,65.1107594937,34.8892405063
4101,1500000US131850102011,131850102011,"Block Group 1, Census Tract 102.01, Lowndes County, Georgia",1159,1014,145,87.4892148404,12.5107851596
4102,1500000US131850102012,131850102012,"Block Group 2, Census Tract 102.01, Lowndes County, Georgia",1197,846,351,70.6766917293,29.3233082707
4103,1500000US131850102021,131850102021,"Block Group 1, Census Tract 102.02, Lowndes County, Georgia",1362,932,430,68.4287812041,31.5712187959
4104,1500000US131850102022,131850102022,"Block Group 2, Census Tract 102.02, Lowndes County, Georgia",1961,1320,641,67.3125956145,32.6874043855
4105,1500000US131850102023,131850102023,"Block Group 3, Census Tract 102.02, Lowndes County, Georgia",1927,1684,243,87.3897249611,12.6102750389
4106,1500000US131850102024,131850102024,"Block Group 4, Census Tract 102.02, Lowndes County, Georgia",2237,1720,517,76.8886902101,23.1113097899
4107,1500000US131850102025,131850102025,"Block Group 5, Census Tract 102.02, Lowndes County, Georgia",3188,2866,322,89.8996235885,10.1003764115
4108,1500000US131850102026,131850102026,"Block Group 6, Census Tract 102.02, Lowndes County, Georgia",863,692,171,80.1853997683,19.8146002317
4109,1500000US131850103011,131850103011,"Block Group 1, Census Tract 103.01, Lowndes County, Georgia",1022,196,826,19.1780821918,80.8219178082
4110,1500000US131850103012,131850103012,"Block Group 2, Census Tract 103.01, Lowndes County, Georgia",2446,2305,141,94.2354865086,5.76451349141
4111,1500000US131850103013,131850103013,"Block Group 3, Census Tract 103.01, Lowndes County, Georgia",1730,631,1099,36.4739884393,63.5260115607
4112,1500000US131850103021,131850103021,"Block Group 1, Census Tract 103.02, Lowndes County, Georgia",1372,853,519,62.1720116618,37.8279883382
4113,1500000US131850103022,131850103022,"Block Group 2, Census Tract 103.02, Lowndes County, Georgia",1247,1215,32,97.4338412189,2.56615878107
4114,1500000US131850104011,131850104011,"Block Group 1, Census Tract 104.01, Lowndes County, Georgia",1001,542,459,54.1458541459,45.8541458541
4115,1500000US131850104012,131850104012,"Block Group 2, Census Tract 104.01, Lowndes County, Georgia",551,285,266,51.724137931,48.275862069
4116,1500000US131850104021,131850104021,"Block Group 1, Census Tract 104.02, Lowndes County, Georgia",825,221,604,26.7878787879,73.2121212121
4117,1500000US131850104022,131850104022,"Block Group 2, Census Tract 104.02, Lowndes County, Georgia",3077,1257,1820,40.851478713,59.148521287
4118,1500000US131850104023,131850104023,"Block Group 3, Census Tract 104.02, Lowndes County, Georgia",3136,1128,2008,35.9693877551,64.0306122449
4119,1500000US131850105001,131850105001,"Block Group 1, Census Tract 105, Lowndes County, Georgia",1309,377,932,28.8006111536,71.1993888464
4120,1500000US131850105002,131850105002,"Block Group 2, Census Tract 105, Lowndes County, Georgia",1587,528,1059,33.2703213611,66.7296786389
4121,1500000US131850105003,131850105003,"Block Group 3, Census Tract 105, Lowndes County, Georgia",1894,218,1676,11.510031679,88.489968321
4122,1500000US131850106011,131850106011,"Block Group 1, Census Tract 106.01, Lowndes County, Georgia",2843,368,2475,12.9440731622,87.0559268378
4123,1500000US131850106012,131850106012,"Block Group 2, Census Tract 106.01, Lowndes County, Georgia",1161,489,672,42.1188630491,57.8811369509
4124,1500000US131850106013,131850106013,"Block Group 3, Census Tract 106.01, Lowndes County, Georgia",1793,431,1362,24.0379252649,75.9620747351
4125,1500000US131850106041,131850106041,"Block Group 1, Census Tract 106.04, Lowndes County, Georgia",485,186,299,38.3505154639,61.6494845361
4126,1500000US131850106042,131850106042,"Block Group 2, Census Tract 106.04, Lowndes County, Georgia",2818,1699,1119,60.2909865153,39.7090134847
4127,1500000US131850106043,131850106043,"Block Group 3, Census Tract 106.04, Lowndes County, Georgia",1886,1216,670,64.4750795334,35.5249204666
4128,1500000US131850107001,131850107001,"Block Group 1, Census Tract 107, Lowndes County, Georgia",720,597,123,82.9166666667,17.0833333333
4129,1500000US131850107002,131850107002,"Block Group 2, Census Tract 107, Lowndes County, Georgia",1068,1065,3,99.7191011236,0.280898876404
4130,1500000US131850107003,131850107003,"Block Group 3, Census Tract 107, Lowndes County, Georgia",2076,1741,335,83.8631984586,16.1368015414
4131,1500000US131850108001,131850108001,"Block Group 1, Census Tract 108, Lowndes County, Georgia",2563,907,1656,35.3882169333,64.6117830667
4132,1500000US131850108002,131850108002,"Block Group 2, Census Tract 108, Lowndes County, Georgia",2109,535,1574,25.3674727359,74.6325272641
4133,1500000US131850108003,131850108003,"Block Group 3, Census Tract 108, Lowndes County, Georgia",886,451,435,50.9029345372,49.0970654628
4134,1500000US131850109001,131850109001,"Block Group 1, Census Tract 109, Lowndes County, Georgia",730,241,489,33.0136986301,66.9863013699
4135,1500000US131850109002,131850109002,"Block Group 2, Census Tract 109, Lowndes County, Georgia",986,274,712,27.7890466531,72.2109533469
4136,1500000US131850110001,131850110001,"Block Group 1, Census Tract 110, Lowndes County, Georgia",2132,452,1680,21.200750469,78.799249531
4137,1500000US131850110002,131850110002,"Block Group 2, Census Tract 110, Lowndes County, Georgia",1280,488,792,38.125,61.875
4138,1500000US131850111001,131850111001,"Block Group 1, Census Tract 111, Lowndes County, Georgia",879,479,400,54.4937428896,45.5062571104
4139,1500000US131850111002,131850111002,"Block Group 2, Census Tract 111, Lowndes County, Georgia",1236,374,862,30.2588996764,69.7411003236
4140,1500000US131850112001,131850112001,"Block Group 1, Census Tract 112, Lowndes County, Georgia",745,639,106,85.7718120805,14.2281879195
4141,1500000US131850112002,131850112002,"Block Group 2, Census Tract 112, Lowndes County, Georgia",1556,481,1075,30.912596401,69.087403599
4142,1500000US131850112003,131850112003,"Block Group 3, Census Tract 112, Lowndes County, Georgia",1242,577,665,46.4573268921,53.5426731079
4143,1500000US131850112004,131850112004,"Block Group 4, Census Tract 112, Lowndes County, Georgia",1591,335,1256,21.0559396606,78.9440603394
4144,1500000US131850113011,131850113011,"Block Group 1, Census Tract 113.01, Lowndes County, Georgia",2074,232,1842,11.1861137898,88.8138862102
4145,1500000US131850113012,131850113012,"Block Group 2, Census Tract 113.01, Lowndes County, Georgia",1393,31,1362,2.22541277818,97.7745872218
4146,1500000US131850113013,131850113013,"Block Group 3, Census Tract 113.01, Lowndes County, Georgia",1825,161,1664,8.82191780822,91.1780821918
4147,1500000US131850113021,131850113021,"Block Group 1, Census Tract 113.02, Lowndes County, Georgia",1340,215,1125,16.0447761194,83.9552238806
4148,1500000US131850113022,131850113022,"Block Group 2, Census Tract 113.02, Lowndes County, Georgia",1260,646,614,51.2698412698,48.7301587302
4149,1500000US131850114011,131850114011,"Block Group 1, Census Tract 114.01, Lowndes County, Georgia",1723,1359,364,78.8740568775,21.1259431225
4150,1500000US131850114012,131850114012,"Block Group 2, Census Tract 114.01, Lowndes County, Georgia",692,264,428,38.1502890173,61.8497109827
4151,1500000US131850114021,131850114021,"Block Group 1, Census Tract 114.02, Lowndes County, Georgia",953,518,435,54.3546694648,45.6453305352
4152,1500000US131850114022,131850114022,"Block Group 2, Census Tract 114.02, Lowndes County, Georgia",874,619,255,70.823798627,29.176201373
4153,1500000US131850114031,131850114031,"Block Group 1, Census Tract 114.03, Lowndes County, Georgia",2392,1506,886,62.9598662207,37.0401337793
4154,1500000US131850114032,131850114032,"Block Group 2, Census Tract 114.03, Lowndes County, Georgia",2201,1434,767,65.1522035438,34.8477964562
4155,1500000US131850114033,131850114033,"Block Group 3, Census Tract 114.03, Lowndes County, Georgia",2150,1501,649,69.8139534884,30.1860465116
4156,1500000US131850114034,131850114034,"Block Group 4, Census Tract 114.03, Lowndes County, Georgia",1724,1103,621,63.9791183295,36.0208816705
4157,1500000US131850115001,131850115001,"Block Group 1, Census Tract 115, Lowndes County, Georgia",1200,956,244,79.6666666667,20.3333333333
4158,1500000US131850115002,131850115002,"Block Group 2, Census Tract 115, Lowndes County, Georgia",2086,1406,680,67.401725791,32.598274209
4159,1500000US131850115003,131850115003,"Block Group 3, Census Tract 115, Lowndes County, Georgia",833,756,77,90.756302521,9.24369747899
4160,1500000US131850116001,131850116001,"Block Group 1, Census Tract 116, Lowndes County, Georgia",2493,1338,1155,53.670276775,46.329723225
4161,1500000US131850116002,131850116002,"Block Group 2, Census Tract 116, Lowndes County, Georgia",1685,1263,422,74.9554896142,25.0445103858
4162,1500000US131879601011,131879601011,"Block Group 1, Census Tract 9601.01, Lumpkin County, Georgia",4636,3046,1590,65.7031924072,34.2968075928
4163,1500000US131879601012,131879601012,"Block Group 2, Census Tract 9601.01, Lumpkin County, Georgia",2520,1495,1025,59.3253968254,40.6746031746
4164,1500000US131879601021,131879601021,"Block Group 1, Census Tract 9601.02, Lumpkin County, Georgia",780,686,94,87.9487179487,12.0512820513
4165,1500000US131879601022,131879601022,"Block Group 2, Census Tract 9601.02, Lumpkin County, Georgia",2766,2099,667,75.8857556038,24.1142443962
4166,1500000US131879601023,131879601023,"Block Group 3, Census Tract 9601.02, Lumpkin County, Georgia",2166,1556,610,71.837488458,28.162511542
4167,1500000US131879602011,131879602011,"Block Group 1, Census Tract 9602.01, Lumpkin County, Georgia",5211,4177,1034,80.157359432,19.842640568
4168,1500000US131879602012,131879602012,"Block Group 2, Census Tract 9602.01, Lumpkin County, Georgia",2569,1898,671,73.8808875049,26.1191124951
4169,1500000US131879602013,131879602013,"Block Group 3, Census Tract 9602.01, Lumpkin County, Georgia",1377,1106,271,80.3195352215,19.6804647785
4170,1500000US131879602021,131879602021,"Block Group 1, Census Tract 9602.02, Lumpkin County, Georgia",2033,1459,574,71.7658632563,28.2341367437
4171,1500000US131879602022,131879602022,"Block Group 2, Census Tract 9602.02, Lumpkin County, Georgia",2030,142,1888,6.99507389163,93.0049261084
4172,1500000US131879602023,131879602023,"Block Group 3, Census Tract 9602.02, Lumpkin County, Georgia",1234,96,1138,7.77957860616,92.2204213938
4173,1500000US131879602024,131879602024,"Block Group 4, Census Tract 9602.02, Lumpkin County, Georgia",2123,1622,501,76.4013188884,23.5986811116
4174,1500000US131899501001,131899501001,"Block Group 1, Census Tract 9501, McDuffie County, Georgia",1447,1231,216,85.0725639254,14.9274360746
4175,1500000US131899501002,131899501002,"Block Group 2, Census Tract 9501, McDuffie County, Georgia",981,949,32,96.7380224261,3.2619775739
4176,1500000US131899502001,131899502001,"Block Group 1, Census Tract 9502, McDuffie County, Georgia",1580,893,687,56.5189873418,43.4810126582
4177,1500000US131899502002,131899502002,"Block Group 2, Census Tract 9502, McDuffie County, Georgia",1485,768,717,51.7171717172,48.2828282828
4178,1500000US131899502003,131899502003,"Block Group 3, Census Tract 9502, McDuffie County, Georgia",1418,921,497,64.9506346968,35.0493653032
4179,1500000US131899502004,131899502004,"Block Group 4, Census Tract 9502, McDuffie County, Georgia",837,362,475,43.2497013142,56.7502986858
4180,1500000US131899503001,131899503001,"Block Group 1, Census Tract 9503, McDuffie County, Georgia",1370,1136,234,82.9197080292,17.0802919708
4181,1500000US131899503002,131899503002,"Block Group 2, Census Tract 9503, McDuffie County, Georgia",1043,766,277,73.4419942474,26.5580057526
4182,1500000US131899503003,131899503003,"Block Group 3, Census Tract 9503, McDuffie County, Georgia",755,374,381,49.5364238411,50.4635761589
4183,1500000US131899504001,131899504001,"Block Group 1, Census Tract 9504, McDuffie County, Georgia",1014,435,579,42.899408284,57.100591716
4184,1500000US131899504002,131899504002,"Block Group 2, Census Tract 9504, McDuffie County, Georgia",825,567,258,68.7272727273,31.2727272727
4185,1500000US131899504003,131899504003,"Block Group 3, Census Tract 9504, McDuffie County, Georgia",924,712,212,77.0562770563,22.9437229437
4186,1500000US131899504004,131899504004,"Block Group 4, Census Tract 9504, McDuffie County, Georgia",981,413,568,42.0998980632,57.9001019368
4187,1500000US131899504005,131899504005,"Block Group 5, Census Tract 9504, McDuffie County, Georgia",1109,64,1045,5.77096483318,94.2290351668
4188,1500000US131899505001,131899505001,"Block Group 1, Census Tract 9505, McDuffie County, Georgia",1060,891,169,84.0566037736,15.9433962264
4189,1500000US131899505002,131899505002,"Block Group 2, Census Tract 9505, McDuffie County, Georgia",1341,1011,330,75.3914988814,24.6085011186
4190,1500000US131899505003,131899505003,"Block Group 3, Census Tract 9505, McDuffie County, Georgia",2073,1204,869,58.0800771828,41.9199228172
4191,1500000US131899505004,131899505004,"Block Group 4, Census Tract 9505, McDuffie County, Georgia",1001,763,238,76.2237762238,23.7762237762
4192,1500000US131911101001,131911101001,"Block Group 1, Census Tract 1101, McIntosh County, Georgia",1576,1329,247,84.3274111675,15.6725888325
4193,1500000US131911101002,131911101002,"Block Group 2, Census Tract 1101, McIntosh County, Georgia",1425,1263,162,88.6315789474,11.3684210526
4194,1500000US131911101003,131911101003,"Block Group 3, Census Tract 1101, McIntosh County, Georgia",899,826,73,91.8798665184,8.12013348165
4195,1500000US131911102001,131911102001,"Block Group 1, Census Tract 1102, McIntosh County, Georgia",2486,1218,1268,48.9943684634,51.0056315366
4196,1500000US131911102002,131911102002,"Block Group 2, Census Tract 1102, McIntosh County, Georgia",1046,1025,21,97.9923518164,2.00764818356
4197,1500000US131911102003,131911102003,"Block Group 3, Census Tract 1102, McIntosh County, Georgia",1209,1113,96,92.0595533499,7.94044665012
4198,1500000US131911103001,131911103001,"Block Group 1, Census Tract 1103, McIntosh County, Georgia",1310,902,408,68.8549618321,31.1450381679
4199,1500000US131911103002,131911103002,"Block Group 2, Census Tract 1103, McIntosh County, Georgia",1855,1410,445,76.0107816712,23.9892183288
4200,1500000US131911103003,131911103003,"Block Group 3, Census Tract 1103, McIntosh County, Georgia",2127,1357,770,63.7987776211,36.2012223789
4201,1500000US131919800001,131919800001,"Block Group 1, Census Tract 9800, McIntosh County, Georgia",0,0,0,,
4202,1500000US131919900000,131919900000,"Block Group 0, Census Tract 9900, McIntosh County, Georgia",0,0,0,,
4203,1500000US131930001001,131930001001,"Block Group 1, Census Tract 1, Macon County, Georgia",1215,841,374,69.2181069959,30.7818930041
4204,1500000US131930001002,131930001002,"Block Group 2, Census Tract 1, Macon County, Georgia",743,469,274,63.1224764468,36.8775235532
4205,1500000US131930002001,131930002001,"Block Group 1, Census Tract 2, Macon County, Georgia",1086,848,238,78.0847145488,21.9152854512
4206,1500000US131930002002,131930002002,"Block Group 2, Census Tract 2, Macon County, Georgia",784,564,220,71.9387755102,28.0612244898
4207,1500000US131930003001,131930003001,"Block Group 1, Census Tract 3, Macon County, Georgia",1350,979,371,72.5185185185,27.4814814815
4208,1500000US131930003002,131930003002,"Block Group 2, Census Tract 3, Macon County, Georgia",1129,739,390,65.4561558902,34.5438441098
4209,1500000US131930003003,131930003003,"Block Group 3, Census Tract 3, Macon County, Georgia",880,469,411,53.2954545455,46.7045454545
4210,1500000US131930004001,131930004001,"Block Group 1, Census Tract 4, Macon County, Georgia",1258,1029,229,81.7965023847,18.2034976153
4211,1500000US131930004002,131930004002,"Block Group 2, Census Tract 4, Macon County, Georgia",592,215,377,36.3175675676,63.6824324324
4212,1500000US131930004003,131930004003,"Block Group 3, Census Tract 4, Macon County, Georgia",531,393,138,74.011299435,25.988700565
4213,1500000US131930004004,131930004004,"Block Group 4, Census Tract 4, Macon County, Georgia",1058,357,701,33.7429111531,66.2570888469
4214,1500000US131930004005,131930004005,"Block Group 5, Census Tract 4, Macon County, Georgia",1082,719,363,66.4510166359,33.5489833641
4215,1500000US131930004006,131930004006,"Block Group 6, Census Tract 4, Macon County, Georgia",582,266,316,45.704467354,54.295532646
4216,1500000US131950201001,131950201001,"Block Group 1, Census Tract 201, Madison County, Georgia",2201,1722,479,78.237164925,21.762835075
4217,1500000US131950201002,131950201002,"Block Group 2, Census Tract 201, Madison County, Georgia",1510,1038,472,68.7417218543,31.2582781457
4218,1500000US131950201003,131950201003,"Block Group 3, Census Tract 201, Madison County, Georgia",1497,1067,430,71.2758851035,28.7241148965
4219,1500000US131950202001,131950202001,"Block Group 1, Census Tract 202, Madison County, Georgia",2218,1905,313,85.8881875564,14.1118124436
4220,1500000US131950202002,131950202002,"Block Group 2, Census Tract 202, Madison County, Georgia",2672,1616,1056,60.4790419162,39.5209580838
4221,1500000US131950203001,131950203001,"Block Group 1, Census Tract 203, Madison County, Georgia",2227,1413,814,63.4485855411,36.5514144589
4222,1500000US131950203002,131950203002,"Block Group 2, Census Tract 203, Madison County, Georgia",1206,960,246,79.6019900498,20.3980099502
4223,1500000US131950203003,131950203003,"Block Group 3, Census Tract 203, Madison County, Georgia",816,615,201,75.3676470588,24.6323529412
4224,1500000US131950204001,131950204001,"Block Group 1, Census Tract 204, Madison County, Georgia",2405,2086,319,86.735966736,13.264033264
4225,1500000US131950204002,131950204002,"Block Group 2, Census Tract 204, Madison County, Georgia",1477,992,485,67.163168585,32.836831415
4226,1500000US131950204003,131950204003,"Block Group 3, Census Tract 204, Madison County, Georgia",1584,885,699,55.8712121212,44.1287878788
4227,1500000US131950205001,131950205001,"Block Group 1, Census Tract 205, Madison County, Georgia",2697,1454,1243,53.9117538005,46.0882461995
4228,1500000US131950205002,131950205002,"Block Group 2, Census Tract 205, Madison County, Georgia",2201,1501,700,68.1962744207,31.8037255793
4229,1500000US131950205003,131950205003,"Block Group 3, Census Tract 205, Madison County, Georgia",1114,786,328,70.5565529623,29.4434470377
4230,1500000US131950206001,131950206001,"Block Group 1, Census Tract 206, Madison County, Georgia",1029,826,203,80.2721088435,19.7278911565
4231,1500000US131950206002,131950206002,"Block Group 2, Census Tract 206, Madison County, Georgia",1132,808,324,71.3780918728,28.6219081272
4232,1500000US131979201001,131979201001,"Block Group 1, Census Tract 9201, Marion County, Georgia",2014,1849,165,91.8073485601,8.19265143992
4233,1500000US131979201002,131979201002,"Block Group 2, Census Tract 9201, Marion County, Georgia",2140,1946,194,90.9345794393,9.06542056075
4234,1500000US131979202001,131979202001,"Block Group 1, Census Tract 9202, Marion County, Georgia",2153,1252,901,58.151416628,41.848583372
4235,1500000US131979202002,131979202002,"Block Group 2, Census Tract 9202, Marion County, Georgia",1226,986,240,80.4241435563,19.5758564437
4236,1500000US131979202003,131979202003,"Block Group 3, Census Tract 9202, Marion County, Georgia",1119,302,817,26.9883824844,73.0116175156
4237,1500000US131999705001,131999705001,"Block Group 1, Census Tract 9705, Meriwether County, Georgia",871,344,527,39.4948335247,60.5051664753
4238,1500000US131999705002,131999705002,"Block Group 2, Census Tract 9705, Meriwether County, Georgia",1259,517,742,41.0643367752,58.9356632248
4239,1500000US131999705003,131999705003,"Block Group 3, Census Tract 9705, Meriwether County, Georgia",872,562,310,64.4495412844,35.5504587156
4240,1500000US131999705004,131999705004,"Block Group 4, Census Tract 9705, Meriwether County, Georgia",803,382,421,47.5716064757,52.4283935243
4241,1500000US131999705005,131999705005,"Block Group 5, Census Tract 9705, Meriwether County, Georgia",775,497,278,64.1290322581,35.8709677419
4242,1500000US131999705006,131999705006,"Block Group 6, Census Tract 9705, Meriwether County, Georgia",958,587,371,61.2734864301,38.7265135699
4243,1500000US131999706001,131999706001,"Block Group 1, Census Tract 9706, Meriwether County, Georgia",924,583,341,63.0952380952,36.9047619048
4244,1500000US131999706002,131999706002,"Block Group 2, Census Tract 9706, Meriwether County, Georgia",1298,1004,294,77.3497688752,22.6502311248
4245,1500000US131999706003,131999706003,"Block Group 3, Census Tract 9706, Meriwether County, Georgia",1044,736,308,70.4980842912,29.5019157088
4246,1500000US131999707001,131999707001,"Block Group 1, Census Tract 9707, Meriwether County, Georgia",2311,1563,748,67.6330592817,32.3669407183
4247,1500000US131999707002,131999707002,"Block Group 2, Census Tract 9707, Meriwether County, Georgia",1384,1222,162,88.2947976879,11.7052023121
4248,1500000US131999707003,131999707003,"Block Group 3, Census Tract 9707, Meriwether County, Georgia",1347,1001,346,74.3132887899,25.6867112101
4249,1500000US131999707004,131999707004,"Block Group 4, Census Tract 9707, Meriwether County, Georgia",1538,1175,363,76.3979193758,23.6020806242
4250,1500000US131999707005,131999707005,"Block Group 5, Census Tract 9707, Meriwether County, Georgia",684,492,192,71.9298245614,28.0701754386
4251,1500000US131999708001,131999708001,"Block Group 1, Census Tract 9708, Meriwether County, Georgia",1201,729,472,60.6994171524,39.3005828476
4252,1500000US131999708002,131999708002,"Block Group 2, Census Tract 9708, Meriwether County, Georgia",593,491,102,82.7993254637,17.2006745363
4253,1500000US131999708003,131999708003,"Block Group 3, Census Tract 9708, Meriwether County, Georgia",1012,797,215,78.7549407115,21.2450592885
4254,1500000US131999708004,131999708004,"Block Group 4, Census Tract 9708, Meriwether County, Georgia",449,444,5,98.8864142539,1.1135857461
4255,1500000US131999708005,131999708005,"Block Group 5, Census Tract 9708, Meriwether County, Georgia",1267,944,323,74.5067087609,25.4932912391
4256,1500000US131999708006,131999708006,"Block Group 6, Census Tract 9708, Meriwether County, Georgia",434,223,211,51.3824884793,48.6175115207
4257,1500000US132019501001,132019501001,"Block Group 1, Census Tract 9501, Miller County, Georgia",1599,1038,561,64.9155722326,35.0844277674
4258,1500000US132019502001,132019502001,"Block Group 1, Census Tract 9502, Miller County, Georgia",635,470,165,74.0157480315,25.9842519685
4259,1500000US132019502002,132019502002,"Block Group 2, Census Tract 9502, Miller County, Georgia",1133,492,641,43.4245366284,56.5754633716
4260,1500000US132019503001,132019503001,"Block Group 1, Census Tract 9503, Miller County, Georgia",753,481,272,63.8778220452,36.1221779548
4261,1500000US132019503002,132019503002,"Block Group 2, Census Tract 9503, Miller County, Georgia",1637,1087,550,66.4019547954,33.5980452046
4262,1500000US132050901001,132050901001,"Block Group 1, Census Tract 901, Mitchell County, Georgia",1258,775,483,61.6057233704,38.3942766296
4263,1500000US132050901002,132050901002,"Block Group 2, Census Tract 901, Mitchell County, Georgia",2210,1725,485,78.0542986425,21.9457013575
4264,1500000US132050902001,132050902001,"Block Group 1, Census Tract 902, Mitchell County, Georgia",857,510,347,59.5099183197,40.4900816803
4265,1500000US132050902002,132050902002,"Block Group 2, Census Tract 902, Mitchell County, Georgia",1320,906,414,68.6363636364,31.3636363636
4266,1500000US132050902003,132050902003,"Block Group 3, Census Tract 902, Mitchell County, Georgia",1082,635,447,58.6876155268,41.3123844732
4267,1500000US132050903001,132050903001,"Block Group 1, Census Tract 903, Mitchell County, Georgia",582,406,176,69.7594501718,30.2405498282
4268,1500000US132050903002,132050903002,"Block Group 2, Census Tract 903, Mitchell County, Georgia",1435,581,854,40.487804878,59.512195122
4269,1500000US132050903003,132050903003,"Block Group 3, Census Tract 903, Mitchell County, Georgia",465,226,239,48.6021505376,51.3978494624
4270,1500000US132050904001,132050904001,"Block Group 1, Census Tract 904, Mitchell County, Georgia",1635,1191,444,72.8440366972,27.1559633028
4271,1500000US132050904002,132050904002,"Block Group 2, Census Tract 904, Mitchell County, Georgia",1689,1208,481,71.5216104204,28.4783895796
4272,1500000US132050904003,132050904003,"Block Group 3, Census Tract 904, Mitchell County, Georgia",939,811,128,86.3684771033,13.6315228967
4273,1500000US132050904004,132050904004,"Block Group 4, Census Tract 904, Mitchell County, Georgia",1744,1089,655,62.4426605505,37.5573394495
4274,1500000US132050905001,132050905001,"Block Group 1, Census Tract 905, Mitchell County, Georgia",762,557,205,73.0971128609,26.9028871391
4275,1500000US132050905002,132050905002,"Block Group 2, Census Tract 905, Mitchell County, Georgia",1038,864,174,83.2369942197,16.7630057803
4276,1500000US132050905003,132050905003,"Block Group 3, Census Tract 905, Mitchell County, Georgia",967,462,505,47.7766287487,52.2233712513
4277,1500000US132050905004,132050905004,"Block Group 4, Census Tract 905, Mitchell County, Georgia",1211,954,257,78.7778695293,21.2221304707
4278,1500000US132050905005,132050905005,"Block Group 5, Census Tract 905, Mitchell County, Georgia",1560,787,773,50.4487179487,49.5512820513
4279,1500000US132070501011,132070501011,"Block Group 1, Census Tract 501.01, Monroe County, Georgia",2037,1320,717,64.8011782032,35.1988217968
4280,1500000US132070501012,132070501012,"Block Group 2, Census Tract 501.01, Monroe County, Georgia",3258,2970,288,91.1602209945,8.83977900552
4281,1500000US132070501013,132070501013,"Block Group 3, Census Tract 501.01, Monroe County, Georgia",600,483,117,80.5,19.5
4282,1500000US132070501021,132070501021,"Block Group 1, Census Tract 501.02, Monroe County, Georgia",2434,1609,825,66.1051766639,33.8948233361
4283,1500000US132070501022,132070501022,"Block Group 2, Census Tract 501.02, Monroe County, Georgia",1572,869,703,55.2798982188,44.7201017812
4284,1500000US132070502001,132070502001,"Block Group 1, Census Tract 502, Monroe County, Georgia",1360,800,560,58.8235294118,41.1764705882
4285,1500000US132070502002,132070502002,"Block Group 2, Census Tract 502, Monroe County, Georgia",767,501,266,65.3194263364,34.6805736636
4286,1500000US132070502003,132070502003,"Block Group 3, Census Tract 502, Monroe County, Georgia",2704,1874,830,69.3047337278,30.6952662722
4287,1500000US132070503011,132070503011,"Block Group 1, Census Tract 503.01, Monroe County, Georgia",1976,1829,147,92.5607287449,7.43927125506
4288,1500000US132070503012,132070503012,"Block Group 2, Census Tract 503.01, Monroe County, Georgia",1278,971,307,75.9780907668,24.0219092332
4289,1500000US132070503013,132070503013,"Block Group 3, Census Tract 503.01, Monroe County, Georgia",1439,1331,108,92.4947880473,7.50521195274
4290,1500000US132070503021,132070503021,"Block Group 1, Census Tract 503.02, Monroe County, Georgia",1853,1588,265,85.6988667026,14.3011332974
4291,1500000US132070503022,132070503022,"Block Group 2, Census Tract 503.02, Monroe County, Georgia",2393,2069,324,86.4605098203,13.5394901797
4292,1500000US132070503023,132070503023,"Block Group 3, Census Tract 503.02, Monroe County, Georgia",1975,1793,182,90.7848101266,9.21518987342
4293,1500000US132099501001,132099501001,"Block Group 1, Census Tract 9501, Montgomery County, Georgia",1346,1162,184,86.3298662704,13.6701337296
4294,1500000US132099501002,132099501002,"Block Group 2, Census Tract 9501, Montgomery County, Georgia",722,556,166,77.0083102493,22.9916897507
4295,1500000US132099502001,132099502001,"Block Group 1, Census Tract 9502, Montgomery County, Georgia",1307,881,426,67.4062739097,32.5937260903
4296,1500000US132099502002,132099502002,"Block Group 2, Census Tract 9502, Montgomery County, Georgia",1473,868,605,58.927359131,41.072640869
4297,1500000US132099502003,132099502003,"Block Group 3, Census Tract 9502, Montgomery County, Georgia",1312,824,488,62.8048780488,37.1951219512
4298,1500000US132099503001,132099503001,"Block Group 1, Census Tract 9503, Montgomery County, Georgia",1146,815,331,71.1169284468,28.8830715532
4299,1500000US132099503002,132099503002,"Block Group 2, Census Tract 9503, Montgomery County, Georgia",923,733,190,79.4149512459,20.5850487541
4300,1500000US132110101001,132110101001,"Block Group 1, Census Tract 101, Morgan County, Georgia",2817,2278,539,80.8661696841,19.1338303159
4301,1500000US132110102001,132110102001,"Block Group 1, Census Tract 102, Morgan County, Georgia",2684,2368,316,88.2265275708,11.7734724292
4302,1500000US132110102002,132110102002,"Block Group 2, Census Tract 102, Morgan County, Georgia",1160,877,283,75.6034482759,24.3965517241
4303,1500000US132110103001,132110103001,"Block Group 1, Census Tract 103, Morgan County, Georgia",2224,1614,610,72.571942446,27.428057554
4304,1500000US132110103002,132110103002,"Block Group 2, Census Tract 103, Morgan County, Georgia",1154,943,211,81.7157712305,18.2842287695
4305,1500000US132110103003,132110103003,"Block Group 3, Census Tract 103, Morgan County, Georgia",2317,1478,839,63.7893828226,36.2106171774
4306,1500000US132110103004,132110103004,"Block Group 4, Census Tract 103, Morgan County, Georgia",954,616,338,64.570230608,35.429769392
4307,1500000US132110104001,132110104001,"Block Group 1, Census Tract 104, Morgan County, Georgia",3004,2038,966,67.8428761651,32.1571238349
4308,1500000US132110105001,132110105001,"Block Group 1, Census Tract 105, Morgan County, Georgia",1414,1251,163,88.4724186704,11.5275813296
4309,1500000US132130101001,132130101001,"Block Group 1, Census Tract 101, Murray County, Georgia",841,613,228,72.8894173603,27.1105826397
4310,1500000US132130101002,132130101002,"Block Group 2, Census Tract 101, Murray County, Georgia",539,497,42,92.2077922078,7.79220779221
4311,1500000US132130101003,132130101003,"Block Group 3, Census Tract 101, Murray County, Georgia",956,637,319,66.6317991632,33.3682008368
4312,1500000US132130101004,132130101004,"Block Group 4, Census Tract 101, Murray County, Georgia",930,827,103,88.9247311828,11.0752688172
4313,1500000US132130102011,132130102011,"Block Group 1, Census Tract 102.01, Murray County, Georgia",1994,1640,354,82.2467402207,17.7532597793
4314,1500000US132130102021,132130102021,"Block Group 1, Census Tract 102.02, Murray County, Georgia",3785,2358,1427,62.2985468956,37.7014531044
4315,1500000US132130102022,132130102022,"Block Group 2, Census Tract 102.02, Murray County, Georgia",1635,1023,612,62.5688073394,37.4311926606
4316,1500000US132130102023,132130102023,"Block Group 3, Census Tract 102.02, Murray County, Georgia",2658,1076,1582,40.4815650865,59.5184349135
4317,1500000US132130102024,132130102024,"Block Group 4, Census Tract 102.02, Murray County, Georgia",973,876,97,90.0308324769,9.96916752312
4318,1500000US132130103001,132130103001,"Block Group 1, Census Tract 103, Murray County, Georgia",553,267,286,48.2820976492,51.7179023508
4319,1500000US132130103002,132130103002,"Block Group 2, Census Tract 103, Murray County, Georgia",1589,1318,271,82.945248584,17.054751416
4320,1500000US132130103003,132130103003,"Block Group 3, Census Tract 103, Murray County, Georgia",1722,1023,699,59.4076655052,40.5923344948
4321,1500000US132130104001,132130104001,"Block Group 1, Census Tract 104, Murray County, Georgia",1271,614,657,48.3084185681,51.6915814319
4322,1500000US132130104002,132130104002,"Block Group 2, Census Tract 104, Murray County, Georgia",790,720,70,91.1392405063,8.86075949367
4323,1500000US132130104003,132130104003,"Block Group 3, Census Tract 104, Murray County, Georgia",2607,1163,1444,44.610663598,55.389336402
4324,1500000US132130104004,132130104004,"Block Group 4, Census Tract 104, Murray County, Georgia",1198,654,544,54.590984975,45.409015025
4325,1500000US132130105001,132130105001,"Block Group 1, Census Tract 105, Murray County, Georgia",640,318,322,49.6875,50.3125
4326,1500000US132130105002,132130105002,"Block Group 2, Census Tract 105, Murray County, Georgia",2147,1514,633,70.5170004658,29.4829995342
4327,1500000US132130105003,132130105003,"Block Group 3, Census Tract 105, Murray County, Georgia",2527,2042,485,80.8072813613,19.1927186387
4328,1500000US132130106001,132130106001,"Block Group 1, Census Tract 106, Murray County, Georgia",1454,885,569,60.8665749656,39.1334250344
4329,1500000US132130106002,132130106002,"Block Group 2, Census Tract 106, Murray County, Georgia",1527,992,535,64.9639816634,35.0360183366
4330,1500000US132130106003,132130106003,"Block Group 3, Census Tract 106, Murray County, Georgia",1161,1046,115,90.0947459087,9.9052540913
4331,1500000US132130107001,132130107001,"Block Group 1, Census Tract 107, Murray County, Georgia",1905,1251,654,65.6692913386,34.3307086614
4332,1500000US132130107002,132130107002,"Block Group 2, Census Tract 107, Murray County, Georgia",1754,1155,599,65.8494868871,34.1505131129
4333,1500000US132130107003,132130107003,"Block Group 3, Census Tract 107, Murray County, Georgia",431,399,32,92.5754060325,7.42459396752
4334,1500000US132130107004,132130107004,"Block Group 4, Census Tract 107, Murray County, Georgia",1572,1084,488,68.9567430025,31.0432569975
4335,1500000US132150002001,132150002001,"Block Group 1, Census Tract 2, Muscogee County, Georgia",1636,643,993,39.3031784841,60.6968215159
4336,1500000US132150002002,132150002002,"Block Group 2, Census Tract 2, Muscogee County, Georgia",1187,951,236,80.1179443976,19.8820556024
4337,1500000US132150003001,132150003001,"Block Group 1, Census Tract 3, Muscogee County, Georgia",774,233,541,30.1033591731,69.8966408269
4338,1500000US132150003002,132150003002,"Block Group 2, Census Tract 3, Muscogee County, Georgia",605,103,502,17.0247933884,82.9752066116
4339,1500000US132150004001,132150004001,"Block Group 1, Census Tract 4, Muscogee County, Georgia",911,722,189,79.2535675082,20.7464324918
4340,1500000US132150004002,132150004002,"Block Group 2, Census Tract 4, Muscogee County, Georgia",1114,893,221,80.1615798923,19.8384201077
4341,1500000US132150004003,132150004003,"Block Group 3, Census Tract 4, Muscogee County, Georgia",736,554,182,75.2717391304,24.7282608696
4342,1500000US132150008001,132150008001,"Block Group 1, Census Tract 8, Muscogee County, Georgia",1040,372,668,35.7692307692,64.2307692308
4343,1500000US132150008002,132150008002,"Block Group 2, Census Tract 8, Muscogee County, Georgia",1349,465,884,34.4699777613,65.5300222387
4344,1500000US132150009001,132150009001,"Block Group 1, Census Tract 9, Muscogee County, Georgia",886,335,551,37.8103837472,62.1896162528
4345,1500000US132150009002,132150009002,"Block Group 2, Census Tract 9, Muscogee County, Georgia",1537,250,1287,16.2654521796,83.7345478204
4346,1500000US132150010001,132150010001,"Block Group 1, Census Tract 10, Muscogee County, Georgia",1014,802,212,79.0927021696,20.9072978304
4347,1500000US132150010002,132150010002,"Block Group 2, Census Tract 10, Muscogee County, Georgia",1828,771,1057,42.1772428884,57.8227571116
4348,1500000US132150010003,132150010003,"Block Group 3, Census Tract 10, Muscogee County, Georgia",700,481,219,68.7142857143,31.2857142857
4349,1500000US132150011001,132150011001,"Block Group 1, Census Tract 11, Muscogee County, Georgia",1683,1158,525,68.8057040998,31.1942959002
4350,1500000US132150011002,132150011002,"Block Group 2, Census Tract 11, Muscogee County, Georgia",938,921,17,98.1876332623,1.81236673774
4351,1500000US132150012001,132150012001,"Block Group 1, Census Tract 12, Muscogee County, Georgia",1167,584,583,50.0428449015,49.9571550985
4352,1500000US132150012002,132150012002,"Block Group 2, Census Tract 12, Muscogee County, Georgia",1071,458,613,42.7637721755,57.2362278245
4353,1500000US132150012003,132150012003,"Block Group 3, Census Tract 12, Muscogee County, Georgia",1153,355,798,30.7892454467,69.2107545533
4354,1500000US132150014001,132150014001,"Block Group 1, Census Tract 14, Muscogee County, Georgia",1004,28,976,2.78884462151,97.2111553785
4355,1500000US132150014002,132150014002,"Block Group 2, Census Tract 14, Muscogee County, Georgia",814,81,733,9.95085995086,90.0491400491
4356,1500000US132150016001,132150016001,"Block Group 1, Census Tract 16, Muscogee County, Georgia",1305,249,1056,19.0804597701,80.9195402299
4357,1500000US132150016002,132150016002,"Block Group 2, Census Tract 16, Muscogee County, Georgia",971,90,881,9.26879505664,90.7312049434
4358,1500000US132150018001,132150018001,"Block Group 1, Census Tract 18, Muscogee County, Georgia",1086,262,824,24.1252302026,75.8747697974
4359,1500000US132150020001,132150020001,"Block Group 1, Census Tract 20, Muscogee County, Georgia",2582,1411,1171,54.647560031,45.352439969
4360,1500000US132150020002,132150020002,"Block Group 2, Census Tract 20, Muscogee County, Georgia",978,529,449,54.0899795501,45.9100204499
4361,1500000US132150021001,132150021001,"Block Group 1, Census Tract 21, Muscogee County, Georgia",802,590,212,73.566084788,26.433915212
4362,1500000US132150021002,132150021002,"Block Group 2, Census Tract 21, Muscogee County, Georgia",1740,961,779,55.2298850575,44.7701149425
4363,1500000US132150022001,132150022001,"Block Group 1, Census Tract 22, Muscogee County, Georgia",990,729,261,73.6363636364,26.3636363636
4364,1500000US132150022002,132150022002,"Block Group 2, Census Tract 22, Muscogee County, Georgia",835,355,480,42.5149700599,57.4850299401
4365,1500000US132150022003,132150022003,"Block Group 3, Census Tract 22, Muscogee County, Georgia",342,260,82,76.0233918129,23.9766081871
4366,1500000US132150022004,132150022004,"Block Group 4, Census Tract 22, Muscogee County, Georgia",1180,242,938,20.5084745763,79.4915254237
4367,1500000US132150023001,132150023001,"Block Group 1, Census Tract 23, Muscogee County, Georgia",1454,584,870,40.1650618982,59.8349381018
4368,1500000US132150024001,132150024001,"Block Group 1, Census Tract 24, Muscogee County, Georgia",1515,58,1457,3.82838283828,96.1716171617
4369,1500000US132150025001,132150025001,"Block Group 1, Census Tract 25, Muscogee County, Georgia",1007,0,1007,0.0,100.0
4370,1500000US132150025002,132150025002,"Block Group 2, Census Tract 25, Muscogee County, Georgia",582,4,578,0.687285223368,99.3127147766
4371,1500000US132150027001,132150027001,"Block Group 1, Census Tract 27, Muscogee County, Georgia",2181,382,1799,17.5149014214,82.4850985786
4372,1500000US132150028001,132150028001,"Block Group 1, Census Tract 28, Muscogee County, Georgia",840,146,694,17.380952381,82.619047619
4373,1500000US132150028002,132150028002,"Block Group 2, Census Tract 28, Muscogee County, Georgia",995,369,626,37.0854271357,62.9145728643
4374,1500000US132150029011,132150029011,"Block Group 1, Census Tract 29.01, Muscogee County, Georgia",803,333,470,41.4694894147,58.5305105853
4375,1500000US132150029012,132150029012,"Block Group 2, Census Tract 29.01, Muscogee County, Georgia",2069,886,1183,42.822619623,57.177380377
4376,1500000US132150029021,132150029021,"Block Group 1, Census Tract 29.02, Muscogee County, Georgia",1409,234,1175,16.607523066,83.392476934
4377,1500000US132150029022,132150029022,"Block Group 2, Census Tract 29.02, Muscogee County, Georgia",955,590,365,61.780104712,38.219895288
4378,1500000US132150030001,132150030001,"Block Group 1, Census Tract 30, Muscogee County, Georgia",444,314,130,70.7207207207,29.2792792793
4379,1500000US132150030002,132150030002,"Block Group 2, Census Tract 30, Muscogee County, Georgia",1469,272,1197,18.5159972771,81.4840027229
4380,1500000US132150030003,132150030003,"Block Group 3, Census Tract 30, Muscogee County, Georgia",687,200,487,29.1120815138,70.8879184862
4381,1500000US132150032001,132150032001,"Block Group 1, Census Tract 32, Muscogee County, Georgia",340,16,324,4.70588235294,95.2941176471
4382,1500000US132150032002,132150032002,"Block Group 2, Census Tract 32, Muscogee County, Georgia",732,72,660,9.83606557377,90.1639344262
4383,1500000US132150032003,132150032003,"Block Group 3, Census Tract 32, Muscogee County, Georgia",699,259,440,37.0529327611,62.9470672389
4384,1500000US132150033011,132150033011,"Block Group 1, Census Tract 33.01, Muscogee County, Georgia",1428,739,689,51.7507002801,48.2492997199
4385,1500000US132150033021,132150033021,"Block Group 1, Census Tract 33.02, Muscogee County, Georgia",825,193,632,23.3939393939,76.6060606061
4386,1500000US132150033022,132150033022,"Block Group 2, Census Tract 33.02, Muscogee County, Georgia",944,440,504,46.6101694915,53.3898305085
4387,1500000US132150033023,132150033023,"Block Group 3, Census Tract 33.02, Muscogee County, Georgia",887,267,620,30.1014656144,69.8985343856
4388,1500000US132150034001,132150034001,"Block Group 1, Census Tract 34, Muscogee County, Georgia",716,47,669,6.56424581006,93.4357541899
4389,1500000US132150034002,132150034002,"Block Group 2, Census Tract 34, Muscogee County, Georgia",1609,233,1376,14.4810441268,85.5189558732
4390,1500000US132150101041,132150101041,"Block Group 1, Census Tract 101.04, Muscogee County, Georgia",1655,451,1204,27.250755287,72.749244713
4391,1500000US132150101042,132150101042,"Block Group 2, Census Tract 101.04, Muscogee County, Georgia",3004,1465,1539,48.7683089214,51.2316910786
4392,1500000US132150101043,132150101043,"Block Group 3, Census Tract 101.04, Muscogee County, Georgia",1918,254,1664,13.2429614181,86.7570385819
4393,1500000US132150101061,132150101061,"Block Group 1, Census Tract 101.06, Muscogee County, Georgia",698,499,199,71.4899713467,28.5100286533
4394,1500000US132150101062,132150101062,"Block Group 2, Census Tract 101.06, Muscogee County, Georgia",1875,1246,629,66.4533333333,33.5466666667
4395,1500000US132150101063,132150101063,"Block Group 3, Census Tract 101.06, Muscogee County, Georgia",2937,2337,600,79.5709908069,20.4290091931
4396,1500000US132150101071,132150101071,"Block Group 1, Census Tract 101.07, Muscogee County, Georgia",3299,2994,305,90.754774174,9.24522582601
4397,1500000US132150101072,132150101072,"Block Group 2, Census Tract 101.07, Muscogee County, Georgia",4456,3490,966,78.3213644524,21.6786355476
4398,1500000US132150102011,132150102011,"Block Group 1, Census Tract 102.01, Muscogee County, Georgia",4448,2110,2338,47.4370503597,52.5629496403
4399,1500000US132150102012,132150102012,"Block Group 2, Census Tract 102.01, Muscogee County, Georgia",2290,2234,56,97.5545851528,2.44541484716
4400,1500000US132150102031,132150102031,"Block Group 1, Census Tract 102.03, Muscogee County, Georgia",3717,2319,1398,62.389023406,37.610976594
4401,1500000US132150102032,132150102032,"Block Group 2, Census Tract 102.03, Muscogee County, Georgia",5076,2922,2154,57.5650118203,42.4349881797
4402,1500000US132150102041,132150102041,"Block Group 1, Census Tract 102.04, Muscogee County, Georgia",2230,1475,755,66.1434977578,33.8565022422
4403,1500000US132150102042,132150102042,"Block Group 2, Census Tract 102.04, Muscogee County, Georgia",1536,398,1138,25.9114583333,74.0885416667
4404,1500000US132150102043,132150102043,"Block Group 3, Census Tract 102.04, Muscogee County, Georgia",2724,1786,938,65.5653450808,34.4346549192
4405,1500000US132150102051,132150102051,"Block Group 1, Census Tract 102.05, Muscogee County, Georgia",1523,470,1053,30.8601444517,69.1398555483
4406,1500000US132150102052,132150102052,"Block Group 2, Census Tract 102.05, Muscogee County, Georgia",1981,1110,871,56.0323069157,43.9676930843
4407,1500000US132150103011,132150103011,"Block Group 1, Census Tract 103.01, Muscogee County, Georgia",2469,2244,225,90.8869987849,9.11300121507
4408,1500000US132150103021,132150103021,"Block Group 1, Census Tract 103.02, Muscogee County, Georgia",1702,1164,538,68.3901292597,31.6098707403
4409,1500000US132150103022,132150103022,"Block Group 2, Census Tract 103.02, Muscogee County, Georgia",2729,1363,1366,49.9450348113,50.0549651887
4410,1500000US132150103023,132150103023,"Block Group 3, Census Tract 103.02, Muscogee County, Georgia",2515,2186,329,86.9184890656,13.0815109344
4411,1500000US132150104011,132150104011,"Block Group 1, Census Tract 104.01, Muscogee County, Georgia",2165,1726,439,79.7228637413,20.2771362587
4412,1500000US132150104012,132150104012,"Block Group 2, Census Tract 104.01, Muscogee County, Georgia",2936,2560,376,87.1934604905,12.8065395095
4413,1500000US132150104013,132150104013,"Block Group 3, Census Tract 104.01, Muscogee County, Georgia",1545,761,784,49.2556634304,50.7443365696
4414,1500000US132150104021,132150104021,"Block Group 1, Census Tract 104.02, Muscogee County, Georgia",1097,124,973,11.3035551504,88.6964448496
4415,1500000US132150104022,132150104022,"Block Group 2, Census Tract 104.02, Muscogee County, Georgia",1430,526,904,36.7832167832,63.2167832168
4416,1500000US132150104023,132150104023,"Block Group 3, Census Tract 104.02, Muscogee County, Georgia",1699,1022,677,60.1530311948,39.8469688052
4417,1500000US132150105011,132150105011,"Block Group 1, Census Tract 105.01, Muscogee County, Georgia",1128,841,287,74.5567375887,25.4432624113
4418,1500000US132150105012,132150105012,"Block Group 2, Census Tract 105.01, Muscogee County, Georgia",1759,1230,529,69.9260943718,30.0739056282
4419,1500000US132150105013,132150105013,"Block Group 3, Census Tract 105.01, Muscogee County, Georgia",1598,1262,336,78.9737171464,21.0262828536
4420,1500000US132150105014,132150105014,"Block Group 4, Census Tract 105.01, Muscogee County, Georgia",1533,442,1091,28.8323548598,71.1676451402
4421,1500000US132150105021,132150105021,"Block Group 1, Census Tract 105.02, Muscogee County, Georgia",1593,319,1274,20.0251098556,79.9748901444
4422,1500000US132150106021,132150106021,"Block Group 1, Census Tract 106.02, Muscogee County, Georgia",2280,1375,905,60.3070175439,39.6929824561
4423,1500000US132150106022,132150106022,"Block Group 2, Census Tract 106.02, Muscogee County, Georgia",493,441,52,89.4523326572,10.5476673428
4424,1500000US132150106023,132150106023,"Block Group 3, Census Tract 106.02, Muscogee County, Georgia",2610,1386,1224,53.1034482759,46.8965517241
4425,1500000US132150106051,132150106051,"Block Group 1, Census Tract 106.05, Muscogee County, Georgia",2190,1438,752,65.6621004566,34.3378995434
4426,1500000US132150106052,132150106052,"Block Group 2, Census Tract 106.05, Muscogee County, Georgia",2302,1514,788,65.7688966116,34.2311033884
4427,1500000US132150106061,132150106061,"Block Group 1, Census Tract 106.06, Muscogee County, Georgia",17,3,14,17.6470588235,82.3529411765
4428,1500000US132150106071,132150106071,"Block Group 1, Census Tract 106.07, Muscogee County, Georgia",1292,856,436,66.253869969,33.746130031
4429,1500000US132150106072,132150106072,"Block Group 2, Census Tract 106.07, Muscogee County, Georgia",2002,1403,599,70.0799200799,29.9200799201
4430,1500000US132150106073,132150106073,"Block Group 3, Census Tract 106.07, Muscogee County, Georgia",2669,1319,1350,49.4192581491,50.5807418509
4431,1500000US132150106081,132150106081,"Block Group 1, Census Tract 106.08, Muscogee County, Georgia",2373,1718,655,72.397808681,27.602191319
4432,1500000US132150106082,132150106082,"Block Group 2, Census Tract 106.08, Muscogee County, Georgia",2211,1394,817,63.0483943917,36.9516056083
4433,1500000US132150107011,132150107011,"Block Group 1, Census Tract 107.01, Muscogee County, Georgia",2091,1550,541,74.1272118604,25.8727881396
4434,1500000US132150107012,132150107012,"Block Group 2, Census Tract 107.01, Muscogee County, Georgia",2165,1636,529,75.5658198614,24.4341801386
4435,1500000US132150107013,132150107013,"Block Group 3, Census Tract 107.01, Muscogee County, Georgia",1876,761,1115,40.5650319829,59.4349680171
4436,1500000US132150107021,132150107021,"Block Group 1, Census Tract 107.02, Muscogee County, Georgia",769,544,225,70.7412223667,29.2587776333
4437,1500000US132150107022,132150107022,"Block Group 2, Census Tract 107.02, Muscogee County, Georgia",2328,1730,598,74.3127147766,25.6872852234
4438,1500000US132150107023,132150107023,"Block Group 3, Census Tract 107.02, Muscogee County, Georgia",1828,1248,580,68.2713347921,31.7286652079
4439,1500000US132150107031,132150107031,"Block Group 1, Census Tract 107.03, Muscogee County, Georgia",1782,1283,499,71.9977553311,28.0022446689
4440,1500000US132150107032,132150107032,"Block Group 2, Census Tract 107.03, Muscogee County, Georgia",2271,833,1438,36.6798767063,63.3201232937
4441,1500000US132150107033,132150107033,"Block Group 3, Census Tract 107.03, Muscogee County, Georgia",1151,782,369,67.9409209383,32.0590790617
4442,1500000US132150107034,132150107034,"Block Group 4, Census Tract 107.03, Muscogee County, Georgia",945,492,453,52.0634920635,47.9365079365
4443,1500000US132150108011,132150108011,"Block Group 1, Census Tract 108.01, Muscogee County, Georgia",308,0,308,0.0,100.0
4444,1500000US132150108012,132150108012,"Block Group 2, Census Tract 108.01, Muscogee County, Georgia",1288,0,1288,0.0,100.0
4445,1500000US132150108021,132150108021,"Block Group 1, Census Tract 108.02, Muscogee County, Georgia",2390,0,2390,0.0,100.0
4446,1500000US132150108022,132150108022,"Block Group 2, Census Tract 108.02, Muscogee County, Georgia",2430,0,2430,0.0,100.0
4447,1500000US132150108023,132150108023,"Block Group 3, Census Tract 108.02, Muscogee County, Georgia",343,0,343,0.0,100.0
4448,1500000US132150111001,132150111001,"Block Group 1, Census Tract 111, Muscogee County, Georgia",1005,227,778,22.5870646766,77.4129353234
4449,1500000US132150111002,132150111002,"Block Group 2, Census Tract 111, Muscogee County, Georgia",371,9,362,2.42587601078,97.5741239892
4450,1500000US132150112001,132150112001,"Block Group 1, Census Tract 112, Muscogee County, Georgia",1181,538,643,45.5546147333,54.4453852667
4451,1500000US132150112002,132150112002,"Block Group 2, Census Tract 112, Muscogee County, Georgia",1041,108,933,10.3746397695,89.6253602305
4452,1500000US132150114001,132150114001,"Block Group 1, Census Tract 114, Muscogee County, Georgia",1535,277,1258,18.0456026059,81.9543973941
4453,1500000US132150114002,132150114002,"Block Group 2, Census Tract 114, Muscogee County, Georgia",732,242,490,33.0601092896,66.9398907104
4454,1500000US132150115001,132150115001,"Block Group 1, Census Tract 115, Muscogee County, Georgia",1027,635,392,61.8305744888,38.1694255112
4455,1500000US132150115002,132150115002,"Block Group 2, Census Tract 115, Muscogee County, Georgia",488,224,264,45.9016393443,54.0983606557
4456,1500000US132150115003,132150115003,"Block Group 3, Census Tract 115, Muscogee County, Georgia",1657,947,710,57.1514785757,42.8485214243
4457,1500000US132150115004,132150115004,"Block Group 4, Census Tract 115, Muscogee County, Georgia",1241,352,889,28.3642224013,71.6357775987
4458,1500000US132150115005,132150115005,"Block Group 5, Census Tract 115, Muscogee County, Georgia",1127,453,674,40.1952085182,59.8047914818
4459,1500000US132150115006,132150115006,"Block Group 6, Census Tract 115, Muscogee County, Georgia",538,416,122,77.3234200743,22.6765799257
4460,1500000US132171001001,132171001001,"Block Group 1, Census Tract 1001, Newton County, Georgia",2455,2396,59,97.5967413442,2.4032586558
4461,1500000US132171001002,132171001002,"Block Group 2, Census Tract 1001, Newton County, Georgia",3098,2294,804,74.0477727566,25.9522272434
4462,1500000US132171001003,132171001003,"Block Group 3, Census Tract 1001, Newton County, Georgia",2792,2504,288,89.6848137536,10.3151862464
4463,1500000US132171001004,132171001004,"Block Group 4, Census Tract 1001, Newton County, Georgia",2576,1758,818,68.2453416149,31.7546583851
4464,1500000US132171002011,132171002011,"Block Group 1, Census Tract 1002.01, Newton County, Georgia",1971,1739,232,88.2293252156,11.7706747844
4465,1500000US132171002012,132171002012,"Block Group 2, Census Tract 1002.01, Newton County, Georgia",1269,1006,263,79.2750197006,20.7249802994
4466,1500000US132171002013,132171002013,"Block Group 3, Census Tract 1002.01, Newton County, Georgia",2777,2368,409,85.2718761253,14.7281238747
4467,1500000US132171002021,132171002021,"Block Group 1, Census Tract 1002.02, Newton County, Georgia",2885,2483,402,86.0658578856,13.9341421144
4468,1500000US132171002022,132171002022,"Block Group 2, Census Tract 1002.02, Newton County, Georgia",2153,1877,276,87.1806781235,12.8193218765
4469,1500000US132171003001,132171003001,"Block Group 1, Census Tract 1003, Newton County, Georgia",2498,1878,620,75.1801441153,24.8198558847
4470,1500000US132171003002,132171003002,"Block Group 2, Census Tract 1003, Newton County, Georgia",3125,2462,663,78.784,21.216
4471,1500000US132171003003,132171003003,"Block Group 3, Census Tract 1003, Newton County, Georgia",2436,122,2314,5.00821018062,94.9917898194
4472,1500000US132171003004,132171003004,"Block Group 4, Census Tract 1003, Newton County, Georgia",1103,599,504,54.30643699,45.69356301
4473,1500000US132171004001,132171004001,"Block Group 1, Census Tract 1004, Newton County, Georgia",1913,892,1021,46.6283324621,53.3716675379
4474,1500000US132171004002,132171004002,"Block Group 2, Census Tract 1004, Newton County, Georgia",945,477,468,50.4761904762,49.5238095238
4475,1500000US132171005011,132171005011,"Block Group 1, Census Tract 1005.01, Newton County, Georgia",5602,3069,2533,54.7840057122,45.2159942878
4476,1500000US132171005012,132171005012,"Block Group 2, Census Tract 1005.01, Newton County, Georgia",8924,5308,3616,59.4800537875,40.5199462125
4477,1500000US132171005013,132171005013,"Block Group 3, Census Tract 1005.01, Newton County, Georgia",960,862,98,89.7916666667,10.2083333333
4478,1500000US132171005021,132171005021,"Block Group 1, Census Tract 1005.02, Newton County, Georgia",5292,3592,1700,67.8760393046,32.1239606954
4479,1500000US132171005022,132171005022,"Block Group 2, Census Tract 1005.02, Newton County, Georgia",3012,1352,1660,44.8871181939,55.1128818061
4480,1500000US132171006001,132171006001,"Block Group 1, Census Tract 1006, Newton County, Georgia",3640,2555,1085,70.1923076923,29.8076923077
4481,1500000US132171006002,132171006002,"Block Group 2, Census Tract 1006, Newton County, Georgia",1879,771,1108,41.0324640766,58.9675359234
4482,1500000US132171007001,132171007001,"Block Group 1, Census Tract 1007, Newton County, Georgia",980,675,305,68.8775510204,31.1224489796
4483,1500000US132171007002,132171007002,"Block Group 2, Census Tract 1007, Newton County, Georgia",2435,1543,892,63.3675564682,36.6324435318
4484,1500000US132171007003,132171007003,"Block Group 3, Census Tract 1007, Newton County, Georgia",2714,850,1864,31.3190862196,68.6809137804
4485,1500000US132171008001,132171008001,"Block Group 1, Census Tract 1008, Newton County, Georgia",3842,3022,820,78.6569495055,21.3430504945
4486,1500000US132171008002,132171008002,"Block Group 2, Census Tract 1008, Newton County, Georgia",5899,3991,1908,67.6555348364,32.3444651636
4487,1500000US132171009011,132171009011,"Block Group 1, Census Tract 1009.01, Newton County, Georgia",4170,3442,728,82.5419664269,17.4580335731
4488,1500000US132171009012,132171009012,"Block Group 2, Census Tract 1009.01, Newton County, Georgia",3441,2735,706,79.482708515,20.517291485
4489,1500000US132171009013,132171009013,"Block Group 3, Census Tract 1009.01, Newton County, Georgia",2410,2175,235,90.2489626556,9.7510373444
4490,1500000US132171009021,132171009021,"Block Group 1, Census Tract 1009.02, Newton County, Georgia",2960,2517,443,85.0337837838,14.9662162162
4491,1500000US132171009022,132171009022,"Block Group 2, Census Tract 1009.02, Newton County, Georgia",2901,1845,1056,63.5987590486,36.4012409514
4492,1500000US132171009031,132171009031,"Block Group 1, Census Tract 1009.03, Newton County, Georgia",4924,3391,1533,68.8667749797,31.1332250203
4493,1500000US132171009032,132171009032,"Block Group 2, Census Tract 1009.03, Newton County, Georgia",1211,922,289,76.1354252684,23.8645747316
4494,1500000US132190301001,132190301001,"Block Group 1, Census Tract 301, Oconee County, Georgia",3854,3314,540,85.9885832901,14.0114167099
4495,1500000US132190301002,132190301002,"Block Group 2, Census Tract 301, Oconee County, Georgia",4170,3194,976,76.5947242206,23.4052757794
4496,1500000US132190301003,132190301003,"Block Group 3, Census Tract 301, Oconee County, Georgia",2061,1558,503,75.5943716642,24.4056283358
4497,1500000US132190301004,132190301004,"Block Group 4, Census Tract 301, Oconee County, Georgia",1492,1259,233,84.3833780161,15.6166219839
4498,1500000US132190302001,132190302001,"Block Group 1, Census Tract 302, Oconee County, Georgia",2637,1715,922,65.0360257869,34.9639742131
4499,1500000US132190302002,132190302002,"Block Group 2, Census Tract 302, Oconee County, Georgia",2876,2314,562,80.4589707928,19.5410292072
4500,1500000US132190303001,132190303001,"Block Group 1, Census Tract 303, Oconee County, Georgia",2951,2747,204,93.0870891223,6.91291087767
4501,1500000US132190303002,132190303002,"Block Group 2, Census Tract 303, Oconee County, Georgia",2141,1432,709,66.8846333489,33.1153666511
4502,1500000US132190304001,132190304001,"Block Group 1, Census Tract 304, Oconee County, Georgia",1855,1387,468,74.7708894879,25.2291105121
4503,1500000US132190304002,132190304002,"Block Group 2, Census Tract 304, Oconee County, Georgia",2160,2001,159,92.6388888889,7.36111111111
4504,1500000US132190304003,132190304003,"Block Group 3, Census Tract 304, Oconee County, Georgia",3096,2304,792,74.4186046512,25.5813953488
4505,1500000US132190305001,132190305001,"Block Group 1, Census Tract 305, Oconee County, Georgia",2118,1931,187,91.1709159585,8.82908404155
4506,1500000US132190306001,132190306001,"Block Group 1, Census Tract 306, Oconee County, Georgia",1923,1605,318,83.4633385335,16.5366614665
4507,1500000US132190306002,132190306002,"Block Group 2, Census Tract 306, Oconee County, Georgia",851,761,90,89.4242068155,10.5757931845
4508,1500000US132219601001,132219601001,"Block Group 1, Census Tract 9601, Oglethorpe County, Georgia",816,720,96,88.2352941176,11.7647058824
4509,1500000US132219601002,132219601002,"Block Group 2, Census Tract 9601, Oglethorpe County, Georgia",927,708,219,76.3754045307,23.6245954693
4510,1500000US132219602011,132219602011,"Block Group 1, Census Tract 9602.01, Oglethorpe County, Georgia",1879,1413,466,75.1995742416,24.8004257584
4511,1500000US132219602012,132219602012,"Block Group 2, Census Tract 9602.01, Oglethorpe County, Georgia",1352,1124,228,83.1360946746,16.8639053254
4512,1500000US132219602013,132219602013,"Block Group 3, Census Tract 9602.01, Oglethorpe County, Georgia",3454,2572,882,74.4643891141,25.5356108859
4513,1500000US132219602021,132219602021,"Block Group 1, Census Tract 9602.02, Oglethorpe County, Georgia",1635,1320,315,80.7339449541,19.2660550459
4514,1500000US132219602022,132219602022,"Block Group 2, Census Tract 9602.02, Oglethorpe County, Georgia",990,723,267,73.0303030303,26.9696969697
4515,1500000US132219602023,132219602023,"Block Group 3, Census Tract 9602.02, Oglethorpe County, Georgia",1813,1256,557,69.277440706,30.722559294
4516,1500000US132219603001,132219603001,"Block Group 1, Census Tract 9603, Oglethorpe County, Georgia",1683,1250,433,74.2721330957,25.7278669043
4517,1500000US132231201011,132231201011,"Block Group 1, Census Tract 1201.01, Paulding County, Georgia",5869,4931,938,84.0177202249,15.9822797751
4518,1500000US132231201012,132231201012,"Block Group 2, Census Tract 1201.01, Paulding County, Georgia",4608,3754,854,81.4670138889,18.5329861111
4519,1500000US132231201013,132231201013,"Block Group 3, Census Tract 1201.01, Paulding County, Georgia",1419,1290,129,90.9090909091,9.09090909091
4520,1500000US132231201021,132231201021,"Block Group 1, Census Tract 1201.02, Paulding County, Georgia",5504,4898,606,88.9898255814,11.0101744186
4521,1500000US132231201022,132231201022,"Block Group 2, Census Tract 1201.02, Paulding County, Georgia",5993,5627,366,93.8928750209,6.10712497914
4522,1500000US132231201031,132231201031,"Block Group 1, Census Tract 1201.03, Paulding County, Georgia",2665,2235,430,83.8649155722,16.1350844278
4523,1500000US132231201032,132231201032,"Block Group 2, Census Tract 1201.03, Paulding County, Georgia",6987,6066,921,86.8183769858,13.1816230142
4524,1500000US132231201041,132231201041,"Block Group 1, Census Tract 1201.04, Paulding County, Georgia",2367,2075,292,87.6637093367,12.3362906633
4525,1500000US132231202021,132231202021,"Block Group 1, Census Tract 1202.02, Paulding County, Georgia",5187,4271,916,82.340466551,17.659533449
4526,1500000US132231202022,132231202022,"Block Group 2, Census Tract 1202.02, Paulding County, Georgia",2557,2046,511,80.015643332,19.984356668
4527,1500000US132231202031,132231202031,"Block Group 1, Census Tract 1202.03, Paulding County, Georgia",2432,1863,569,76.6036184211,23.3963815789
4528,1500000US132231202032,132231202032,"Block Group 2, Census Tract 1202.03, Paulding County, Georgia",2621,2014,607,76.8409004197,23.1590995803
4529,1500000US132231202041,132231202041,"Block Group 1, Census Tract 1202.04, Paulding County, Georgia",3950,2316,1634,58.6329113924,41.3670886076
4530,1500000US132231202042,132231202042,"Block Group 2, Census Tract 1202.04, Paulding County, Georgia",2711,2628,83,96.9383991147,3.06160088528
4531,1500000US132231203011,132231203011,"Block Group 1, Census Tract 1203.01, Paulding County, Georgia",3743,1813,1930,48.4370825541,51.5629174459
4532,1500000US132231203012,132231203012,"Block Group 2, Census Tract 1203.01, Paulding County, Georgia",1546,1263,283,81.6946959897,18.3053040103
4533,1500000US132231203021,132231203021,"Block Group 1, Census Tract 1203.02, Paulding County, Georgia",2286,1985,301,86.832895888,13.167104112
4534,1500000US132231203022,132231203022,"Block Group 2, Census Tract 1203.02, Paulding County, Georgia",3949,2059,1890,52.1397822233,47.8602177767
4535,1500000US132231203023,132231203023,"Block Group 3, Census Tract 1203.02, Paulding County, Georgia",3845,3066,779,79.7399219766,20.2600780234
4536,1500000US132231203024,132231203024,"Block Group 4, Census Tract 1203.02, Paulding County, Georgia",3740,1123,2617,30.0267379679,69.9732620321
4537,1500000US132231203031,132231203031,"Block Group 1, Census Tract 1203.03, Paulding County, Georgia",1833,1269,564,69.2307692308,30.7692307692
4538,1500000US132231204001,132231204001,"Block Group 1, Census Tract 1204, Paulding County, Georgia",7050,5650,1400,80.1418439716,19.8581560284
4539,1500000US132231204002,132231204002,"Block Group 2, Census Tract 1204, Paulding County, Georgia",5743,4403,1340,76.6672470834,23.3327529166
4540,1500000US132231204003,132231204003,"Block Group 3, Census Tract 1204, Paulding County, Georgia",1775,1360,415,76.6197183099,23.3802816901
4541,1500000US132231204004,132231204004,"Block Group 4, Census Tract 1204, Paulding County, Georgia",3735,3264,471,87.3895582329,12.6104417671
4542,1500000US132231205011,132231205011,"Block Group 1, Census Tract 1205.01, Paulding County, Georgia",3706,2744,962,74.0420939018,25.9579060982
4543,1500000US132231205012,132231205012,"Block Group 2, Census Tract 1205.01, Paulding County, Georgia",2499,1638,861,65.5462184874,34.4537815126
4544,1500000US132231205021,132231205021,"Block Group 1, Census Tract 1205.02, Paulding County, Georgia",1589,897,692,56.4505978603,43.5494021397
4545,1500000US132231205022,132231205022,"Block Group 2, Census Tract 1205.02, Paulding County, Georgia",1459,1286,173,88.1425633996,11.8574366004
4546,1500000US132231205023,132231205023,"Block Group 3, Census Tract 1205.02, Paulding County, Georgia",2899,2175,724,75.02587099,24.97412901
4547,1500000US132231205024,132231205024,"Block Group 4, Census Tract 1205.02, Paulding County, Georgia",1675,1272,403,75.9402985075,24.0597014925
4548,1500000US132231205025,132231205025,"Block Group 5, Census Tract 1205.02, Paulding County, Georgia",1401,1181,220,84.2969307637,15.7030692363
4549,1500000US132231205031,132231205031,"Block Group 1, Census Tract 1205.03, Paulding County, Georgia",3938,3559,379,90.375825292,9.62417470797
4550,1500000US132231205032,132231205032,"Block Group 2, Census Tract 1205.03, Paulding County, Georgia",1318,919,399,69.7268588771,30.2731411229
4551,1500000US132231206011,132231206011,"Block Group 1, Census Tract 1206.01, Paulding County, Georgia",2504,2326,178,92.8913738019,7.10862619808
4552,1500000US132231206012,132231206012,"Block Group 2, Census Tract 1206.01, Paulding County, Georgia",1888,1714,174,90.7838983051,9.21610169492
4553,1500000US132231206021,132231206021,"Block Group 1, Census Tract 1206.02, Paulding County, Georgia",1035,712,323,68.7922705314,31.2077294686
4554,1500000US132231206022,132231206022,"Block Group 2, Census Tract 1206.02, Paulding County, Georgia",3506,2989,517,85.2538505419,14.7461494581
4555,1500000US132231206023,132231206023,"Block Group 3, Census Tract 1206.02, Paulding County, Georgia",1904,1812,92,95.1680672269,4.83193277311
4556,1500000US132231206024,132231206024,"Block Group 4, Census Tract 1206.02, Paulding County, Georgia",3272,3021,251,92.3288508557,7.67114914425
4557,1500000US132231206031,132231206031,"Block Group 1, Census Tract 1206.03, Paulding County, Georgia",3578,2304,1274,64.3935159307,35.6064840693
4558,1500000US132231206032,132231206032,"Block Group 2, Census Tract 1206.03, Paulding County, Georgia",2622,2072,550,79.0236460717,20.9763539283
4559,1500000US132231206041,132231206041,"Block Group 1, Census Tract 1206.04, Paulding County, Georgia",2501,2414,87,96.5213914434,3.47860855658
4560,1500000US132231206042,132231206042,"Block Group 2, Census Tract 1206.04, Paulding County, Georgia",3142,2724,418,86.6963717377,13.3036282623
4561,1500000US132231206051,132231206051,"Block Group 1, Census Tract 1206.05, Paulding County, Georgia",4715,3699,1016,78.4517497349,21.5482502651
4562,1500000US132231206052,132231206052,"Block Group 2, Census Tract 1206.05, Paulding County, Georgia",1502,1347,155,89.6804260985,10.3195739015
4563,1500000US132250401011,132250401011,"Block Group 1, Census Tract 401.01, Peach County, Georgia",1695,1521,174,89.7345132743,10.2654867257
4564,1500000US132250401021,132250401021,"Block Group 1, Census Tract 401.02, Peach County, Georgia",3609,2475,1134,68.578553616,31.421446384
4565,1500000US132250401022,132250401022,"Block Group 2, Census Tract 401.02, Peach County, Georgia",1682,1584,98,94.1736028537,5.82639714625
4566,1500000US132250401023,132250401023,"Block Group 3, Census Tract 401.02, Peach County, Georgia",3420,2780,640,81.2865497076,18.7134502924
4567,1500000US132250401024,132250401024,"Block Group 4, Census Tract 401.02, Peach County, Georgia",1303,717,586,55.0268610898,44.9731389102
4568,1500000US132250402001,132250402001,"Block Group 1, Census Tract 402, Peach County, Georgia",2140,1239,901,57.8971962617,42.1028037383
4569,1500000US132250402002,132250402002,"Block Group 2, Census Tract 402, Peach County, Georgia",2262,1554,708,68.700265252,31.299734748
4570,1500000US132250403011,132250403011,"Block Group 1, Census Tract 403.01, Peach County, Georgia",1624,1342,282,82.6354679803,17.3645320197
4571,1500000US132250403012,132250403012,"Block Group 2, Census Tract 403.01, Peach County, Georgia",1016,799,217,78.6417322835,21.3582677165
4572,1500000US132250403021,132250403021,"Block Group 1, Census Tract 403.02, Peach County, Georgia",2084,699,1385,33.5412667946,66.4587332054
4573,1500000US132250404001,132250404001,"Block Group 1, Census Tract 404, Peach County, Georgia",2265,1405,860,62.0309050773,37.9690949227
4574,1500000US132250404002,132250404002,"Block Group 2, Census Tract 404, Peach County, Georgia",1710,410,1300,23.9766081871,76.0233918129
4575,1500000US132270501001,132270501001,"Block Group 1, Census Tract 501, Pickens County, Georgia",2017,1979,38,98.116013882,1.883986118
4576,1500000US132270501002,132270501002,"Block Group 2, Census Tract 501, Pickens County, Georgia",1747,1503,244,86.033199771,13.966800229
4577,1500000US132270501003,132270501003,"Block Group 3, Census Tract 501, Pickens County, Georgia",1343,967,376,72.0029784066,27.9970215934
4578,1500000US132270502001,132270502001,"Block Group 1, Census Tract 502, Pickens County, Georgia",1462,1077,385,73.6662106703,26.3337893297
4579,1500000US132270502002,132270502002,"Block Group 2, Census Tract 502, Pickens County, Georgia",1997,1385,612,69.3540310466,30.6459689534
4580,1500000US132270502003,132270502003,"Block Group 3, Census Tract 502, Pickens County, Georgia",997,470,527,47.1414242728,52.8585757272
4581,1500000US132270502004,132270502004,"Block Group 4, Census Tract 502, Pickens County, Georgia",1588,1066,522,67.1284634761,32.8715365239
4582,1500000US132270503001,132270503001,"Block Group 1, Census Tract 503, Pickens County, Georgia",1761,1426,335,80.976717774,19.023282226
4583,1500000US132270503002,132270503002,"Block Group 2, Census Tract 503, Pickens County, Georgia",2478,2173,305,87.6916868442,12.3083131558
4584,1500000US132270504001,132270504001,"Block Group 1, Census Tract 504, Pickens County, Georgia",1888,1702,186,90.1483050847,9.85169491525
4585,1500000US132270504002,132270504002,"Block Group 2, Census Tract 504, Pickens County, Georgia",2014,1179,835,58.5402184707,41.4597815293
4586,1500000US132270505001,132270505001,"Block Group 1, Census Tract 505, Pickens County, Georgia",1694,1017,677,60.0354191263,39.9645808737
4587,1500000US132270505002,132270505002,"Block Group 2, Census Tract 505, Pickens County, Georgia",2686,2234,452,83.1720029784,16.8279970216
4588,1500000US132270506001,132270506001,"Block Group 1, Census Tract 506, Pickens County, Georgia",1750,1108,642,63.3142857143,36.6857142857
4589,1500000US132270506002,132270506002,"Block Group 2, Census Tract 506, Pickens County, Georgia",518,425,93,82.0463320463,17.9536679537
4590,1500000US132270506003,132270506003,"Block Group 3, Census Tract 506, Pickens County, Georgia",1741,1484,257,85.2383687536,14.7616312464
4591,1500000US132270506004,132270506004,"Block Group 4, Census Tract 506, Pickens County, Georgia",1732,977,755,56.4087759815,43.5912240185
4592,1500000US132299601001,132299601001,"Block Group 1, Census Tract 9601, Pierce County, Georgia",1349,988,361,73.2394366197,26.7605633803
4593,1500000US132299601002,132299601002,"Block Group 2, Census Tract 9601, Pierce County, Georgia",1283,827,456,64.4583008574,35.5416991426
4594,1500000US132299602001,132299602001,"Block Group 1, Census Tract 9602, Pierce County, Georgia",988,649,339,65.6882591093,34.3117408907
4595,1500000US132299602002,132299602002,"Block Group 2, Census Tract 9602, Pierce County, Georgia",899,598,301,66.5183537264,33.4816462736
4596,1500000US132299603001,132299603001,"Block Group 1, Census Tract 9603, Pierce County, Georgia",2194,1706,488,77.7575205105,22.2424794895
4597,1500000US132299603002,132299603002,"Block Group 2, Census Tract 9603, Pierce County, Georgia",1424,1257,167,88.2724719101,11.7275280899
4598,1500000US132299603003,132299603003,"Block Group 3, Census Tract 9603, Pierce County, Georgia",1504,567,937,37.6994680851,62.3005319149
4599,1500000US132299603004,132299603004,"Block Group 4, Census Tract 9603, Pierce County, Georgia",1425,1087,338,76.2807017544,23.7192982456
4600,1500000US132299604001,132299604001,"Block Group 1, Census Tract 9604, Pierce County, Georgia",1685,1119,566,66.409495549,33.590504451
4601,1500000US132299604002,132299604002,"Block Group 2, Census Tract 9604, Pierce County, Georgia",1502,1366,136,90.9454061252,9.05459387483
4602,1500000US132299604003,132299604003,"Block Group 3, Census Tract 9604, Pierce County, Georgia",1383,1253,130,90.6001446132,9.39985538684
4603,1500000US132299604004,132299604004,"Block Group 4, Census Tract 9604, Pierce County, Georgia",3127,2544,583,81.3559322034,18.6440677966
4604,1500000US132310101001,132310101001,"Block Group 1, Census Tract 101, Pike County, Georgia",2455,2163,292,88.1059063136,11.8940936864
4605,1500000US132310101002,132310101002,"Block Group 2, Census Tract 101, Pike County, Georgia",2290,1836,454,80.1746724891,19.8253275109
4606,1500000US132310101003,132310101003,"Block Group 3, Census Tract 101, Pike County, Georgia",1993,1351,642,67.7872553939,32.2127446061
4607,1500000US132310102001,132310102001,"Block Group 1, Census Tract 102, Pike County, Georgia",3516,3153,363,89.6757679181,10.3242320819
4608,1500000US132310103001,132310103001,"Block Group 1, Census Tract 103, Pike County, Georgia",1531,1163,368,75.9634225996,24.0365774004
4609,1500000US132310103002,132310103002,"Block Group 2, Census Tract 103, Pike County, Georgia",2549,2115,434,82.9737151824,17.0262848176
4610,1500000US132310104001,132310104001,"Block Group 1, Census Tract 104, Pike County, Georgia",1386,1286,100,92.784992785,7.21500721501
4611,1500000US132310104002,132310104002,"Block Group 2, Census Tract 104, Pike County, Georgia",1837,1646,191,89.6026129559,10.3973870441
4612,1500000US132330101001,132330101001,"Block Group 1, Census Tract 101, Polk County, Georgia",1342,931,411,69.3740685544,30.6259314456
4613,1500000US132330101002,132330101002,"Block Group 2, Census Tract 101, Polk County, Georgia",852,549,303,64.4366197183,35.5633802817
4614,1500000US132330101003,132330101003,"Block Group 3, Census Tract 101, Polk County, Georgia",1510,1426,84,94.4370860927,5.56291390728
4615,1500000US132330101004,132330101004,"Block Group 4, Census Tract 101, Polk County, Georgia",1265,1089,176,86.0869565217,13.9130434783
4616,1500000US132330102001,132330102001,"Block Group 1, Census Tract 102, Polk County, Georgia",1679,1255,424,74.7468731388,25.2531268612
4617,1500000US132330102002,132330102002,"Block Group 2, Census Tract 102, Polk County, Georgia",1810,1749,61,96.6298342541,3.37016574586
4618,1500000US132330102003,132330102003,"Block Group 3, Census Tract 102, Polk County, Georgia",1887,1185,702,62.7980922099,37.2019077901
4619,1500000US132330102004,132330102004,"Block Group 4, Census Tract 102, Polk County, Georgia",1415,948,467,66.9964664311,33.0035335689
4620,1500000US132330102005,132330102005,"Block Group 5, Census Tract 102, Polk County, Georgia",1126,462,664,41.0301953819,58.9698046181
4621,1500000US132330103001,132330103001,"Block Group 1, Census Tract 103, Polk County, Georgia",1428,1142,286,79.9719887955,20.0280112045
4622,1500000US132330103002,132330103002,"Block Group 2, Census Tract 103, Polk County, Georgia",1318,1091,227,82.7769347496,17.2230652504
4623,1500000US132330103003,132330103003,"Block Group 3, Census Tract 103, Polk County, Georgia",2152,1113,1039,51.719330855,48.280669145
4624,1500000US132330104001,132330104001,"Block Group 1, Census Tract 104, Polk County, Georgia",1341,1001,340,74.6457867263,25.3542132737
4625,1500000US132330104002,132330104002,"Block Group 2, Census Tract 104, Polk County, Georgia",1101,718,383,65.2134423252,34.7865576748
4626,1500000US132330104003,132330104003,"Block Group 3, Census Tract 104, Polk County, Georgia",1351,643,708,47.5943745374,52.4056254626
4627,1500000US132330104004,132330104004,"Block Group 4, Census Tract 104, Polk County, Georgia",984,248,736,25.2032520325,74.7967479675
4628,1500000US132330104005,132330104005,"Block Group 5, Census Tract 104, Polk County, Georgia",1355,290,1065,21.4022140221,78.5977859779
4629,1500000US132330105001,132330105001,"Block Group 1, Census Tract 105, Polk County, Georgia",1517,1285,232,84.7066578774,15.2933421226
4630,1500000US132330105002,132330105002,"Block Group 2, Census Tract 105, Polk County, Georgia",1065,588,477,55.2112676056,44.7887323944
4631,1500000US132330105003,132330105003,"Block Group 3, Census Tract 105, Polk County, Georgia",522,120,402,22.9885057471,77.0114942529
4632,1500000US132330105004,132330105004,"Block Group 4, Census Tract 105, Polk County, Georgia",888,301,587,33.8963963964,66.1036036036
4633,1500000US132330105005,132330105005,"Block Group 5, Census Tract 105, Polk County, Georgia",711,472,239,66.3853727145,33.6146272855
4634,1500000US132330105006,132330105006,"Block Group 6, Census Tract 105, Polk County, Georgia",828,664,164,80.193236715,19.806763285
4635,1500000US132330106001,132330106001,"Block Group 1, Census Tract 106, Polk County, Georgia",1194,865,329,72.445561139,27.554438861
4636,1500000US132330106002,132330106002,"Block Group 2, Census Tract 106, Polk County, Georgia",1988,1386,602,69.7183098592,30.2816901408
4637,1500000US132330106003,132330106003,"Block Group 3, Census Tract 106, Polk County, Georgia",1455,1386,69,95.2577319588,4.74226804124
4638,1500000US132330106004,132330106004,"Block Group 4, Census Tract 106, Polk County, Georgia",1279,1133,146,88.5848318999,11.4151681001
4639,1500000US132330107001,132330107001,"Block Group 1, Census Tract 107, Polk County, Georgia",1585,1281,304,80.8201892744,19.1798107256
4640,1500000US132330107002,132330107002,"Block Group 2, Census Tract 107, Polk County, Georgia",954,421,533,44.1299790356,55.8700209644
4641,1500000US132330107003,132330107003,"Block Group 3, Census Tract 107, Polk County, Georgia",930,588,342,63.2258064516,36.7741935484
4642,1500000US132330107004,132330107004,"Block Group 4, Census Tract 107, Polk County, Georgia",1053,402,651,38.1766381766,61.8233618234
4643,1500000US132330107005,132330107005,"Block Group 5, Census Tract 107, Polk County, Georgia",970,446,524,45.9793814433,54.0206185567
4644,1500000US132359501001,132359501001,"Block Group 1, Census Tract 9501, Pulaski County, Georgia",797,522,275,65.495608532,34.504391468
4645,1500000US132359501002,132359501002,"Block Group 2, Census Tract 9501, Pulaski County, Georgia",767,591,176,77.0534550196,22.9465449804
4646,1500000US132359502001,132359502001,"Block Group 1, Census Tract 9502, Pulaski County, Georgia",1373,1126,247,82.0101966497,17.9898033503
4647,1500000US132359502002,132359502002,"Block Group 2, Census Tract 9502, Pulaski County, Georgia",702,281,421,40.0284900285,59.9715099715
4648,1500000US132359502003,132359502003,"Block Group 3, Census Tract 9502, Pulaski County, Georgia",941,123,818,13.0712008502,86.9287991498
4649,1500000US132359502004,132359502004,"Block Group 4, Census Tract 9502, Pulaski County, Georgia",1013,315,698,31.0957551826,68.9042448174
4650,1500000US132359502005,132359502005,"Block Group 5, Census Tract 9502, Pulaski County, Georgia",1098,709,389,64.5719489982,35.4280510018
4651,1500000US132359502006,132359502006,"Block Group 6, Census Tract 9502, Pulaski County, Georgia",1906,1113,793,58.3945435467,41.6054564533
4652,1500000US132359503001,132359503001,"Block Group 1, Census Tract 9503, Pulaski County, Georgia",1454,1197,257,82.3246217331,17.6753782669
4653,1500000US132379601011,132379601011,"Block Group 1, Census Tract 9601.01, Putnam County, Georgia",1047,934,113,89.2072588348,10.7927411652
4654,1500000US132379601012,132379601012,"Block Group 2, Census Tract 9601.01, Putnam County, Georgia",764,468,296,61.2565445026,38.7434554974
4655,1500000US132379601013,132379601013,"Block Group 3, Census Tract 9601.01, Putnam County, Georgia",1402,958,444,68.3309557775,31.6690442225
4656,1500000US132379601021,132379601021,"Block Group 1, Census Tract 9601.02, Putnam County, Georgia",2615,2171,444,83.0210325048,16.9789674952
4657,1500000US132379601022,132379601022,"Block Group 2, Census Tract 9601.02, Putnam County, Georgia",2881,2386,495,82.8184658105,17.1815341895
4658,1500000US132379602011,132379602011,"Block Group 1, Census Tract 9602.01, Putnam County, Georgia",1131,875,256,77.3651635721,22.6348364279
4659,1500000US132379602021,132379602021,"Block Group 1, Census Tract 9602.02, Putnam County, Georgia",867,542,325,62.5144175317,37.4855824683
4660,1500000US132379602022,132379602022,"Block Group 2, Census Tract 9602.02, Putnam County, Georgia",1907,1353,554,70.9491347666,29.0508652334
4661,1500000US132379602023,132379602023,"Block Group 3, Census Tract 9602.02, Putnam County, Georgia",910,636,274,69.8901098901,30.1098901099
4662,1500000US132379602024,132379602024,"Block Group 4, Census Tract 9602.02, Putnam County, Georgia",1024,585,439,57.12890625,42.87109375
4663,1500000US132379602025,132379602025,"Block Group 5, Census Tract 9602.02, Putnam County, Georgia",1105,434,671,39.2760180995,60.7239819005
4664,1500000US132379602026,132379602026,"Block Group 6, Census Tract 9602.02, Putnam County, Georgia",555,346,209,62.3423423423,37.6576576577
4665,1500000US132379602027,132379602027,"Block Group 7, Census Tract 9602.02, Putnam County, Georgia",582,554,28,95.1890034364,4.81099656357
4666,1500000US132379603001,132379603001,"Block Group 1, Census Tract 9603, Putnam County, Georgia",1355,1212,143,89.4464944649,10.5535055351
4667,1500000US132379603002,132379603002,"Block Group 2, Census Tract 9603, Putnam County, Georgia",715,610,105,85.3146853147,14.6853146853
4668,1500000US132379603003,132379603003,"Block Group 3, Census Tract 9603, Putnam County, Georgia",581,410,171,70.5679862306,29.4320137694
4669,1500000US132379603004,132379603004,"Block Group 4, Census Tract 9603, Putnam County, Georgia",1614,1293,321,80.1115241636,19.8884758364
4670,1500000US132399603001,132399603001,"Block Group 1, Census Tract 9603, Quitman County, Georgia",1181,877,304,74.2591024555,25.7408975445
4671,1500000US132399603002,132399603002,"Block Group 2, Census Tract 9603, Quitman County, Georgia",1145,813,332,71.0043668122,28.9956331878
4672,1500000US132419701001,132419701001,"Block Group 1, Census Tract 9701, Rabun County, Georgia",510,423,87,82.9411764706,17.0588235294
4673,1500000US132419701002,132419701002,"Block Group 2, Census Tract 9701, Rabun County, Georgia",2031,1150,881,56.6223535204,43.3776464796
4674,1500000US132419701003,132419701003,"Block Group 3, Census Tract 9701, Rabun County, Georgia",1549,1245,304,80.3744351194,19.6255648806
4675,1500000US132419701004,132419701004,"Block Group 4, Census Tract 9701, Rabun County, Georgia",1369,827,542,60.4090577064,39.5909422936
4676,1500000US132419702011,132419702011,"Block Group 1, Census Tract 9702.01, Rabun County, Georgia",1866,1067,799,57.18113612,42.81886388
4677,1500000US132419702012,132419702012,"Block Group 2, Census Tract 9702.01, Rabun County, Georgia",470,462,8,98.2978723404,1.70212765957
4678,1500000US132419702013,132419702013,"Block Group 3, Census Tract 9702.01, Rabun County, Georgia",833,739,94,88.7154861945,11.2845138055
4679,1500000US132419702021,132419702021,"Block Group 1, Census Tract 9702.02, Rabun County, Georgia",1158,957,201,82.6424870466,17.3575129534
4680,1500000US132419702022,132419702022,"Block Group 2, Census Tract 9702.02, Rabun County, Georgia",1335,926,409,69.3632958801,30.6367041199
4681,1500000US132419703011,132419703011,"Block Group 1, Census Tract 9703.01, Rabun County, Georgia",484,484,0,100.0,0.0
4682,1500000US132419703012,132419703012,"Block Group 2, Census Tract 9703.01, Rabun County, Georgia",671,568,103,84.6497764531,15.3502235469
4683,1500000US132419703013,132419703013,"Block Group 3, Census Tract 9703.01, Rabun County, Georgia",1998,1627,371,81.4314314314,18.5685685686
4684,1500000US132419703021,132419703021,"Block Group 1, Census Tract 9703.02, Rabun County, Georgia",1618,1221,397,75.4635352287,24.5364647713
4685,1500000US132437901001,132437901001,"Block Group 1, Census Tract 7901, Randolph County, Georgia",1162,1008,154,86.7469879518,13.2530120482
4686,1500000US132437901002,132437901002,"Block Group 2, Census Tract 7901, Randolph County, Georgia",615,436,179,70.8943089431,29.1056910569
4687,1500000US132437902001,132437902001,"Block Group 1, Census Tract 7902, Randolph County, Georgia",839,666,173,79.3802145411,20.6197854589
4688,1500000US132437902002,132437902002,"Block Group 2, Census Tract 7902, Randolph County, Georgia",1207,639,568,52.9411764706,47.0588235294
4689,1500000US132437902003,132437902003,"Block Group 3, Census Tract 7902, Randolph County, Georgia",1115,871,244,78.1165919283,21.8834080717
4690,1500000US132437902004,132437902004,"Block Group 4, Census Tract 7902, Randolph County, Georgia",1678,366,1312,21.8116805721,78.1883194279
4691,1500000US132437902005,132437902005,"Block Group 5, Census Tract 7902, Randolph County, Georgia",492,253,239,51.4227642276,48.5772357724
4692,1500000US132450001001,132450001001,"Block Group 1, Census Tract 1, Richmond County, Georgia",705,464,241,65.8156028369,34.1843971631
4693,1500000US132450001002,132450001002,"Block Group 2, Census Tract 1, Richmond County, Georgia",1337,802,535,59.9850411369,40.0149588631
4694,1500000US132450001003,132450001003,"Block Group 3, Census Tract 1, Richmond County, Georgia",682,265,417,38.8563049853,61.1436950147
4695,1500000US132450001004,132450001004,"Block Group 4, Census Tract 1, Richmond County, Georgia",579,238,341,41.1053540587,58.8946459413
4696,1500000US132450001005,132450001005,"Block Group 5, Census Tract 1, Richmond County, Georgia",616,493,123,80.0324675325,19.9675324675
4697,1500000US132450002001,132450002001,"Block Group 1, Census Tract 2, Richmond County, Georgia",951,451,500,47.4237644585,52.5762355415
4698,1500000US132450002002,132450002002,"Block Group 2, Census Tract 2, Richmond County, Georgia",606,26,580,4.2904290429,95.7095709571
4699,1500000US132450002003,132450002003,"Block Group 3, Census Tract 2, Richmond County, Georgia",750,169,581,22.5333333333,77.4666666667
4700,1500000US132450003001,132450003001,"Block Group 1, Census Tract 3, Richmond County, Georgia",383,110,273,28.7206266319,71.2793733681
4701,1500000US132450003002,132450003002,"Block Group 2, Census Tract 3, Richmond County, Georgia",581,246,335,42.3407917384,57.6592082616
4702,1500000US132450006001,132450006001,"Block Group 1, Census Tract 6, Richmond County, Georgia",645,285,360,44.1860465116,55.8139534884
4703,1500000US132450006002,132450006002,"Block Group 2, Census Tract 6, Richmond County, Georgia",1037,72,965,6.9431051109,93.0568948891
4704,1500000US132450006003,132450006003,"Block Group 3, Census Tract 6, Richmond County, Georgia",553,177,376,32.0072332731,67.9927667269
4705,1500000US132450007001,132450007001,"Block Group 1, Census Tract 7, Richmond County, Georgia",577,162,415,28.0762564991,71.9237435009
4706,1500000US132450007002,132450007002,"Block Group 2, Census Tract 7, Richmond County, Georgia",391,249,142,63.6828644501,36.3171355499
4707,1500000US132450009001,132450009001,"Block Group 1, Census Tract 9, Richmond County, Georgia",616,123,493,19.9675324675,80.0324675325
4708,1500000US132450009002,132450009002,"Block Group 2, Census Tract 9, Richmond County, Georgia",0,0,0,,
4709,1500000US132450009003,132450009003,"Block Group 3, Census Tract 9, Richmond County, Georgia",499,201,298,40.2805611222,59.7194388778
4710,1500000US132450010001,132450010001,"Block Group 1, Census Tract 10, Richmond County, Georgia",645,92,553,14.2635658915,85.7364341085
4711,1500000US132450010002,132450010002,"Block Group 2, Census Tract 10, Richmond County, Georgia",585,208,377,35.5555555556,64.4444444444
4712,1500000US132450010003,132450010003,"Block Group 3, Census Tract 10, Richmond County, Georgia",768,416,352,54.1666666667,45.8333333333
4713,1500000US132450010004,132450010004,"Block Group 4, Census Tract 10, Richmond County, Georgia",201,84,117,41.7910447761,58.2089552239
4714,1500000US132450011001,132450011001,"Block Group 1, Census Tract 11, Richmond County, Georgia",1077,754,323,70.0092850511,29.9907149489
4715,1500000US132450011002,132450011002,"Block Group 2, Census Tract 11, Richmond County, Georgia",724,614,110,84.8066298343,15.1933701657
4716,1500000US132450012001,132450012001,"Block Group 1, Census Tract 12, Richmond County, Georgia",308,78,230,25.3246753247,74.6753246753
4717,1500000US132450012002,132450012002,"Block Group 2, Census Tract 12, Richmond County, Georgia",678,532,146,78.4660766962,21.5339233038
4718,1500000US132450012003,132450012003,"Block Group 3, Census Tract 12, Richmond County, Georgia",843,223,620,26.453143535,73.546856465
4719,1500000US132450012004,132450012004,"Block Group 4, Census Tract 12, Richmond County, Georgia",326,245,81,75.1533742331,24.8466257669
4720,1500000US132450012005,132450012005,"Block Group 5, Census Tract 12, Richmond County, Georgia",1404,569,835,40.5270655271,59.4729344729
4721,1500000US132450012006,132450012006,"Block Group 6, Census Tract 12, Richmond County, Georgia",629,173,456,27.5039745628,72.4960254372
4722,1500000US132450013001,132450013001,"Block Group 1, Census Tract 13, Richmond County, Georgia",798,635,163,79.5739348371,20.4260651629
4723,1500000US132450013002,132450013002,"Block Group 2, Census Tract 13, Richmond County, Georgia",758,577,181,76.1213720317,23.8786279683
4724,1500000US132450014001,132450014001,"Block Group 1, Census Tract 14, Richmond County, Georgia",428,84,344,19.6261682243,80.3738317757
4725,1500000US132450014002,132450014002,"Block Group 2, Census Tract 14, Richmond County, Georgia",628,294,334,46.8152866242,53.1847133758
4726,1500000US132450014003,132450014003,"Block Group 3, Census Tract 14, Richmond County, Georgia",801,116,685,14.481897628,85.518102372
4727,1500000US132450015001,132450015001,"Block Group 1, Census Tract 15, Richmond County, Georgia",180,66,114,36.6666666667,63.3333333333
4728,1500000US132450015002,132450015002,"Block Group 2, Census Tract 15, Richmond County, Georgia",580,144,436,24.8275862069,75.1724137931
4729,1500000US132450016011,132450016011,"Block Group 1, Census Tract 16.01, Richmond County, Georgia",1996,408,1588,20.4408817635,79.5591182365
4730,1500000US132450016012,132450016012,"Block Group 2, Census Tract 16.01, Richmond County, Georgia",1674,634,1040,37.8733572282,62.1266427718
4731,1500000US132450016013,132450016013,"Block Group 3, Census Tract 16.01, Richmond County, Georgia",368,113,255,30.7065217391,69.2934782609
4732,1500000US132450016021,132450016021,"Block Group 1, Census Tract 16.02, Richmond County, Georgia",1916,1399,517,73.0167014614,26.9832985386
4733,1500000US132450016022,132450016022,"Block Group 2, Census Tract 16.02, Richmond County, Georgia",905,852,53,94.1436464088,5.85635359116
4734,1500000US132450016023,132450016023,"Block Group 3, Census Tract 16.02, Richmond County, Georgia",1129,539,590,47.741364039,52.258635961
4735,1500000US132450101011,132450101011,"Block Group 1, Census Tract 101.01, Richmond County, Georgia",1835,1291,544,70.3542234332,29.6457765668
4736,1500000US132450101012,132450101012,"Block Group 2, Census Tract 101.01, Richmond County, Georgia",1598,673,925,42.1151439299,57.8848560701
4737,1500000US132450101041,132450101041,"Block Group 1, Census Tract 101.04, Richmond County, Georgia",1996,664,1332,33.2665330661,66.7334669339
4738,1500000US132450101042,132450101042,"Block Group 2, Census Tract 101.04, Richmond County, Georgia",887,439,448,49.4926719278,50.5073280722
4739,1500000US132450101043,132450101043,"Block Group 3, Census Tract 101.04, Richmond County, Georgia",1044,661,383,63.3141762452,36.6858237548
4740,1500000US132450101051,132450101051,"Block Group 1, Census Tract 101.05, Richmond County, Georgia",871,585,286,67.1641791045,32.8358208955
4741,1500000US132450101052,132450101052,"Block Group 2, Census Tract 101.05, Richmond County, Georgia",2196,1623,573,73.9071038251,26.0928961749
4742,1500000US132450101053,132450101053,"Block Group 3, Census Tract 101.05, Richmond County, Georgia",1707,727,980,42.5893380199,57.4106619801
4743,1500000US132450101061,132450101061,"Block Group 1, Census Tract 101.06, Richmond County, Georgia",836,729,107,87.2009569378,12.7990430622
4744,1500000US132450101062,132450101062,"Block Group 2, Census Tract 101.06, Richmond County, Georgia",2133,518,1615,24.2850445382,75.7149554618
4745,1500000US132450101063,132450101063,"Block Group 3, Census Tract 101.06, Richmond County, Georgia",2051,353,1698,17.2111165285,82.7888834715
4746,1500000US132450101071,132450101071,"Block Group 1, Census Tract 101.07, Richmond County, Georgia",1247,244,1003,19.5669607057,80.4330392943
4747,1500000US132450101072,132450101072,"Block Group 2, Census Tract 101.07, Richmond County, Georgia",1215,456,759,37.5308641975,62.4691358025
4748,1500000US132450102011,132450102011,"Block Group 1, Census Tract 102.01, Richmond County, Georgia",1694,1115,579,65.8205430933,34.1794569067
4749,1500000US132450102012,132450102012,"Block Group 2, Census Tract 102.01, Richmond County, Georgia",664,546,118,82.2289156627,17.7710843373
4750,1500000US132450102013,132450102013,"Block Group 3, Census Tract 102.01, Richmond County, Georgia",2105,1640,465,77.9097387173,22.0902612827
4751,1500000US132450102031,132450102031,"Block Group 1, Census Tract 102.03, Richmond County, Georgia",1347,539,808,40.0148478099,59.9851521901
4752,1500000US132450102032,132450102032,"Block Group 2, Census Tract 102.03, Richmond County, Georgia",1667,1013,654,60.7678464307,39.2321535693
4753,1500000US132450102033,132450102033,"Block Group 3, Census Tract 102.03, Richmond County, Georgia",1113,446,667,40.0718778077,59.9281221923
4754,1500000US132450102041,132450102041,"Block Group 1, Census Tract 102.04, Richmond County, Georgia",6491,5161,1330,79.5100908951,20.4899091049
4755,1500000US132450102042,132450102042,"Block Group 2, Census Tract 102.04, Richmond County, Georgia",796,76,720,9.54773869347,90.4522613065
4756,1500000US132450102043,132450102043,"Block Group 3, Census Tract 102.04, Richmond County, Georgia",3463,1383,2080,39.9364712677,60.0635287323
4757,1500000US132450102044,132450102044,"Block Group 4, Census Tract 102.04, Richmond County, Georgia",2108,1249,859,59.2504743833,40.7495256167
4758,1500000US132450103001,132450103001,"Block Group 1, Census Tract 103, Richmond County, Georgia",1462,176,1286,12.0383036936,87.9616963064
4759,1500000US132450103002,132450103002,"Block Group 2, Census Tract 103, Richmond County, Georgia",433,238,195,54.9653579677,45.0346420323
4760,1500000US132450103003,132450103003,"Block Group 3, Census Tract 103, Richmond County, Georgia",2224,1359,865,61.1061151079,38.8938848921
4761,1500000US132450103004,132450103004,"Block Group 4, Census Tract 103, Richmond County, Georgia",485,92,393,18.9690721649,81.0309278351
4762,1500000US132450103005,132450103005,"Block Group 5, Census Tract 103, Richmond County, Georgia",612,348,264,56.862745098,43.137254902
4763,1500000US132450104001,132450104001,"Block Group 1, Census Tract 104, Richmond County, Georgia",964,391,573,40.5601659751,59.4398340249
4764,1500000US132450104002,132450104002,"Block Group 2, Census Tract 104, Richmond County, Georgia",854,270,584,31.6159250585,68.3840749415
4765,1500000US132450104003,132450104003,"Block Group 3, Census Tract 104, Richmond County, Georgia",732,8,724,1.09289617486,98.9071038251
4766,1500000US132450104004,132450104004,"Block Group 4, Census Tract 104, Richmond County, Georgia",712,410,302,57.5842696629,42.4157303371
4767,1500000US132450104005,132450104005,"Block Group 5, Census Tract 104, Richmond County, Georgia",1037,367,670,35.3905496625,64.6094503375
4768,1500000US132450105041,132450105041,"Block Group 1, Census Tract 105.04, Richmond County, Georgia",2156,955,1201,44.2949907236,55.7050092764
4769,1500000US132450105042,132450105042,"Block Group 2, Census Tract 105.04, Richmond County, Georgia",2764,728,2036,26.3386396527,73.6613603473
4770,1500000US132450105043,132450105043,"Block Group 3, Census Tract 105.04, Richmond County, Georgia",810,550,260,67.9012345679,32.0987654321
4771,1500000US132450105044,132450105044,"Block Group 4, Census Tract 105.04, Richmond County, Georgia",1424,669,755,46.9803370787,53.0196629213
4772,1500000US132450105061,132450105061,"Block Group 1, Census Tract 105.06, Richmond County, Georgia",1748,269,1479,15.3890160183,84.6109839817
4773,1500000US132450105062,132450105062,"Block Group 2, Census Tract 105.06, Richmond County, Georgia",1178,509,669,43.2088285229,56.7911714771
4774,1500000US132450105063,132450105063,"Block Group 3, Census Tract 105.06, Richmond County, Georgia",1971,1019,952,51.6996448503,48.3003551497
4775,1500000US132450105071,132450105071,"Block Group 1, Census Tract 105.07, Richmond County, Georgia",1422,674,748,47.3980309423,52.6019690577
4776,1500000US132450105072,132450105072,"Block Group 2, Census Tract 105.07, Richmond County, Georgia",951,479,472,50.3680336488,49.6319663512
4777,1500000US132450105073,132450105073,"Block Group 3, Census Tract 105.07, Richmond County, Georgia",2899,1497,1402,51.6384960331,48.3615039669
4778,1500000US132450105074,132450105074,"Block Group 4, Census Tract 105.07, Richmond County, Georgia",394,191,203,48.4771573604,51.5228426396
4779,1500000US132450105081,132450105081,"Block Group 1, Census Tract 105.08, Richmond County, Georgia",3036,1266,1770,41.6996047431,58.3003952569
4780,1500000US132450105082,132450105082,"Block Group 2, Census Tract 105.08, Richmond County, Georgia",1264,632,632,50.0,50.0
4781,1500000US132450105091,132450105091,"Block Group 1, Census Tract 105.09, Richmond County, Georgia",1144,945,199,82.6048951049,17.3951048951
4782,1500000US132450105092,132450105092,"Block Group 2, Census Tract 105.09, Richmond County, Georgia",2939,1278,1661,43.4841782919,56.5158217081
4783,1500000US132450105101,132450105101,"Block Group 1, Census Tract 105.10, Richmond County, Georgia",1049,628,421,59.8665395615,40.1334604385
4784,1500000US132450105102,132450105102,"Block Group 2, Census Tract 105.10, Richmond County, Georgia",357,271,86,75.9103641457,24.0896358543
4785,1500000US132450105103,132450105103,"Block Group 3, Census Tract 105.10, Richmond County, Georgia",2208,1115,1093,50.4981884058,49.5018115942
4786,1500000US132450105104,132450105104,"Block Group 4, Census Tract 105.10, Richmond County, Georgia",1311,806,505,61.4797864226,38.5202135774
4787,1500000US132450105111,132450105111,"Block Group 1, Census Tract 105.11, Richmond County, Georgia",2062,1025,1037,49.7090203686,50.2909796314
4788,1500000US132450105112,132450105112,"Block Group 2, Census Tract 105.11, Richmond County, Georgia",1451,648,803,44.6588559614,55.3411440386
4789,1500000US132450105121,132450105121,"Block Group 1, Census Tract 105.12, Richmond County, Georgia",1339,810,529,60.4929051531,39.5070948469
4790,1500000US132450105122,132450105122,"Block Group 2, Census Tract 105.12, Richmond County, Georgia",1533,768,765,50.0978473581,49.9021526419
4791,1500000US132450105123,132450105123,"Block Group 3, Census Tract 105.12, Richmond County, Georgia",1568,620,948,39.5408163265,60.4591836735
4792,1500000US132450105131,132450105131,"Block Group 1, Census Tract 105.13, Richmond County, Georgia",1999,1276,723,63.831915958,36.168084042
4793,1500000US132450105132,132450105132,"Block Group 2, Census Tract 105.13, Richmond County, Georgia",1097,706,391,64.3573381951,35.6426618049
4794,1500000US132450106001,132450106001,"Block Group 1, Census Tract 106, Richmond County, Georgia",853,255,598,29.8944900352,70.1055099648
4795,1500000US132450106002,132450106002,"Block Group 2, Census Tract 106, Richmond County, Georgia",841,655,186,77.8834720571,22.1165279429
4796,1500000US132450106003,132450106003,"Block Group 3, Census Tract 106, Richmond County, Georgia",1799,631,1168,35.0750416898,64.9249583102
4797,1500000US132450106004,132450106004,"Block Group 4, Census Tract 106, Richmond County, Georgia",848,195,653,22.9952830189,77.0047169811
4798,1500000US132450107061,132450107061,"Block Group 1, Census Tract 107.06, Richmond County, Georgia",1828,1332,496,72.8665207877,27.1334792123
4799,1500000US132450107062,132450107062,"Block Group 2, Census Tract 107.06, Richmond County, Georgia",1712,827,885,48.3060747664,51.6939252336
4800,1500000US132450107063,132450107063,"Block Group 3, Census Tract 107.06, Richmond County, Georgia",1305,629,676,48.1992337165,51.8007662835
4801,1500000US132450107071,132450107071,"Block Group 1, Census Tract 107.07, Richmond County, Georgia",2436,1199,1237,49.2200328407,50.7799671593
4802,1500000US132450107072,132450107072,"Block Group 2, Census Tract 107.07, Richmond County, Georgia",470,216,254,45.9574468085,54.0425531915
4803,1500000US132450107081,132450107081,"Block Group 1, Census Tract 107.08, Richmond County, Georgia",2038,1162,876,57.0166830226,42.9833169774
4804,1500000US132450107082,132450107082,"Block Group 2, Census Tract 107.08, Richmond County, Georgia",1484,921,563,62.0619946092,37.9380053908
4805,1500000US132450107083,132450107083,"Block Group 3, Census Tract 107.08, Richmond County, Georgia",2136,1267,869,59.3164794007,40.6835205993
4806,1500000US132450107091,132450107091,"Block Group 1, Census Tract 107.09, Richmond County, Georgia",3390,2532,858,74.6902654867,25.3097345133
4807,1500000US132450107092,132450107092,"Block Group 2, Census Tract 107.09, Richmond County, Georgia",2681,1449,1232,54.046997389,45.953002611
4808,1500000US132450107101,132450107101,"Block Group 1, Census Tract 107.10, Richmond County, Georgia",1373,937,436,68.2447195921,31.7552804079
4809,1500000US132450107102,132450107102,"Block Group 2, Census Tract 107.10, Richmond County, Georgia",1321,432,889,32.7024981075,67.2975018925
4810,1500000US132450107103,132450107103,"Block Group 3, Census Tract 107.10, Richmond County, Georgia",3101,1412,1689,45.5336988068,54.4663011932
4811,1500000US132450107111,132450107111,"Block Group 1, Census Tract 107.11, Richmond County, Georgia",1253,960,293,76.6161213089,23.3838786911
4812,1500000US132450107112,132450107112,"Block Group 2, Census Tract 107.11, Richmond County, Georgia",1655,1192,463,72.0241691843,27.9758308157
4813,1500000US132450107121,132450107121,"Block Group 1, Census Tract 107.12, Richmond County, Georgia",2278,1510,768,66.2862159789,33.7137840211
4814,1500000US132450107122,132450107122,"Block Group 2, Census Tract 107.12, Richmond County, Georgia",3405,2538,867,74.5374449339,25.4625550661
4815,1500000US132450107123,132450107123,"Block Group 3, Census Tract 107.12, Richmond County, Georgia",3036,2382,654,78.4584980237,21.5415019763
4816,1500000US132450108001,132450108001,"Block Group 1, Census Tract 108, Richmond County, Georgia",0,0,0,,
4817,1500000US132450108002,132450108002,"Block Group 2, Census Tract 108, Richmond County, Georgia",3123,0,3123,0.0,100.0
4818,1500000US132450108003,132450108003,"Block Group 3, Census Tract 108, Richmond County, Georgia",0,0,0,,
4819,1500000US132450108004,132450108004,"Block Group 4, Census Tract 108, Richmond County, Georgia",1194,15,1179,1.25628140704,98.743718593
4820,1500000US132450109031,132450109031,"Block Group 1, Census Tract 109.03, Richmond County, Georgia",2244,1873,371,83.4670231729,16.5329768271
4821,1500000US132450109032,132450109032,"Block Group 2, Census Tract 109.03, Richmond County, Georgia",2934,2378,556,81.0497614179,18.9502385821
4822,1500000US132450109041,132450109041,"Block Group 1, Census Tract 109.04, Richmond County, Georgia",884,525,359,59.3891402715,40.6108597285
4823,1500000US132450109042,132450109042,"Block Group 2, Census Tract 109.04, Richmond County, Georgia",2542,1762,780,69.3154996066,30.6845003934
4824,1500000US132450109051,132450109051,"Block Group 1, Census Tract 109.05, Richmond County, Georgia",1172,1103,69,94.1126279863,5.88737201365
4825,1500000US132450109052,132450109052,"Block Group 2, Census Tract 109.05, Richmond County, Georgia",2051,1831,220,89.2735251097,10.7264748903
4826,1500000US132450109053,132450109053,"Block Group 3, Census Tract 109.05, Richmond County, Georgia",1845,1165,680,63.1436314363,36.8563685637
4827,1500000US132450109061,132450109061,"Block Group 1, Census Tract 109.06, Richmond County, Georgia",855,813,42,95.0877192982,4.91228070175
4828,1500000US132450109062,132450109062,"Block Group 2, Census Tract 109.06, Richmond County, Georgia",3050,1828,1222,59.9344262295,40.0655737705
4829,1500000US132450109063,132450109063,"Block Group 3, Census Tract 109.06, Richmond County, Georgia",3274,2482,792,75.8094074527,24.1905925473
4830,1500000US132450110001,132450110001,"Block Group 1, Census Tract 110, Richmond County, Georgia",372,43,329,11.5591397849,88.4408602151
4831,1500000US132450110002,132450110002,"Block Group 2, Census Tract 110, Richmond County, Georgia",888,157,731,17.6801801802,82.3198198198
4832,1500000US132470601011,132470601011,"Block Group 1, Census Tract 601.01, Rockdale County, Georgia",828,604,224,72.9468599034,27.0531400966
4833,1500000US132470601012,132470601012,"Block Group 2, Census Tract 601.01, Rockdale County, Georgia",1016,555,461,54.625984252,45.374015748
4834,1500000US132470601013,132470601013,"Block Group 3, Census Tract 601.01, Rockdale County, Georgia",1424,1116,308,78.3707865169,21.6292134831
4835,1500000US132470601021,132470601021,"Block Group 1, Census Tract 601.02, Rockdale County, Georgia",1122,923,199,82.2638146168,17.7361853832
4836,1500000US132470601022,132470601022,"Block Group 2, Census Tract 601.02, Rockdale County, Georgia",852,604,248,70.8920187793,29.1079812207
4837,1500000US132470601023,132470601023,"Block Group 3, Census Tract 601.02, Rockdale County, Georgia",3281,2231,1050,67.997561719,32.002438281
4838,1500000US132470602011,132470602011,"Block Group 1, Census Tract 602.01, Rockdale County, Georgia",2819,1112,1707,39.4466122739,60.5533877261
4839,1500000US132470602012,132470602012,"Block Group 2, Census Tract 602.01, Rockdale County, Georgia",1224,1118,106,91.339869281,8.66013071895
4840,1500000US132470602013,132470602013,"Block Group 3, Census Tract 602.01, Rockdale County, Georgia",635,610,25,96.062992126,3.93700787402
4841,1500000US132470602021,132470602021,"Block Group 1, Census Tract 602.02, Rockdale County, Georgia",2471,790,1681,31.9708619992,68.0291380008
4842,1500000US132470602022,132470602022,"Block Group 2, Census Tract 602.02, Rockdale County, Georgia",2444,1993,451,81.5466448445,18.4533551555
4843,1500000US132470602023,132470602023,"Block Group 3, Census Tract 602.02, Rockdale County, Georgia",1912,1703,209,89.0690376569,10.9309623431
4844,1500000US132470602024,132470602024,"Block Group 4, Census Tract 602.02, Rockdale County, Georgia",3011,2518,493,83.6267020923,16.3732979077
4845,1500000US132470603041,132470603041,"Block Group 1, Census Tract 603.04, Rockdale County, Georgia",637,73,564,11.4599686028,88.5400313972
4846,1500000US132470603042,132470603042,"Block Group 2, Census Tract 603.04, Rockdale County, Georgia",1318,1005,313,76.2518968134,23.7481031866
4847,1500000US132470603043,132470603043,"Block Group 3, Census Tract 603.04, Rockdale County, Georgia",1915,829,1086,43.2898172324,56.7101827676
4848,1500000US132470603044,132470603044,"Block Group 4, Census Tract 603.04, Rockdale County, Georgia",1330,433,897,32.5563909774,67.4436090226
4849,1500000US132470603051,132470603051,"Block Group 1, Census Tract 603.05, Rockdale County, Georgia",1029,491,538,47.7162293489,52.2837706511
4850,1500000US132470603052,132470603052,"Block Group 2, Census Tract 603.05, Rockdale County, Georgia",1941,101,1840,5.20350334879,94.7964966512
4851,1500000US132470603053,132470603053,"Block Group 3, Census Tract 603.05, Rockdale County, Georgia",2351,1068,1283,45.4274776691,54.5725223309
4852,1500000US132470603061,132470603061,"Block Group 1, Census Tract 603.06, Rockdale County, Georgia",3090,2625,465,84.9514563107,15.0485436893
4853,1500000US132470603071,132470603071,"Block Group 1, Census Tract 603.07, Rockdale County, Georgia",2477,1149,1328,46.3867581752,53.6132418248
4854,1500000US132470603072,132470603072,"Block Group 2, Census Tract 603.07, Rockdale County, Georgia",2329,2295,34,98.5401459854,1.4598540146
4855,1500000US132470603073,132470603073,"Block Group 3, Census Tract 603.07, Rockdale County, Georgia",4276,3209,1067,75.0467726848,24.9532273152
4856,1500000US132470603074,132470603074,"Block Group 4, Census Tract 603.07, Rockdale County, Georgia",1301,1222,79,93.9277478862,6.07225211376
4857,1500000US132470603081,132470603081,"Block Group 1, Census Tract 603.08, Rockdale County, Georgia",3743,2386,1357,63.7456585627,36.2543414373
4858,1500000US132470603082,132470603082,"Block Group 2, Census Tract 603.08, Rockdale County, Georgia",1840,261,1579,14.1847826087,85.8152173913
4859,1500000US132470603083,132470603083,"Block Group 3, Census Tract 603.08, Rockdale County, Georgia",2666,677,1989,25.3938484621,74.6061515379
4860,1500000US132470603091,132470603091,"Block Group 1, Census Tract 603.09, Rockdale County, Georgia",1067,867,200,81.2558575445,18.7441424555
4861,1500000US132470603092,132470603092,"Block Group 2, Census Tract 603.09, Rockdale County, Georgia",1827,774,1053,42.3645320197,57.6354679803
4862,1500000US132470603093,132470603093,"Block Group 3, Census Tract 603.09, Rockdale County, Georgia",2384,1193,1191,50.0419463087,49.9580536913
4863,1500000US132470604031,132470604031,"Block Group 1, Census Tract 604.03, Rockdale County, Georgia",1900,1711,189,90.0526315789,9.94736842105
4864,1500000US132470604032,132470604032,"Block Group 2, Census Tract 604.03, Rockdale County, Georgia",561,420,141,74.8663101604,25.1336898396
4865,1500000US132470604033,132470604033,"Block Group 3, Census Tract 604.03, Rockdale County, Georgia",1030,835,195,81.067961165,18.932038835
4866,1500000US132470604041,132470604041,"Block Group 1, Census Tract 604.04, Rockdale County, Georgia",2696,1747,949,64.7997032641,35.2002967359
4867,1500000US132470604042,132470604042,"Block Group 2, Census Tract 604.04, Rockdale County, Georgia",1386,1201,185,86.6522366522,13.3477633478
4868,1500000US132470604043,132470604043,"Block Group 3, Census Tract 604.04, Rockdale County, Georgia",1923,1864,59,96.9318772751,3.06812272491
4869,1500000US132470604051,132470604051,"Block Group 1, Census Tract 604.05, Rockdale County, Georgia",2806,2490,316,88.7384176764,11.2615823236
4870,1500000US132470604052,132470604052,"Block Group 2, Census Tract 604.05, Rockdale County, Georgia",2995,2524,471,84.2737896494,15.7262103506
4871,1500000US132470604053,132470604053,"Block Group 3, Census Tract 604.05, Rockdale County, Georgia",1369,1349,20,98.5390796202,1.46092037984
4872,1500000US132470604061,132470604061,"Block Group 1, Census Tract 604.06, Rockdale County, Georgia",1139,1054,85,92.5373134328,7.46268656716
4873,1500000US132470604062,132470604062,"Block Group 2, Census Tract 604.06, Rockdale County, Georgia",2772,1989,783,71.7532467532,28.2467532468
4874,1500000US132470604063,132470604063,"Block Group 3, Census Tract 604.06, Rockdale County, Georgia",1752,1520,232,86.7579908676,13.2420091324
4875,1500000US132470604071,132470604071,"Block Group 1, Census Tract 604.07, Rockdale County, Georgia",1281,1054,227,82.2794691647,17.7205308353
4876,1500000US132470604072,132470604072,"Block Group 2, Census Tract 604.07, Rockdale County, Georgia",1177,856,321,72.7272727273,27.2727272727
4877,1500000US132470604073,132470604073,"Block Group 3, Census Tract 604.07, Rockdale County, Georgia",758,671,87,88.5224274406,11.4775725594
4878,1500000US132499601001,132499601001,"Block Group 1, Census Tract 9601, Schley County, Georgia",1280,732,548,57.1875,42.8125
4879,1500000US132499601002,132499601002,"Block Group 2, Census Tract 9601, Schley County, Georgia",1686,1160,526,68.8018979834,31.1981020166
4880,1500000US132499602001,132499602001,"Block Group 1, Census Tract 9602, Schley County, Georgia",2104,1344,760,63.8783269962,36.1216730038
4881,1500000US132519702001,132519702001,"Block Group 1, Census Tract 9702, Screven County, Georgia",1146,941,205,82.1116928447,17.8883071553
4882,1500000US132519702002,132519702002,"Block Group 2, Census Tract 9702, Screven County, Georgia",685,505,180,73.7226277372,26.2773722628
4883,1500000US132519703001,132519703001,"Block Group 1, Census Tract 9703, Screven County, Georgia",804,657,147,81.7164179104,18.2835820896
4884,1500000US132519703002,132519703002,"Block Group 2, Census Tract 9703, Screven County, Georgia",1031,900,131,87.2938894277,12.7061105723
4885,1500000US132519703003,132519703003,"Block Group 3, Census Tract 9703, Screven County, Georgia",847,545,302,64.3447461629,35.6552538371
4886,1500000US132519703004,132519703004,"Block Group 4, Census Tract 9703, Screven County, Georgia",373,156,217,41.8230563003,58.1769436997
4887,1500000US132519704001,132519704001,"Block Group 1, Census Tract 9704, Screven County, Georgia",993,920,73,92.6485397784,7.35146022155
4888,1500000US132519704002,132519704002,"Block Group 2, Census Tract 9704, Screven County, Georgia",1556,832,724,53.470437018,46.529562982
4889,1500000US132519704003,132519704003,"Block Group 3, Census Tract 9704, Screven County, Georgia",859,370,489,43.0733410943,56.9266589057
4890,1500000US132519704004,132519704004,"Block Group 4, Census Tract 9704, Screven County, Georgia",1098,679,419,61.839708561,38.160291439
4891,1500000US132519705001,132519705001,"Block Group 1, Census Tract 9705, Screven County, Georgia",1702,1318,384,77.4383078731,22.5616921269
4892,1500000US132519705002,132519705002,"Block Group 2, Census Tract 9705, Screven County, Georgia",987,823,164,83.3839918946,16.6160081054
4893,1500000US132519706001,132519706001,"Block Group 1, Census Tract 9706, Screven County, Georgia",1039,881,158,84.7930702599,15.2069297401
4894,1500000US132519706002,132519706002,"Block Group 2, Census Tract 9706, Screven County, Georgia",682,517,165,75.8064516129,24.1935483871
4895,1500000US132532001001,132532001001,"Block Group 1, Census Tract 2001, Seminole County, Georgia",831,627,204,75.4512635379,24.5487364621
4896,1500000US132532001002,132532001002,"Block Group 2, Census Tract 2001, Seminole County, Georgia",835,620,215,74.251497006,25.748502994
4897,1500000US132532001003,132532001003,"Block Group 3, Census Tract 2001, Seminole County, Georgia",837,763,74,91.1589008363,8.84109916368
4898,1500000US132532002001,132532002001,"Block Group 1, Census Tract 2002, Seminole County, Georgia",1871,912,959,48.7439871726,51.2560128274
4899,1500000US132532002002,132532002002,"Block Group 2, Census Tract 2002, Seminole County, Georgia",891,606,285,68.0134680135,31.9865319865
4900,1500000US132532002003,132532002003,"Block Group 3, Census Tract 2002, Seminole County, Georgia",875,727,148,83.0857142857,16.9142857143
4901,1500000US132532003001,132532003001,"Block Group 1, Census Tract 2003, Seminole County, Georgia",1023,651,372,63.6363636364,36.3636363636
4902,1500000US132532003002,132532003002,"Block Group 2, Census Tract 2003, Seminole County, Georgia",390,345,45,88.4615384615,11.5384615385
4903,1500000US132532003003,132532003003,"Block Group 3, Census Tract 2003, Seminole County, Georgia",1110,923,187,83.1531531532,16.8468468468
4904,1500000US132551601001,132551601001,"Block Group 1, Census Tract 1601, Spalding County, Georgia",3007,2390,617,79.4812105088,20.5187894912
4905,1500000US132551601002,132551601002,"Block Group 2, Census Tract 1601, Spalding County, Georgia",956,856,100,89.539748954,10.460251046
4906,1500000US132551601003,132551601003,"Block Group 3, Census Tract 1601, Spalding County, Georgia",1810,725,1085,40.0552486188,59.9447513812
4907,1500000US132551602001,132551602001,"Block Group 1, Census Tract 1602, Spalding County, Georgia",1567,1457,110,92.9802169751,7.01978302489
4908,1500000US132551602002,132551602002,"Block Group 2, Census Tract 1602, Spalding County, Georgia",1660,1390,270,83.734939759,16.265060241
4909,1500000US132551602003,132551602003,"Block Group 3, Census Tract 1602, Spalding County, Georgia",3045,2440,605,80.13136289,19.86863711
4910,1500000US132551603001,132551603001,"Block Group 1, Census Tract 1603, Spalding County, Georgia",1484,1199,285,80.795148248,19.204851752
4911,1500000US132551603002,132551603002,"Block Group 2, Census Tract 1603, Spalding County, Georgia",1719,821,898,47.7603257708,52.2396742292
4912,1500000US132551604001,132551604001,"Block Group 1, Census Tract 1604, Spalding County, Georgia",1868,720,1148,38.5438972163,61.4561027837
4913,1500000US132551604002,132551604002,"Block Group 2, Census Tract 1604, Spalding County, Georgia",1246,474,772,38.0417335474,61.9582664526
4914,1500000US132551604003,132551604003,"Block Group 3, Census Tract 1604, Spalding County, Georgia",914,11,903,1.20350109409,98.7964989059
4915,1500000US132551604004,132551604004,"Block Group 4, Census Tract 1604, Spalding County, Georgia",327,208,119,63.6085626911,36.3914373089
4916,1500000US132551604005,132551604005,"Block Group 5, Census Tract 1604, Spalding County, Georgia",1070,239,831,22.3364485981,77.6635514019
4917,1500000US132551605001,132551605001,"Block Group 1, Census Tract 1605, Spalding County, Georgia",3637,2144,1493,58.9496838053,41.0503161947
4918,1500000US132551605002,132551605002,"Block Group 2, Census Tract 1605, Spalding County, Georgia",2704,1822,882,67.3816568047,32.6183431953
4919,1500000US132551606001,132551606001,"Block Group 1, Census Tract 1606, Spalding County, Georgia",1480,1184,296,80.0,20.0
4920,1500000US132551606002,132551606002,"Block Group 2, Census Tract 1606, Spalding County, Georgia",2411,1868,543,77.478224803,22.521775197
4921,1500000US132551607001,132551607001,"Block Group 1, Census Tract 1607, Spalding County, Georgia",2428,1329,1099,54.7364085667,45.2635914333
4922,1500000US132551607002,132551607002,"Block Group 2, Census Tract 1607, Spalding County, Georgia",1662,334,1328,20.0962695548,79.9037304452
4923,1500000US132551607003,132551607003,"Block Group 3, Census Tract 1607, Spalding County, Georgia",2560,1149,1411,44.8828125,55.1171875
4924,1500000US132551608001,132551608001,"Block Group 1, Census Tract 1608, Spalding County, Georgia",1559,300,1259,19.2431045542,80.7568954458
4925,1500000US132551608002,132551608002,"Block Group 2, Census Tract 1608, Spalding County, Georgia",1385,180,1205,12.9963898917,87.0036101083
4926,1500000US132551608003,132551608003,"Block Group 3, Census Tract 1608, Spalding County, Georgia",1889,360,1529,19.0577024881,80.9422975119
4927,1500000US132551609001,132551609001,"Block Group 1, Census Tract 1609, Spalding County, Georgia",725,338,387,46.6206896552,53.3793103448
4928,1500000US132551609002,132551609002,"Block Group 2, Census Tract 1609, Spalding County, Georgia",1230,615,615,50.0,50.0
4929,1500000US132551609003,132551609003,"Block Group 3, Census Tract 1609, Spalding County, Georgia",737,180,557,24.4233378562,75.5766621438
4930,1500000US132551610001,132551610001,"Block Group 1, Census Tract 1610, Spalding County, Georgia",996,927,69,93.0722891566,6.92771084337
4931,1500000US132551610002,132551610002,"Block Group 2, Census Tract 1610, Spalding County, Georgia",1323,1157,166,87.4527588813,12.5472411187
4932,1500000US132551610003,132551610003,"Block Group 3, Census Tract 1610, Spalding County, Georgia",2824,2337,487,82.7549575071,17.2450424929
4933,1500000US132551611001,132551611001,"Block Group 1, Census Tract 1611, Spalding County, Georgia",1173,803,370,68.4569479966,31.5430520034
4934,1500000US132551611002,132551611002,"Block Group 2, Census Tract 1611, Spalding County, Georgia",2756,1702,1054,61.7561683599,38.2438316401
4935,1500000US132551612001,132551612001,"Block Group 1, Census Tract 1612, Spalding County, Georgia",2568,2288,280,89.0965732087,10.9034267913
4936,1500000US132551612002,132551612002,"Block Group 2, Census Tract 1612, Spalding County, Georgia",617,0,617,0.0,100.0
4937,1500000US132551612003,132551612003,"Block Group 3, Census Tract 1612, Spalding County, Georgia",1027,130,897,12.6582278481,87.3417721519
4938,1500000US132551612004,132551612004,"Block Group 4, Census Tract 1612, Spalding County, Georgia",4242,2810,1432,66.2423385196,33.7576614804
4939,1500000US132579701001,132579701001,"Block Group 1, Census Tract 9701, Stephens County, Georgia",1336,1190,146,89.0718562874,10.9281437126
4940,1500000US132579701002,132579701002,"Block Group 2, Census Tract 9701, Stephens County, Georgia",978,804,174,82.2085889571,17.7914110429
4941,1500000US132579701003,132579701003,"Block Group 3, Census Tract 9701, Stephens County, Georgia",799,589,210,73.717146433,26.282853567
4942,1500000US132579701004,132579701004,"Block Group 4, Census Tract 9701, Stephens County, Georgia",1364,625,739,45.8211143695,54.1788856305
4943,1500000US132579701005,132579701005,"Block Group 5, Census Tract 9701, Stephens County, Georgia",1548,1225,323,79.1343669251,20.8656330749
4944,1500000US132579702001,132579702001,"Block Group 1, Census Tract 9702, Stephens County, Georgia",2400,1610,790,67.0833333333,32.9166666667
4945,1500000US132579702002,132579702002,"Block Group 2, Census Tract 9702, Stephens County, Georgia",1945,1842,103,94.7043701799,5.29562982005
4946,1500000US132579702003,132579702003,"Block Group 3, Census Tract 9702, Stephens County, Georgia",1794,1158,636,64.5484949833,35.4515050167
4947,1500000US132579703011,132579703011,"Block Group 1, Census Tract 9703.01, Stephens County, Georgia",348,182,166,52.2988505747,47.7011494253
4948,1500000US132579703012,132579703012,"Block Group 2, Census Tract 9703.01, Stephens County, Georgia",1015,585,430,57.6354679803,42.3645320197
4949,1500000US132579703013,132579703013,"Block Group 3, Census Tract 9703.01, Stephens County, Georgia",555,293,262,52.7927927928,47.2072072072
4950,1500000US132579703014,132579703014,"Block Group 4, Census Tract 9703.01, Stephens County, Georgia",1075,516,559,48.0,52.0
4951,1500000US132579703021,132579703021,"Block Group 1, Census Tract 9703.02, Stephens County, Georgia",1212,456,756,37.6237623762,62.3762376238
4952,1500000US132579703022,132579703022,"Block Group 2, Census Tract 9703.02, Stephens County, Georgia",1517,1168,349,76.994067238,23.005932762
4953,1500000US132579704001,132579704001,"Block Group 1, Census Tract 9704, Stephens County, Georgia",1879,1475,404,78.499201703,21.500798297
4954,1500000US132579704002,132579704002,"Block Group 2, Census Tract 9704, Stephens County, Georgia",1505,1338,167,88.903654485,11.096345515
4955,1500000US132579704003,132579704003,"Block Group 3, Census Tract 9704, Stephens County, Georgia",1962,1532,430,78.0835881753,21.9164118247
4956,1500000US132579704004,132579704004,"Block Group 4, Census Tract 9704, Stephens County, Georgia",1648,1539,109,93.3859223301,6.6140776699
4957,1500000US132599501001,132599501001,"Block Group 1, Census Tract 9501, Stewart County, Georgia",1229,732,497,59.5606183889,40.4393816111
4958,1500000US132599501002,132599501002,"Block Group 2, Census Tract 9501, Stewart County, Georgia",791,648,143,81.9216182048,18.0783817952
4959,1500000US132599504001,132599504001,"Block Group 1, Census Tract 9504, Stewart County, Georgia",597,310,287,51.9262981575,48.0737018425
4960,1500000US132599504002,132599504002,"Block Group 2, Census Tract 9504, Stewart County, Georgia",960,510,450,53.125,46.875
4961,1500000US132599504003,132599504003,"Block Group 3, Census Tract 9504, Stewart County, Georgia",724,470,254,64.9171270718,35.0828729282
4962,1500000US132619501001,132619501001,"Block Group 1, Census Tract 9501, Sumter County, Georgia",1245,982,263,78.875502008,21.124497992
4963,1500000US132619502001,132619502001,"Block Group 1, Census Tract 9502, Sumter County, Georgia",1675,708,967,42.2686567164,57.7313432836
4964,1500000US132619502002,132619502002,"Block Group 2, Census Tract 9502, Sumter County, Georgia",937,782,155,83.4578441836,16.5421558164
4965,1500000US132619502003,132619502003,"Block Group 3, Census Tract 9502, Sumter County, Georgia",1343,694,649,51.6753536858,48.3246463142
4966,1500000US132619502004,132619502004,"Block Group 4, Census Tract 9502, Sumter County, Georgia",1056,250,806,23.6742424242,76.3257575758
4967,1500000US132619503001,132619503001,"Block Group 1, Census Tract 9503, Sumter County, Georgia",1801,1392,409,77.2903942254,22.7096057746
4968,1500000US132619503002,132619503002,"Block Group 2, Census Tract 9503, Sumter County, Georgia",1269,1087,182,85.657998424,14.342001576
4969,1500000US132619503003,132619503003,"Block Group 3, Census Tract 9503, Sumter County, Georgia",533,279,254,52.3452157598,47.6547842402
4970,1500000US132619503004,132619503004,"Block Group 4, Census Tract 9503, Sumter County, Georgia",1068,180,888,16.8539325843,83.1460674157
4971,1500000US132619503005,132619503005,"Block Group 5, Census Tract 9503, Sumter County, Georgia",1894,822,1072,43.4002111932,56.5997888068
4972,1500000US132619504001,132619504001,"Block Group 1, Census Tract 9504, Sumter County, Georgia",837,614,223,73.3572281959,26.6427718041
4973,1500000US132619504002,132619504002,"Block Group 2, Census Tract 9504, Sumter County, Georgia",798,515,283,64.5363408521,35.4636591479
4974,1500000US132619504003,132619504003,"Block Group 3, Census Tract 9504, Sumter County, Georgia",899,776,123,86.318131257,13.681868743
4975,1500000US132619505001,132619505001,"Block Group 1, Census Tract 9505, Sumter County, Georgia",979,796,183,81.3074565884,18.6925434116
4976,1500000US132619505002,132619505002,"Block Group 2, Census Tract 9505, Sumter County, Georgia",989,683,306,69.0596562184,30.9403437816
4977,1500000US132619505003,132619505003,"Block Group 3, Census Tract 9505, Sumter County, Georgia",1357,1072,285,78.997789241,21.002210759
4978,1500000US132619506001,132619506001,"Block Group 1, Census Tract 9506, Sumter County, Georgia",514,158,356,30.7392996109,69.2607003891
4979,1500000US132619506002,132619506002,"Block Group 2, Census Tract 9506, Sumter County, Georgia",764,368,396,48.167539267,51.832460733
4980,1500000US132619506003,132619506003,"Block Group 3, Census Tract 9506, Sumter County, Georgia",832,459,373,55.1682692308,44.8317307692
4981,1500000US132619507001,132619507001,"Block Group 1, Census Tract 9507, Sumter County, Georgia",1770,725,1045,40.9604519774,59.0395480226
4982,1500000US132619507002,132619507002,"Block Group 2, Census Tract 9507, Sumter County, Georgia",1783,1349,434,75.6590016826,24.3409983174
4983,1500000US132619507003,132619507003,"Block Group 3, Census Tract 9507, Sumter County, Georgia",1498,405,1093,27.0360480641,72.9639519359
4984,1500000US132619507004,132619507004,"Block Group 4, Census Tract 9507, Sumter County, Georgia",703,424,279,60.3129445235,39.6870554765
4985,1500000US132619508001,132619508001,"Block Group 1, Census Tract 9508, Sumter County, Georgia",927,753,174,81.2297734628,18.7702265372
4986,1500000US132619508002,132619508002,"Block Group 2, Census Tract 9508, Sumter County, Georgia",931,468,463,50.268528464,49.731471536
4987,1500000US132619508003,132619508003,"Block Group 3, Census Tract 9508, Sumter County, Georgia",969,528,441,54.4891640867,45.5108359133
4988,1500000US132639601001,132639601001,"Block Group 1, Census Tract 9601, Talbot County, Georgia",774,586,188,75.7105943152,24.2894056848
4989,1500000US132639601002,132639601002,"Block Group 2, Census Tract 9601, Talbot County, Georgia",1665,1494,171,89.7297297297,10.2702702703
4990,1500000US132639602001,132639602001,"Block Group 1, Census Tract 9602, Talbot County, Georgia",961,583,378,60.6659729448,39.3340270552
4991,1500000US132639602002,132639602002,"Block Group 2, Census Tract 9602, Talbot County, Georgia",1409,1124,285,79.7728885735,20.2271114265
4992,1500000US132639603001,132639603001,"Block Group 1, Census Tract 9603, Talbot County, Georgia",514,401,113,78.0155642023,21.9844357977
4993,1500000US132639603002,132639603002,"Block Group 2, Census Tract 9603, Talbot County, Georgia",1147,1050,97,91.5431560593,8.45684394071
4994,1500000US132650102001,132650102001,"Block Group 1, Census Tract 102, Taliaferro County, Georgia",672,485,187,72.1726190476,27.8273809524
4995,1500000US132650102002,132650102002,"Block Group 2, Census Tract 102, Taliaferro County, Georgia",607,392,215,64.5799011532,35.4200988468
4996,1500000US132650102003,132650102003,"Block Group 3, Census Tract 102, Taliaferro County, Georgia",433,406,27,93.7644341801,6.23556581986
4997,1500000US132679501001,132679501001,"Block Group 1, Census Tract 9501, Tattnall County, Georgia",1012,890,122,87.9446640316,12.0553359684
4998,1500000US132679501002,132679501002,"Block Group 2, Census Tract 9501, Tattnall County, Georgia",549,451,98,82.1493624772,17.8506375228
4999,1500000US132679501003,132679501003,"Block Group 3, Census Tract 9501, Tattnall County, Georgia",988,658,330,66.5991902834,33.4008097166
5000,1500000US132679501004,132679501004,"Block Group 4, Census Tract 9501, Tattnall County, Georgia",882,613,269,69.5011337868,30.4988662132
5001,1500000US132679502011,132679502011,"Block Group 1, Census Tract 9502.01, Tattnall County, Georgia",1814,1353,461,74.5865490628,25.4134509372
5002,1500000US132679502012,132679502012,"Block Group 2, Census Tract 9502.01, Tattnall County, Georgia",2640,1461,1179,55.3409090909,44.6590909091
5003,1500000US132679502021,132679502021,"Block Group 1, Census Tract 9502.02, Tattnall County, Georgia",469,129,340,27.5053304904,72.4946695096
5004,1500000US132679502022,132679502022,"Block Group 2, Census Tract 9502.02, Tattnall County, Georgia",3220,2031,1189,63.0745341615,36.9254658385
5005,1500000US132679503001,132679503001,"Block Group 1, Census Tract 9503, Tattnall County, Georgia",1251,920,331,73.5411670663,26.4588329337
5006,1500000US132679503002,132679503002,"Block Group 2, Census Tract 9503, Tattnall County, Georgia",1122,696,426,62.0320855615,37.9679144385
5007,1500000US132679503003,132679503003,"Block Group 3, Census Tract 9503, Tattnall County, Georgia",1155,871,284,75.4112554113,24.5887445887
5008,1500000US132679503004,132679503004,"Block Group 4, Census Tract 9503, Tattnall County, Georgia",390,174,216,44.6153846154,55.3846153846
5009,1500000US132679504001,132679504001,"Block Group 1, Census Tract 9504, Tattnall County, Georgia",816,761,55,93.2598039216,6.74019607843
5010,1500000US132679504002,132679504002,"Block Group 2, Census Tract 9504, Tattnall County, Georgia",716,625,91,87.2905027933,12.7094972067
5011,1500000US132679504003,132679504003,"Block Group 3, Census Tract 9504, Tattnall County, Georgia",386,308,78,79.792746114,20.207253886
5012,1500000US132679504004,132679504004,"Block Group 4, Census Tract 9504, Tattnall County, Georgia",1969,1209,760,61.4017267649,38.5982732351
5013,1500000US132699501001,132699501001,"Block Group 1, Census Tract 9501, Taylor County, Georgia",1418,1054,364,74.3300423131,25.6699576869
5014,1500000US132699502001,132699502001,"Block Group 1, Census Tract 9502, Taylor County, Georgia",1080,698,382,64.6296296296,35.3703703704
5015,1500000US132699502002,132699502002,"Block Group 2, Census Tract 9502, Taylor County, Georgia",1242,1038,204,83.5748792271,16.4251207729
5016,1500000US132699503001,132699503001,"Block Group 1, Census Tract 9503, Taylor County, Georgia",1567,1000,567,63.8162093172,36.1837906828
5017,1500000US132699503002,132699503002,"Block Group 2, Census Tract 9503, Taylor County, Georgia",1058,499,559,47.1644612476,52.8355387524
5018,1500000US132699503003,132699503003,"Block Group 3, Census Tract 9503, Taylor County, Georgia",895,559,336,62.4581005587,37.5418994413
5019,1500000US132699503004,132699503004,"Block Group 4, Census Tract 9503, Taylor County, Georgia",886,643,243,72.5733634312,27.4266365688
5020,1500000US132719501001,132719501001,"Block Group 1, Census Tract 9501, Telfair County, Georgia",2158,1413,745,65.4772937905,34.5227062095
5021,1500000US132719501002,132719501002,"Block Group 2, Census Tract 9501, Telfair County, Georgia",1077,476,601,44.1968430826,55.8031569174
5022,1500000US132719501003,132719501003,"Block Group 3, Census Tract 9501, Telfair County, Georgia",1428,960,468,67.2268907563,32.7731092437
5023,1500000US132719501004,132719501004,"Block Group 4, Census Tract 9501, Telfair County, Georgia",1069,407,662,38.0729653882,61.9270346118
5024,1500000US132719501005,132719501005,"Block Group 5, Census Tract 9501, Telfair County, Georgia",1953,815,1138,41.7306707629,58.2693292371
5025,1500000US132719502001,132719502001,"Block Group 1, Census Tract 9502, Telfair County, Georgia",743,491,252,66.0834454913,33.9165545087
5026,1500000US132719502002,132719502002,"Block Group 2, Census Tract 9502, Telfair County, Georgia",1041,853,188,81.9404418828,18.0595581172
5027,1500000US132719505001,132719505001,"Block Group 1, Census Tract 9505, Telfair County, Georgia",1098,790,308,71.9489981785,28.0510018215
5028,1500000US132719505002,132719505002,"Block Group 2, Census Tract 9505, Telfair County, Georgia",926,529,397,57.1274298056,42.8725701944
5029,1500000US132719505003,132719505003,"Block Group 3, Census Tract 9505, Telfair County, Georgia",1025,513,512,50.0487804878,49.9512195122
5030,1500000US132731202001,132731202001,"Block Group 1, Census Tract 1202, Terrell County, Georgia",679,434,245,63.9175257732,36.0824742268
5031,1500000US132731202002,132731202002,"Block Group 2, Census Tract 1202, Terrell County, Georgia",911,657,254,72.1185510428,27.8814489572
5032,1500000US132731203001,132731203001,"Block Group 1, Census Tract 1203, Terrell County, Georgia",673,434,239,64.4873699851,35.5126300149
5033,1500000US132731203002,132731203002,"Block Group 2, Census Tract 1203, Terrell County, Georgia",1132,324,808,28.6219081272,71.3780918728
5034,1500000US132731203003,132731203003,"Block Group 3, Census Tract 1203, Terrell County, Georgia",703,60,643,8.53485064011,91.4651493599
5035,1500000US132731203004,132731203004,"Block Group 4, Census Tract 1203, Terrell County, Georgia",464,184,280,39.6551724138,60.3448275862
5036,1500000US132731204001,132731204001,"Block Group 1, Census Tract 1204, Terrell County, Georgia",1065,634,431,59.5305164319,40.4694835681
5037,1500000US132731204002,132731204002,"Block Group 2, Census Tract 1204, Terrell County, Georgia",687,395,292,57.4963609898,42.5036390102
5038,1500000US132731204003,132731204003,"Block Group 3, Census Tract 1204, Terrell County, Georgia",939,261,678,27.7955271565,72.2044728435
5039,1500000US132731205001,132731205001,"Block Group 1, Census Tract 1205, Terrell County, Georgia",1637,1175,462,71.7776420281,28.2223579719
5040,1500000US132759601001,132759601001,"Block Group 1, Census Tract 9601, Thomas County, Georgia",574,351,223,61.149825784,38.850174216
5041,1500000US132759601002,132759601002,"Block Group 2, Census Tract 9601, Thomas County, Georgia",638,364,274,57.0532915361,42.9467084639
5042,1500000US132759602001,132759602001,"Block Group 1, Census Tract 9602, Thomas County, Georgia",2634,2293,341,87.0539104024,12.9460895976
5043,1500000US132759602002,132759602002,"Block Group 2, Census Tract 9602, Thomas County, Georgia",1286,692,594,53.8102643857,46.1897356143
5044,1500000US132759603001,132759603001,"Block Group 1, Census Tract 9603, Thomas County, Georgia",1194,759,435,63.567839196,36.432160804
5045,1500000US132759603002,132759603002,"Block Group 2, Census Tract 9603, Thomas County, Georgia",1045,772,273,73.8755980861,26.1244019139
5046,1500000US132759604001,132759604001,"Block Group 1, Census Tract 9604, Thomas County, Georgia",863,705,158,81.6917728853,18.3082271147
5047,1500000US132759604002,132759604002,"Block Group 2, Census Tract 9604, Thomas County, Georgia",1288,878,410,68.1677018634,31.8322981366
5048,1500000US132759605001,132759605001,"Block Group 1, Census Tract 9605, Thomas County, Georgia",3155,1532,1623,48.557844691,51.442155309
5049,1500000US132759605002,132759605002,"Block Group 2, Census Tract 9605, Thomas County, Georgia",1531,901,630,58.8504245591,41.1495754409
5050,1500000US132759605003,132759605003,"Block Group 3, Census Tract 9605, Thomas County, Georgia",2060,868,1192,42.1359223301,57.8640776699
5051,1500000US132759606001,132759606001,"Block Group 1, Census Tract 9606, Thomas County, Georgia",1596,1021,575,63.9724310777,36.0275689223
5052,1500000US132759606002,132759606002,"Block Group 2, Census Tract 9606, Thomas County, Georgia",1011,984,27,97.3293768546,2.6706231454
5053,1500000US132759606003,132759606003,"Block Group 3, Census Tract 9606, Thomas County, Georgia",348,178,170,51.1494252874,48.8505747126
5054,1500000US132759606004,132759606004,"Block Group 4, Census Tract 9606, Thomas County, Georgia",1684,319,1365,18.9429928741,81.0570071259
5055,1500000US132759606005,132759606005,"Block Group 5, Census Tract 9606, Thomas County, Georgia",856,309,547,36.0981308411,63.9018691589
5056,1500000US132759607001,132759607001,"Block Group 1, Census Tract 9607, Thomas County, Georgia",1970,1346,624,68.3248730964,31.6751269036
5057,1500000US132759607002,132759607002,"Block Group 2, Census Tract 9607, Thomas County, Georgia",1517,210,1307,13.8431114041,86.1568885959
5058,1500000US132759607003,132759607003,"Block Group 3, Census Tract 9607, Thomas County, Georgia",1312,736,576,56.0975609756,43.9024390244
5059,1500000US132759607004,132759607004,"Block Group 4, Census Tract 9607, Thomas County, Georgia",911,463,448,50.8232711306,49.1767288694
5060,1500000US132759607005,132759607005,"Block Group 5, Census Tract 9607, Thomas County, Georgia",781,341,440,43.661971831,56.338028169
5061,1500000US132759607006,132759607006,"Block Group 6, Census Tract 9607, Thomas County, Georgia",350,186,164,53.1428571429,46.8571428571
5062,1500000US132759608001,132759608001,"Block Group 1, Census Tract 9608, Thomas County, Georgia",932,899,33,96.4592274678,3.54077253219
5063,1500000US132759608002,132759608002,"Block Group 2, Census Tract 9608, Thomas County, Georgia",1457,832,625,57.1036376115,42.8963623885
5064,1500000US132759608003,132759608003,"Block Group 3, Census Tract 9608, Thomas County, Georgia",564,81,483,14.3617021277,85.6382978723
5065,1500000US132759608004,132759608004,"Block Group 4, Census Tract 9608, Thomas County, Georgia",846,357,489,42.1985815603,57.8014184397
5066,1500000US132759608005,132759608005,"Block Group 5, Census Tract 9608, Thomas County, Georgia",1471,1242,229,84.4323589395,15.5676410605
5067,1500000US132759609001,132759609001,"Block Group 1, Census Tract 9609, Thomas County, Georgia",705,456,249,64.6808510638,35.3191489362
5068,1500000US132759609002,132759609002,"Block Group 2, Census Tract 9609, Thomas County, Georgia",1883,1198,685,63.6218799788,36.3781200212
5069,1500000US132759609003,132759609003,"Block Group 3, Census Tract 9609, Thomas County, Georgia",934,741,193,79.3361884368,20.6638115632
5070,1500000US132759610001,132759610001,"Block Group 1, Census Tract 9610, Thomas County, Georgia",1984,1513,471,76.2600806452,23.7399193548
5071,1500000US132759610002,132759610002,"Block Group 2, Census Tract 9610, Thomas County, Georgia",970,480,490,49.4845360825,50.5154639175
5072,1500000US132759610003,132759610003,"Block Group 3, Census Tract 9610, Thomas County, Georgia",775,571,204,73.6774193548,26.3225806452
5073,1500000US132759611001,132759611001,"Block Group 1, Census Tract 9611, Thomas County, Georgia",892,618,274,69.2825112108,30.7174887892
5074,1500000US132759611002,132759611002,"Block Group 2, Census Tract 9611, Thomas County, Georgia",1072,611,461,56.9962686567,43.0037313433
5075,1500000US132759611003,132759611003,"Block Group 3, Census Tract 9611, Thomas County, Georgia",847,619,228,73.0814639906,26.9185360094
5076,1500000US132779601001,132779601001,"Block Group 1, Census Tract 9601, Tift County, Georgia",1346,992,354,73.6998514116,26.3001485884
5077,1500000US132779601002,132779601002,"Block Group 2, Census Tract 9601, Tift County, Georgia",1157,1035,122,89.4554883319,10.5445116681
5078,1500000US132779602001,132779602001,"Block Group 1, Census Tract 9602, Tift County, Georgia",1419,1313,106,92.5299506695,7.47004933051
5079,1500000US132779602002,132779602002,"Block Group 2, Census Tract 9602, Tift County, Georgia",1565,1140,425,72.8434504792,27.1565495208
5080,1500000US132779603001,132779603001,"Block Group 1, Census Tract 9603, Tift County, Georgia",512,350,162,68.359375,31.640625
5081,1500000US132779603002,132779603002,"Block Group 2, Census Tract 9603, Tift County, Georgia",998,436,562,43.6873747495,56.3126252505
5082,1500000US132779603003,132779603003,"Block Group 3, Census Tract 9603, Tift County, Georgia",2985,1304,1681,43.6850921273,56.3149078727
5083,1500000US132779603004,132779603004,"Block Group 4, Census Tract 9603, Tift County, Georgia",549,154,395,28.0510018215,71.9489981785
5084,1500000US132779603005,132779603005,"Block Group 5, Census Tract 9603, Tift County, Georgia",849,542,307,63.839811543,36.160188457
5085,1500000US132779603006,132779603006,"Block Group 6, Census Tract 9603, Tift County, Georgia",492,49,443,9.9593495935,90.0406504065
5086,1500000US132779604001,132779604001,"Block Group 1, Census Tract 9604, Tift County, Georgia",304,285,19,93.75,6.25
5087,1500000US132779604002,132779604002,"Block Group 2, Census Tract 9604, Tift County, Georgia",944,279,665,29.5550847458,70.4449152542
5088,1500000US132779604003,132779604003,"Block Group 3, Census Tract 9604, Tift County, Georgia",2256,558,1698,24.7340425532,75.2659574468
5089,1500000US132779604004,132779604004,"Block Group 4, Census Tract 9604, Tift County, Georgia",982,862,120,87.7800407332,12.2199592668
5090,1500000US132779604005,132779604005,"Block Group 5, Census Tract 9604, Tift County, Georgia",401,118,283,29.4264339152,70.5735660848
5091,1500000US132779604006,132779604006,"Block Group 6, Census Tract 9604, Tift County, Georgia",1193,633,560,53.0595138307,46.9404861693
5092,1500000US132779605001,132779605001,"Block Group 1, Census Tract 9605, Tift County, Georgia",2766,2496,270,90.2386117137,9.76138828633
5093,1500000US132779605002,132779605002,"Block Group 2, Census Tract 9605, Tift County, Georgia",1775,1415,360,79.7183098592,20.2816901408
5094,1500000US132779606001,132779606001,"Block Group 1, Census Tract 9606, Tift County, Georgia",1278,44,1234,3.44287949922,96.5571205008
5095,1500000US132779606002,132779606002,"Block Group 2, Census Tract 9606, Tift County, Georgia",2842,990,1852,34.8346235046,65.1653764954
5096,1500000US132779606003,132779606003,"Block Group 3, Census Tract 9606, Tift County, Georgia",1011,379,632,37.487636004,62.512363996
5097,1500000US132779606004,132779606004,"Block Group 4, Census Tract 9606, Tift County, Georgia",639,349,290,54.6165884194,45.3834115806
5098,1500000US132779607001,132779607001,"Block Group 1, Census Tract 9607, Tift County, Georgia",830,239,591,28.7951807229,71.2048192771
5099,1500000US132779607002,132779607002,"Block Group 2, Census Tract 9607, Tift County, Georgia",2639,1424,1215,53.9598332702,46.0401667298
5100,1500000US132779607003,132779607003,"Block Group 3, Census Tract 9607, Tift County, Georgia",383,181,202,47.2584856397,52.7415143603
5101,1500000US132779607004,132779607004,"Block Group 4, Census Tract 9607, Tift County, Georgia",805,79,726,9.81366459627,90.1863354037
5102,1500000US132779608001,132779608001,"Block Group 1, Census Tract 9608, Tift County, Georgia",1238,800,438,64.620355412,35.379644588
5103,1500000US132779608002,132779608002,"Block Group 2, Census Tract 9608, Tift County, Georgia",1333,861,472,64.5911477869,35.4088522131
5104,1500000US132779609001,132779609001,"Block Group 1, Census Tract 9609, Tift County, Georgia",840,449,391,53.4523809524,46.5476190476
5105,1500000US132779609002,132779609002,"Block Group 2, Census Tract 9609, Tift County, Georgia",1221,1016,205,83.2104832105,16.7895167895
5106,1500000US132779609003,132779609003,"Block Group 3, Census Tract 9609, Tift County, Georgia",1396,1361,35,97.4928366762,2.50716332378
5107,1500000US132799701001,132799701001,"Block Group 1, Census Tract 9701, Toombs County, Georgia",2331,1592,739,68.2968682969,31.7031317031
5108,1500000US132799701002,132799701002,"Block Group 2, Census Tract 9701, Toombs County, Georgia",898,442,456,49.2204899777,50.7795100223
5109,1500000US132799701003,132799701003,"Block Group 3, Census Tract 9701, Toombs County, Georgia",1068,338,730,31.6479400749,68.3520599251
5110,1500000US132799701004,132799701004,"Block Group 4, Census Tract 9701, Toombs County, Georgia",1174,687,487,58.5178875639,41.4821124361
5111,1500000US132799702001,132799702001,"Block Group 1, Census Tract 9702, Toombs County, Georgia",1535,1222,313,79.6091205212,20.3908794788
5112,1500000US132799702002,132799702002,"Block Group 2, Census Tract 9702, Toombs County, Georgia",964,648,316,67.2199170124,32.7800829876
5113,1500000US132799702003,132799702003,"Block Group 3, Census Tract 9702, Toombs County, Georgia",901,486,415,53.9400665927,46.0599334073
5114,1500000US132799702004,132799702004,"Block Group 4, Census Tract 9702, Toombs County, Georgia",765,67,698,8.75816993464,91.2418300654
5115,1500000US132799702005,132799702005,"Block Group 5, Census Tract 9702, Toombs County, Georgia",305,78,227,25.5737704918,74.4262295082
5116,1500000US132799703001,132799703001,"Block Group 1, Census Tract 9703, Toombs County, Georgia",1219,1083,136,88.843314192,11.156685808
5117,1500000US132799703002,132799703002,"Block Group 2, Census Tract 9703, Toombs County, Georgia",1407,393,1014,27.9317697228,72.0682302772
5118,1500000US132799703003,132799703003,"Block Group 3, Census Tract 9703, Toombs County, Georgia",1212,974,238,80.3630363036,19.6369636964
5119,1500000US132799703004,132799703004,"Block Group 4, Census Tract 9703, Toombs County, Georgia",683,425,258,62.2254758419,37.7745241581
5120,1500000US132799703005,132799703005,"Block Group 5, Census Tract 9703, Toombs County, Georgia",1751,1712,39,97.7727013135,2.22729868646
5121,1500000US132799704001,132799704001,"Block Group 1, Census Tract 9704, Toombs County, Georgia",689,175,514,25.3991291727,74.6008708273
5122,1500000US132799704002,132799704002,"Block Group 2, Census Tract 9704, Toombs County, Georgia",525,298,227,56.7619047619,43.2380952381
5123,1500000US132799704003,132799704003,"Block Group 3, Census Tract 9704, Toombs County, Georgia",1136,931,205,81.9542253521,18.0457746479
5124,1500000US132799704004,132799704004,"Block Group 4, Census Tract 9704, Toombs County, Georgia",1800,685,1115,38.0555555556,61.9444444444
5125,1500000US132799705001,132799705001,"Block Group 1, Census Tract 9705, Toombs County, Georgia",398,203,195,51.0050251256,48.9949748744
5126,1500000US132799705002,132799705002,"Block Group 2, Census Tract 9705, Toombs County, Georgia",1642,1149,493,69.9756394641,30.0243605359
5127,1500000US132799705003,132799705003,"Block Group 3, Census Tract 9705, Toombs County, Georgia",1500,966,534,64.4,35.6
5128,1500000US132799706001,132799706001,"Block Group 1, Census Tract 9706, Toombs County, Georgia",1012,856,156,84.5849802372,15.4150197628
5129,1500000US132799706002,132799706002,"Block Group 2, Census Tract 9706, Toombs County, Georgia",1256,984,272,78.3439490446,21.6560509554
5130,1500000US132799706003,132799706003,"Block Group 3, Census Tract 9706, Toombs County, Georgia",574,424,150,73.8675958188,26.1324041812
5131,1500000US132819601001,132819601001,"Block Group 1, Census Tract 9601, Towns County, Georgia",1778,1410,368,79.3025871766,20.6974128234
5132,1500000US132819601002,132819601002,"Block Group 2, Census Tract 9601, Towns County, Georgia",1294,1094,200,84.544049459,15.455950541
5133,1500000US132819601003,132819601003,"Block Group 3, Census Tract 9601, Towns County, Georgia",676,396,280,58.5798816568,41.4201183432
5134,1500000US132819602001,132819602001,"Block Group 1, Census Tract 9602, Towns County, Georgia",1249,1021,228,81.7453963171,18.2546036829
5135,1500000US132819602002,132819602002,"Block Group 2, Census Tract 9602, Towns County, Georgia",1463,1297,166,88.6534518113,11.3465481887
5136,1500000US132819603001,132819603001,"Block Group 1, Census Tract 9603, Towns County, Georgia",1227,969,258,78.9731051345,21.0268948655
5137,1500000US132819603002,132819603002,"Block Group 2, Census Tract 9603, Towns County, Georgia",1191,999,192,83.879093199,16.120906801
5138,1500000US132819603003,132819603003,"Block Group 3, Census Tract 9603, Towns County, Georgia",1110,678,432,61.0810810811,38.9189189189
5139,1500000US132839601001,132839601001,"Block Group 1, Census Tract 9601, Treutlen County, Georgia",582,419,163,71.9931271478,28.0068728522
5140,1500000US132839601002,132839601002,"Block Group 2, Census Tract 9601, Treutlen County, Georgia",559,428,131,76.5652951699,23.4347048301
5141,1500000US132839602001,132839602001,"Block Group 1, Census Tract 9602, Treutlen County, Georgia",924,542,382,58.658008658,41.341991342
5142,1500000US132839602002,132839602002,"Block Group 2, Census Tract 9602, Treutlen County, Georgia",809,496,313,61.3102595797,38.6897404203
5143,1500000US132839602003,132839602003,"Block Group 3, Census Tract 9602, Treutlen County, Georgia",1432,1067,365,74.5111731844,25.4888268156
5144,1500000US132839602004,132839602004,"Block Group 4, Census Tract 9602, Treutlen County, Georgia",640,440,200,68.75,31.25
5145,1500000US132839602005,132839602005,"Block Group 5, Census Tract 9602, Treutlen County, Georgia",1307,998,309,76.3580719204,23.6419280796
5146,1500000US132859601001,132859601001,"Block Group 1, Census Tract 9601, Troup County, Georgia",1349,854,495,63.3061527057,36.6938472943
5147,1500000US132859601002,132859601002,"Block Group 2, Census Tract 9601, Troup County, Georgia",1310,822,488,62.7480916031,37.2519083969
5148,1500000US132859601003,132859601003,"Block Group 3, Census Tract 9601, Troup County, Georgia",1220,671,549,55.0,45.0
5149,1500000US132859601004,132859601004,"Block Group 4, Census Tract 9601, Troup County, Georgia",2189,1660,529,75.8337140247,24.1662859753
5150,1500000US132859602011,132859602011,"Block Group 1, Census Tract 9602.01, Troup County, Georgia",3046,2744,302,90.0853578464,9.91464215364
5151,1500000US132859602021,132859602021,"Block Group 1, Census Tract 9602.02, Troup County, Georgia",2346,1717,629,73.1884057971,26.8115942029
5152,1500000US132859603001,132859603001,"Block Group 1, Census Tract 9603, Troup County, Georgia",718,589,129,82.0334261838,17.9665738162
5153,1500000US132859603002,132859603002,"Block Group 2, Census Tract 9603, Troup County, Georgia",992,857,135,86.3911290323,13.6088709677
5154,1500000US132859603003,132859603003,"Block Group 3, Census Tract 9603, Troup County, Georgia",1851,1600,251,86.4397622907,13.5602377093
5155,1500000US132859604001,132859604001,"Block Group 1, Census Tract 9604, Troup County, Georgia",807,283,524,35.0681536555,64.9318463445
5156,1500000US132859604002,132859604002,"Block Group 2, Census Tract 9604, Troup County, Georgia",1852,839,1013,45.3023758099,54.6976241901
5157,1500000US132859604003,132859604003,"Block Group 3, Census Tract 9604, Troup County, Georgia",3021,1710,1311,56.6037735849,43.3962264151
5158,1500000US132859605011,132859605011,"Block Group 1, Census Tract 9605.01, Troup County, Georgia",1402,792,610,56.4907275321,43.5092724679
5159,1500000US132859605012,132859605012,"Block Group 2, Census Tract 9605.01, Troup County, Georgia",651,93,558,14.2857142857,85.7142857143
5160,1500000US132859605013,132859605013,"Block Group 3, Census Tract 9605.01, Troup County, Georgia",1272,547,725,43.0031446541,56.9968553459
5161,1500000US132859605014,132859605014,"Block Group 4, Census Tract 9605.01, Troup County, Georgia",1379,183,1196,13.2704858593,86.7295141407
5162,1500000US132859605021,132859605021,"Block Group 1, Census Tract 9605.02, Troup County, Georgia",2383,1927,456,80.8644565674,19.1355434326
5163,1500000US132859605022,132859605022,"Block Group 2, Census Tract 9605.02, Troup County, Georgia",4974,2099,2875,42.1994370728,57.8005629272
5164,1500000US132859606001,132859606001,"Block Group 1, Census Tract 9606, Troup County, Georgia",1447,1214,233,83.8977194195,16.1022805805
5165,1500000US132859606002,132859606002,"Block Group 2, Census Tract 9606, Troup County, Georgia",1640,772,868,47.0731707317,52.9268292683
5166,1500000US132859606003,132859606003,"Block Group 3, Census Tract 9606, Troup County, Georgia",899,97,802,10.7897664071,89.2102335929
5167,1500000US132859606004,132859606004,"Block Group 4, Census Tract 9606, Troup County, Georgia",1577,252,1325,15.9797083069,84.0202916931
5168,1500000US132859607001,132859607001,"Block Group 1, Census Tract 9607, Troup County, Georgia",1744,422,1322,24.1972477064,75.8027522936
5169,1500000US132859607002,132859607002,"Block Group 2, Census Tract 9607, Troup County, Georgia",1792,1190,602,66.40625,33.59375
5170,1500000US132859607003,132859607003,"Block Group 3, Census Tract 9607, Troup County, Georgia",1372,877,495,63.9212827988,36.0787172012
5171,1500000US132859607004,132859607004,"Block Group 4, Census Tract 9607, Troup County, Georgia",606,267,339,44.0594059406,55.9405940594
5172,1500000US132859608001,132859608001,"Block Group 1, Census Tract 9608, Troup County, Georgia",1262,432,830,34.2313787639,65.7686212361
5173,1500000US132859608002,132859608002,"Block Group 2, Census Tract 9608, Troup County, Georgia",1170,452,718,38.6324786325,61.3675213675
5174,1500000US132859608003,132859608003,"Block Group 3, Census Tract 9608, Troup County, Georgia",1003,198,805,19.740777667,80.259222333
5175,1500000US132859609011,132859609011,"Block Group 1, Census Tract 9609.01, Troup County, Georgia",882,370,512,41.9501133787,58.0498866213
5176,1500000US132859609012,132859609012,"Block Group 2, Census Tract 9609.01, Troup County, Georgia",1494,260,1234,17.4029451138,82.5970548862
5177,1500000US132859609013,132859609013,"Block Group 3, Census Tract 9609.01, Troup County, Georgia",1935,780,1155,40.3100775194,59.6899224806
5178,1500000US132859609021,132859609021,"Block Group 1, Census Tract 9609.02, Troup County, Georgia",2192,2063,129,94.1149635036,5.88503649635
5179,1500000US132859609022,132859609022,"Block Group 2, Census Tract 9609.02, Troup County, Georgia",2837,2362,475,83.2569615791,16.7430384209
5180,1500000US132859609023,132859609023,"Block Group 3, Census Tract 9609.02, Troup County, Georgia",1686,1237,449,73.3689205219,26.6310794781
5181,1500000US132859610001,132859610001,"Block Group 1, Census Tract 9610, Troup County, Georgia",2005,1441,564,71.8703241895,28.1296758105
5182,1500000US132859610002,132859610002,"Block Group 2, Census Tract 9610, Troup County, Georgia",1671,1401,270,83.842010772,16.157989228
5183,1500000US132859610003,132859610003,"Block Group 3, Census Tract 9610, Troup County, Georgia",1084,331,753,30.5350553506,69.4649446494
5184,1500000US132859610004,132859610004,"Block Group 4, Census Tract 9610, Troup County, Georgia",1448,134,1314,9.25414364641,90.7458563536
5185,1500000US132859611001,132859611001,"Block Group 1, Census Tract 9611, Troup County, Georgia",1353,1050,303,77.6053215078,22.3946784922
5186,1500000US132859611002,132859611002,"Block Group 2, Census Tract 9611, Troup County, Georgia",1403,1291,112,92.017106201,7.982893799
5187,1500000US132879702001,132879702001,"Block Group 1, Census Tract 9702, Turner County, Georgia",887,621,266,70.0112739572,29.9887260428
5188,1500000US132879702002,132879702002,"Block Group 2, Census Tract 9702, Turner County, Georgia",1013,847,166,83.6130306022,16.3869693978
5189,1500000US132879702003,132879702003,"Block Group 3, Census Tract 9702, Turner County, Georgia",1005,793,212,78.9054726368,21.0945273632
5190,1500000US132879702004,132879702004,"Block Group 4, Census Tract 9702, Turner County, Georgia",1563,846,717,54.1266794626,45.8733205374
5191,1500000US132879702005,132879702005,"Block Group 5, Census Tract 9702, Turner County, Georgia",803,385,418,47.9452054795,52.0547945205
5192,1500000US132879703001,132879703001,"Block Group 1, Census Tract 9703, Turner County, Georgia",779,427,352,54.8138639281,45.1861360719
5193,1500000US132879703002,132879703002,"Block Group 2, Census Tract 9703, Turner County, Georgia",499,476,23,95.3907815631,4.60921843687
5194,1500000US132879703003,132879703003,"Block Group 3, Census Tract 9703, Turner County, Georgia",686,625,61,91.1078717201,8.89212827988
5195,1500000US132879703004,132879703004,"Block Group 4, Census Tract 9703, Turner County, Georgia",699,482,217,68.9556509299,31.0443490701
5196,1500000US132890601001,132890601001,"Block Group 1, Census Tract 601, Twiggs County, Georgia",1019,522,497,51.2266928361,48.7733071639
5197,1500000US132890601002,132890601002,"Block Group 2, Census Tract 601, Twiggs County, Georgia",1392,1173,219,84.2672413793,15.7327586207
5198,1500000US132890601003,132890601003,"Block Group 3, Census Tract 601, Twiggs County, Georgia",512,500,12,97.65625,2.34375
5199,1500000US132890601004,132890601004,"Block Group 4, Census Tract 601, Twiggs County, Georgia",2048,1886,162,92.08984375,7.91015625
5200,1500000US132890602001,132890602001,"Block Group 1, Census Tract 602, Twiggs County, Georgia",1108,764,344,68.9530685921,31.0469314079
5201,1500000US132890602002,132890602002,"Block Group 2, Census Tract 602, Twiggs County, Georgia",1209,893,316,73.8626964433,26.1373035567
5202,1500000US132890602003,132890602003,"Block Group 3, Census Tract 602, Twiggs County, Georgia",725,578,147,79.724137931,20.275862069
5203,1500000US132890602004,132890602004,"Block Group 4, Census Tract 602, Twiggs County, Georgia",409,256,153,62.5916870416,37.4083129584
5204,1500000US132910001011,132910001011,"Block Group 1, Census Tract 1.01, Union County, Georgia",2652,2338,314,88.1598793363,11.8401206637
5205,1500000US132910001021,132910001021,"Block Group 1, Census Tract 1.02, Union County, Georgia",1922,1048,874,54.5265348595,45.4734651405
5206,1500000US132910001022,132910001022,"Block Group 2, Census Tract 1.02, Union County, Georgia",1023,1008,15,98.5337243402,1.46627565982
5207,1500000US132910001023,132910001023,"Block Group 3, Census Tract 1.02, Union County, Georgia",2164,1965,199,90.8040665434,9.19593345656
5208,1500000US132910002011,132910002011,"Block Group 1, Census Tract 2.01, Union County, Georgia",925,744,181,80.4324324324,19.5675675676
5209,1500000US132910002012,132910002012,"Block Group 2, Census Tract 2.01, Union County, Georgia",1839,1558,281,84.7199564981,15.2800435019
5210,1500000US132910002031,132910002031,"Block Group 1, Census Tract 2.03, Union County, Georgia",1526,1207,319,79.0956749672,20.9043250328
5211,1500000US132910002032,132910002032,"Block Group 2, Census Tract 2.03, Union County, Georgia",752,680,72,90.4255319149,9.57446808511
5212,1500000US132910002041,132910002041,"Block Group 1, Census Tract 2.04, Union County, Georgia",735,559,176,76.0544217687,23.9455782313
5213,1500000US132910002042,132910002042,"Block Group 2, Census Tract 2.04, Union County, Georgia",2375,1916,459,80.6736842105,19.3263157895
5214,1500000US132910002051,132910002051,"Block Group 1, Census Tract 2.05, Union County, Georgia",958,874,84,91.2317327766,8.76826722338
5215,1500000US132910002052,132910002052,"Block Group 2, Census Tract 2.05, Union County, Georgia",2106,1608,498,76.3532763533,23.6467236467
5216,1500000US132910002053,132910002053,"Block Group 3, Census Tract 2.05, Union County, Georgia",1116,374,742,33.5125448029,66.4874551971
5217,1500000US132910002054,132910002054,"Block Group 4, Census Tract 2.05, Union County, Georgia",1159,764,395,65.9188955997,34.0811044003
5218,1500000US132930101001,132930101001,"Block Group 1, Census Tract 101, Upson County, Georgia",1928,1347,581,69.8651452282,30.1348547718
5219,1500000US132930101002,132930101002,"Block Group 2, Census Tract 101, Upson County, Georgia",1045,795,250,76.0765550239,23.9234449761
5220,1500000US132930102011,132930102011,"Block Group 1, Census Tract 102.01, Upson County, Georgia",1645,996,649,60.547112462,39.452887538
5221,1500000US132930102012,132930102012,"Block Group 2, Census Tract 102.01, Upson County, Georgia",2116,1150,966,54.347826087,45.652173913
5222,1500000US132930102013,132930102013,"Block Group 3, Census Tract 102.01, Upson County, Georgia",1330,831,499,62.4812030075,37.5187969925
5223,1500000US132930102021,132930102021,"Block Group 1, Census Tract 102.02, Upson County, Georgia",1228,919,309,74.8371335505,25.1628664495
5224,1500000US132930102022,132930102022,"Block Group 2, Census Tract 102.02, Upson County, Georgia",1410,1159,251,82.1985815603,17.8014184397
5225,1500000US132930103001,132930103001,"Block Group 1, Census Tract 103, Upson County, Georgia",1835,1368,467,74.5504087193,25.4495912807
5226,1500000US132930103002,132930103002,"Block Group 2, Census Tract 103, Upson County, Georgia",1290,1137,153,88.1395348837,11.8604651163
5227,1500000US132930104001,132930104001,"Block Group 1, Census Tract 104, Upson County, Georgia",1137,473,664,41.600703606,58.399296394
5228,1500000US132930104002,132930104002,"Block Group 2, Census Tract 104, Upson County, Georgia",1555,781,774,50.2250803859,49.7749196141
5229,1500000US132930104003,132930104003,"Block Group 3, Census Tract 104, Upson County, Georgia",1115,398,717,35.6950672646,64.3049327354
5230,1500000US132930104004,132930104004,"Block Group 4, Census Tract 104, Upson County, Georgia",933,756,177,81.0289389068,18.9710610932
5231,1500000US132930104005,132930104005,"Block Group 5, Census Tract 104, Upson County, Georgia",494,377,117,76.3157894737,23.6842105263
5232,1500000US132930104006,132930104006,"Block Group 6, Census Tract 104, Upson County, Georgia",489,263,226,53.7832310838,46.2167689162
5233,1500000US132930105001,132930105001,"Block Group 1, Census Tract 105, Upson County, Georgia",1573,426,1147,27.0820089002,72.9179910998
5234,1500000US132930105002,132930105002,"Block Group 2, Census Tract 105, Upson County, Georgia",1331,1107,224,83.1705484598,16.8294515402
5235,1500000US132930105003,132930105003,"Block Group 3, Census Tract 105, Upson County, Georgia",498,142,356,28.5140562249,71.4859437751
5236,1500000US132930105004,132930105004,"Block Group 4, Census Tract 105, Upson County, Georgia",571,243,328,42.5569176883,57.4430823117
5237,1500000US132930105005,132930105005,"Block Group 5, Census Tract 105, Upson County, Georgia",1232,577,655,46.8344155844,53.1655844156
5238,1500000US132930106001,132930106001,"Block Group 1, Census Tract 106, Upson County, Georgia",1187,1009,178,85.0042122999,14.9957877001
5239,1500000US132950201001,132950201001,"Block Group 1, Census Tract 201, Walker County, Georgia",909,691,218,76.0176017602,23.9823982398
5240,1500000US132950201002,132950201002,"Block Group 2, Census Tract 201, Walker County, Georgia",1701,1221,480,71.7813051146,28.2186948854
5241,1500000US132950201003,132950201003,"Block Group 3, Census Tract 201, Walker County, Georgia",951,653,298,68.6645636172,31.3354363828
5242,1500000US132950201004,132950201004,"Block Group 4, Census Tract 201, Walker County, Georgia",830,505,325,60.843373494,39.156626506
5243,1500000US132950201005,132950201005,"Block Group 5, Census Tract 201, Walker County, Georgia",995,780,215,78.391959799,21.608040201
5244,1500000US132950201006,132950201006,"Block Group 6, Census Tract 201, Walker County, Georgia",1207,467,740,38.6909693455,61.3090306545
5245,1500000US132950202001,132950202001,"Block Group 1, Census Tract 202, Walker County, Georgia",2389,1045,1344,43.7421515278,56.2578484722
5246,1500000US132950202002,132950202002,"Block Group 2, Census Tract 202, Walker County, Georgia",1547,499,1048,32.2559793148,67.7440206852
5247,1500000US132950203011,132950203011,"Block Group 1, Census Tract 203.01, Walker County, Georgia",2046,1050,996,51.3196480938,48.6803519062
5248,1500000US132950203012,132950203012,"Block Group 2, Census Tract 203.01, Walker County, Georgia",999,568,431,56.8568568569,43.1431431431
5249,1500000US132950203013,132950203013,"Block Group 3, Census Tract 203.01, Walker County, Georgia",981,596,385,60.754332314,39.245667686
5250,1500000US132950203014,132950203014,"Block Group 4, Census Tract 203.01, Walker County, Georgia",693,693,0,100.0,0.0
5251,1500000US132950203021,132950203021,"Block Group 1, Census Tract 203.02, Walker County, Georgia",915,617,298,67.4316939891,32.5683060109
5252,1500000US132950203022,132950203022,"Block Group 2, Census Tract 203.02, Walker County, Georgia",454,393,61,86.563876652,13.436123348
5253,1500000US132950203023,132950203023,"Block Group 3, Census Tract 203.02, Walker County, Georgia",675,609,66,90.2222222222,9.77777777778
5254,1500000US132950203024,132950203024,"Block Group 4, Census Tract 203.02, Walker County, Georgia",784,481,303,61.3520408163,38.6479591837
5255,1500000US132950203025,132950203025,"Block Group 5, Census Tract 203.02, Walker County, Georgia",2262,1560,702,68.9655172414,31.0344827586
5256,1500000US132950204001,132950204001,"Block Group 1, Census Tract 204, Walker County, Georgia",738,633,105,85.7723577236,14.2276422764
5257,1500000US132950204002,132950204002,"Block Group 2, Census Tract 204, Walker County, Georgia",924,808,116,87.4458874459,12.5541125541
5258,1500000US132950204003,132950204003,"Block Group 3, Census Tract 204, Walker County, Georgia",1543,1030,513,66.7530784187,33.2469215813
5259,1500000US132950205011,132950205011,"Block Group 1, Census Tract 205.01, Walker County, Georgia",1636,1175,461,71.8215158924,28.1784841076
5260,1500000US132950205012,132950205012,"Block Group 2, Census Tract 205.01, Walker County, Georgia",2429,1725,704,71.0168793742,28.9831206258
5261,1500000US132950205013,132950205013,"Block Group 3, Census Tract 205.01, Walker County, Georgia",4089,3138,951,76.7424798239,23.2575201761
5262,1500000US132950205021,132950205021,"Block Group 1, Census Tract 205.02, Walker County, Georgia",1317,884,433,67.1222475323,32.8777524677
5263,1500000US132950205022,132950205022,"Block Group 2, Census Tract 205.02, Walker County, Georgia",3221,2589,632,80.3787643589,19.6212356411
5264,1500000US132950205023,132950205023,"Block Group 3, Census Tract 205.02, Walker County, Georgia",2008,1158,850,57.6693227092,42.3306772908
5265,1500000US132950206011,132950206011,"Block Group 1, Census Tract 206.01, Walker County, Georgia",2322,2005,317,86.3479758829,13.6520241171
5266,1500000US132950206012,132950206012,"Block Group 2, Census Tract 206.01, Walker County, Georgia",1712,1241,471,72.488317757,27.511682243
5267,1500000US132950206013,132950206013,"Block Group 3, Census Tract 206.01, Walker County, Georgia",2086,1881,205,90.1725790988,9.82742090125
5268,1500000US132950206021,132950206021,"Block Group 1, Census Tract 206.02, Walker County, Georgia",2481,2294,187,92.4627166465,7.53728335349
5269,1500000US132950206022,132950206022,"Block Group 2, Census Tract 206.02, Walker County, Georgia",1883,1669,214,88.6351566649,11.3648433351
5270,1500000US132950207001,132950207001,"Block Group 1, Census Tract 207, Walker County, Georgia",1808,1249,559,69.0818584071,30.9181415929
5271,1500000US132950207002,132950207002,"Block Group 2, Census Tract 207, Walker County, Georgia",1124,528,596,46.975088968,53.024911032
5272,1500000US132950207003,132950207003,"Block Group 3, Census Tract 207, Walker County, Georgia",586,225,361,38.3959044369,61.6040955631
5273,1500000US132950207004,132950207004,"Block Group 4, Census Tract 207, Walker County, Georgia",689,374,315,54.2815674891,45.7184325109
5274,1500000US132950207005,132950207005,"Block Group 5, Census Tract 207, Walker County, Georgia",2099,1097,1002,52.2629823726,47.7370176274
5275,1500000US132950207006,132950207006,"Block Group 6, Census Tract 207, Walker County, Georgia",579,385,194,66.493955095,33.506044905
5276,1500000US132950208001,132950208001,"Block Group 1, Census Tract 208, Walker County, Georgia",1141,931,210,81.5950920245,18.4049079755
5277,1500000US132950208002,132950208002,"Block Group 2, Census Tract 208, Walker County, Georgia",958,847,111,88.4133611691,11.5866388309
5278,1500000US132950208003,132950208003,"Block Group 3, Census Tract 208, Walker County, Georgia",1112,747,365,67.1762589928,32.8237410072
5279,1500000US132950209011,132950209011,"Block Group 1, Census Tract 209.01, Walker County, Georgia",2904,2651,253,91.2878787879,8.71212121212
5280,1500000US132950209012,132950209012,"Block Group 2, Census Tract 209.01, Walker County, Georgia",1944,1686,258,86.7283950617,13.2716049383
5281,1500000US132950209013,132950209013,"Block Group 3, Census Tract 209.01, Walker County, Georgia",673,496,177,73.6998514116,26.3001485884
5282,1500000US132950209014,132950209014,"Block Group 4, Census Tract 209.01, Walker County, Georgia",746,746,0,100.0,0.0
5283,1500000US132950209021,132950209021,"Block Group 1, Census Tract 209.02, Walker County, Georgia",660,571,89,86.5151515152,13.4848484848
5284,1500000US132950209022,132950209022,"Block Group 2, Census Tract 209.02, Walker County, Georgia",1172,1040,132,88.7372013652,11.2627986348
5285,1500000US132971101001,132971101001,"Block Group 1, Census Tract 1101, Walton County, Georgia",2813,2218,595,78.8482047636,21.1517952364
5286,1500000US132971101002,132971101002,"Block Group 2, Census Tract 1101, Walton County, Georgia",1868,1528,340,81.7987152034,18.2012847966
5287,1500000US132971101003,132971101003,"Block Group 3, Census Tract 1101, Walton County, Georgia",4191,3940,251,94.0109759007,5.98902409926
5288,1500000US132971102001,132971102001,"Block Group 1, Census Tract 1102, Walton County, Georgia",1663,1019,644,61.2748045701,38.7251954299
5289,1500000US132971102002,132971102002,"Block Group 2, Census Tract 1102, Walton County, Georgia",2549,2298,251,90.1530011769,9.84699882307
5290,1500000US132971103001,132971103001,"Block Group 1, Census Tract 1103, Walton County, Georgia",1822,887,935,48.682766191,51.317233809
5291,1500000US132971103002,132971103002,"Block Group 2, Census Tract 1103, Walton County, Georgia",3869,1843,2026,47.635047816,52.364952184
5292,1500000US132971103003,132971103003,"Block Group 3, Census Tract 1103, Walton County, Georgia",1238,534,704,43.1340872375,56.8659127625
5293,1500000US132971104001,132971104001,"Block Group 1, Census Tract 1104, Walton County, Georgia",2348,1430,918,60.9028960818,39.0971039182
5294,1500000US132971104002,132971104002,"Block Group 2, Census Tract 1104, Walton County, Georgia",2198,730,1468,33.212010919,66.787989081
5295,1500000US132971104003,132971104003,"Block Group 3, Census Tract 1104, Walton County, Georgia",1951,1014,937,51.9733470015,48.0266529985
5296,1500000US132971105031,132971105031,"Block Group 1, Census Tract 1105.03, Walton County, Georgia",3466,2750,716,79.3421811887,20.6578188113
5297,1500000US132971105041,132971105041,"Block Group 1, Census Tract 1105.04, Walton County, Georgia",2085,1715,370,82.2541966427,17.7458033573
5298,1500000US132971105042,132971105042,"Block Group 2, Census Tract 1105.04, Walton County, Georgia",2857,1459,1398,51.0675533777,48.9324466223
5299,1500000US132971105051,132971105051,"Block Group 1, Census Tract 1105.05, Walton County, Georgia",4223,3652,571,86.4788065356,13.5211934644
5300,1500000US132971105061,132971105061,"Block Group 1, Census Tract 1105.06, Walton County, Georgia",1417,1052,365,74.2413549753,25.7586450247
5301,1500000US132971105062,132971105062,"Block Group 2, Census Tract 1105.06, Walton County, Georgia",1459,1154,305,79.0952707334,20.9047292666
5302,1500000US132971105063,132971105063,"Block Group 3, Census Tract 1105.06, Walton County, Georgia",2267,1967,300,86.7666519629,13.2333480371
5303,1500000US132971105071,132971105071,"Block Group 1, Census Tract 1105.07, Walton County, Georgia",1478,1381,97,93.4370771313,6.56292286874
5304,1500000US132971105072,132971105072,"Block Group 2, Census Tract 1105.07, Walton County, Georgia",1155,1155,0,100.0,0.0
5305,1500000US132971105073,132971105073,"Block Group 3, Census Tract 1105.07, Walton County, Georgia",4979,3837,1142,77.0636674031,22.9363325969
5306,1500000US132971105081,132971105081,"Block Group 1, Census Tract 1105.08, Walton County, Georgia",1978,1675,303,84.6814964611,15.3185035389
5307,1500000US132971105082,132971105082,"Block Group 2, Census Tract 1105.08, Walton County, Georgia",1822,1669,153,91.6026344676,8.39736553238
5308,1500000US132971105083,132971105083,"Block Group 3, Census Tract 1105.08, Walton County, Georgia",1310,800,510,61.0687022901,38.9312977099
5309,1500000US132971106011,132971106011,"Block Group 1, Census Tract 1106.01, Walton County, Georgia",2057,1830,227,88.9645114244,11.0354885756
5310,1500000US132971106012,132971106012,"Block Group 2, Census Tract 1106.01, Walton County, Georgia",2580,2482,98,96.2015503876,3.7984496124
5311,1500000US132971106021,132971106021,"Block Group 1, Census Tract 1106.02, Walton County, Georgia",2745,2022,723,73.6612021858,26.3387978142
5312,1500000US132971106022,132971106022,"Block Group 2, Census Tract 1106.02, Walton County, Georgia",2580,2127,453,82.4418604651,17.5581395349
5313,1500000US132971106031,132971106031,"Block Group 1, Census Tract 1106.03, Walton County, Georgia",869,670,199,77.1001150748,22.8998849252
5314,1500000US132971106032,132971106032,"Block Group 2, Census Tract 1106.03, Walton County, Georgia",3683,2793,890,75.8349171871,24.1650828129
5315,1500000US132971107001,132971107001,"Block Group 1, Census Tract 1107, Walton County, Georgia",1804,829,975,45.9534368071,54.0465631929
5316,1500000US132971107002,132971107002,"Block Group 2, Census Tract 1107, Walton County, Georgia",2877,2271,606,78.9363920751,21.0636079249
5317,1500000US132971107003,132971107003,"Block Group 3, Census Tract 1107, Walton County, Georgia",1503,189,1314,12.5748502994,87.4251497006
5318,1500000US132971107004,132971107004,"Block Group 4, Census Tract 1107, Walton County, Georgia",907,506,401,55.7883131202,44.2116868798
5319,1500000US132971108001,132971108001,"Block Group 1, Census Tract 1108, Walton County, Georgia",1792,1284,508,71.6517857143,28.3482142857
5320,1500000US132971108002,132971108002,"Block Group 2, Census Tract 1108, Walton County, Georgia",1616,860,756,53.2178217822,46.7821782178
5321,1500000US132971108003,132971108003,"Block Group 3, Census Tract 1108, Walton County, Georgia",1753,1492,261,85.1112378779,14.8887621221
5322,1500000US132971108004,132971108004,"Block Group 4, Census Tract 1108, Walton County, Georgia",1723,1180,543,68.4852002322,31.5147997678
5323,1500000US132999501001,132999501001,"Block Group 1, Census Tract 9501, Ware County, Georgia",1616,1344,272,83.1683168317,16.8316831683
5324,1500000US132999502001,132999502001,"Block Group 1, Census Tract 9502, Ware County, Georgia",1303,866,437,66.4620107444,33.5379892556
5325,1500000US132999502002,132999502002,"Block Group 2, Census Tract 9502, Ware County, Georgia",1403,1037,366,73.9130434783,26.0869565217
5326,1500000US132999502003,132999502003,"Block Group 3, Census Tract 9502, Ware County, Georgia",1834,1218,616,66.4122137405,33.5877862595
5327,1500000US132999502004,132999502004,"Block Group 4, Census Tract 9502, Ware County, Georgia",980,857,123,87.4489795918,12.5510204082
5328,1500000US132999503001,132999503001,"Block Group 1, Census Tract 9503, Ware County, Georgia",750,464,286,61.8666666667,38.1333333333
5329,1500000US132999503002,132999503002,"Block Group 2, Census Tract 9503, Ware County, Georgia",834,480,354,57.5539568345,42.4460431655
5330,1500000US132999503003,132999503003,"Block Group 3, Census Tract 9503, Ware County, Georgia",343,262,81,76.3848396501,23.6151603499
5331,1500000US132999504001,132999504001,"Block Group 1, Census Tract 9504, Ware County, Georgia",481,111,370,23.0769230769,76.9230769231
5332,1500000US132999504002,132999504002,"Block Group 2, Census Tract 9504, Ware County, Georgia",545,228,317,41.8348623853,58.1651376147
5333,1500000US132999504003,132999504003,"Block Group 3, Census Tract 9504, Ware County, Georgia",742,338,404,45.5525606469,54.4474393531
5334,1500000US132999505001,132999505001,"Block Group 1, Census Tract 9505, Ware County, Georgia",1895,1475,420,77.8364116095,22.1635883905
5335,1500000US132999505002,132999505002,"Block Group 2, Census Tract 9505, Ware County, Georgia",919,662,257,72.034820457,27.965179543
5336,1500000US132999505003,132999505003,"Block Group 3, Census Tract 9505, Ware County, Georgia",974,508,466,52.1560574949,47.8439425051
5337,1500000US132999505004,132999505004,"Block Group 4, Census Tract 9505, Ware County, Georgia",739,472,267,63.8700947226,36.1299052774
5338,1500000US132999505005,132999505005,"Block Group 5, Census Tract 9505, Ware County, Georgia",798,544,254,68.1704260652,31.8295739348
5339,1500000US132999506001,132999506001,"Block Group 1, Census Tract 9506, Ware County, Georgia",1657,1201,456,72.4803862402,27.5196137598
5340,1500000US132999506002,132999506002,"Block Group 2, Census Tract 9506, Ware County, Georgia",1630,1232,398,75.5828220859,24.4171779141
5341,1500000US132999506003,132999506003,"Block Group 3, Census Tract 9506, Ware County, Georgia",1384,241,1143,17.4132947977,82.5867052023
5342,1500000US132999506004,132999506004,"Block Group 4, Census Tract 9506, Ware County, Georgia",659,363,296,55.0834597876,44.9165402124
5343,1500000US132999506005,132999506005,"Block Group 5, Census Tract 9506, Ware County, Georgia",748,432,316,57.7540106952,42.2459893048
5344,1500000US132999507001,132999507001,"Block Group 1, Census Tract 9507, Ware County, Georgia",407,285,122,70.0245700246,29.9754299754
5345,1500000US132999507002,132999507002,"Block Group 2, Census Tract 9507, Ware County, Georgia",800,322,478,40.25,59.75
5346,1500000US132999508001,132999508001,"Block Group 1, Census Tract 9508, Ware County, Georgia",711,335,376,47.1167369902,52.8832630098
5347,1500000US132999508002,132999508002,"Block Group 2, Census Tract 9508, Ware County, Georgia",1252,924,328,73.8019169329,26.1980830671
5348,1500000US132999508003,132999508003,"Block Group 3, Census Tract 9508, Ware County, Georgia",1234,232,1002,18.8006482982,81.1993517018
5349,1500000US132999508004,132999508004,"Block Group 4, Census Tract 9508, Ware County, Georgia",313,313,0,100.0,0.0
5350,1500000US132999508005,132999508005,"Block Group 5, Census Tract 9508, Ware County, Georgia",1418,926,492,65.3032440056,34.6967559944
5351,1500000US132999508006,132999508006,"Block Group 6, Census Tract 9508, Ware County, Georgia",683,442,241,64.7144948755,35.2855051245
5352,1500000US132999509001,132999509001,"Block Group 1, Census Tract 9509, Ware County, Georgia",1003,768,235,76.5702891326,23.4297108674
5353,1500000US132999509002,132999509002,"Block Group 2, Census Tract 9509, Ware County, Georgia",737,527,210,71.5061058345,28.4938941655
5354,1500000US132999509003,132999509003,"Block Group 3, Census Tract 9509, Ware County, Georgia",1379,1027,352,74.4742567078,25.5257432922
5355,1500000US132999509004,132999509004,"Block Group 4, Census Tract 9509, Ware County, Georgia",1106,729,377,65.9132007233,34.0867992767
5356,1500000US133019704001,133019704001,"Block Group 1, Census Tract 9704, Warren County, Georgia",877,376,501,42.8734321551,57.1265678449
5357,1500000US133019704002,133019704002,"Block Group 2, Census Tract 9704, Warren County, Georgia",1190,664,526,55.7983193277,44.2016806723
5358,1500000US133019704003,133019704003,"Block Group 3, Census Tract 9704, Warren County, Georgia",675,535,140,79.2592592593,20.7407407407
5359,1500000US133019705001,133019705001,"Block Group 1, Census Tract 9705, Warren County, Georgia",1235,909,326,73.6032388664,26.3967611336
5360,1500000US133019705002,133019705002,"Block Group 2, Census Tract 9705, Warren County, Georgia",776,538,238,69.3298969072,30.6701030928
5361,1500000US133019705003,133019705003,"Block Group 3, Census Tract 9705, Warren County, Georgia",720,602,118,83.6111111111,16.3888888889
5362,1500000US133039501001,133039501001,"Block Group 1, Census Tract 9501, Washington County, Georgia",860,682,178,79.3023255814,20.6976744186
5363,1500000US133039501002,133039501002,"Block Group 2, Census Tract 9501, Washington County, Georgia",879,744,135,84.6416382253,15.3583617747
5364,1500000US133039503001,133039503001,"Block Group 1, Census Tract 9503, Washington County, Georgia",1795,1064,731,59.2757660167,40.7242339833
5365,1500000US133039503002,133039503002,"Block Group 2, Census Tract 9503, Washington County, Georgia",1282,624,658,48.6739469579,51.3260530421
5366,1500000US133039503003,133039503003,"Block Group 3, Census Tract 9503, Washington County, Georgia",601,345,256,57.4043261231,42.5956738769
5367,1500000US133039503004,133039503004,"Block Group 4, Census Tract 9503, Washington County, Georgia",550,389,161,70.7272727273,29.2727272727
5368,1500000US133039504001,133039504001,"Block Group 1, Census Tract 9504, Washington County, Georgia",1808,1665,143,92.0907079646,7.9092920354
5369,1500000US133039504002,133039504002,"Block Group 2, Census Tract 9504, Washington County, Georgia",973,762,211,78.3144912641,21.6855087359
5370,1500000US133039504003,133039504003,"Block Group 3, Census Tract 9504, Washington County, Georgia",820,191,629,23.2926829268,76.7073170732
5371,1500000US133039504004,133039504004,"Block Group 4, Census Tract 9504, Washington County, Georgia",1513,1220,293,80.6345009914,19.3654990086
5372,1500000US133039505001,133039505001,"Block Group 1, Census Tract 9505, Washington County, Georgia",1000,686,314,68.6,31.4
5373,1500000US133039505002,133039505002,"Block Group 2, Census Tract 9505, Washington County, Georgia",1359,1064,295,78.2928623988,21.7071376012
5374,1500000US133039505003,133039505003,"Block Group 3, Census Tract 9505, Washington County, Georgia",1573,1231,342,78.2581055308,21.7418944692
5375,1500000US133039507001,133039507001,"Block Group 1, Census Tract 9507, Washington County, Georgia",1695,1253,442,73.9233038348,26.0766961652
5376,1500000US133039507002,133039507002,"Block Group 2, Census Tract 9507, Washington County, Georgia",947,427,520,45.0897571278,54.9102428722
5377,1500000US133039507003,133039507003,"Block Group 3, Census Tract 9507, Washington County, Georgia",1461,851,610,58.2477754962,41.7522245038
5378,1500000US133059701001,133059701001,"Block Group 1, Census Tract 9701, Wayne County, Georgia",1044,914,130,87.5478927203,12.4521072797
5379,1500000US133059701002,133059701002,"Block Group 2, Census Tract 9701, Wayne County, Georgia",823,801,22,97.3268529769,2.67314702309
5380,1500000US133059701003,133059701003,"Block Group 3, Census Tract 9701, Wayne County, Georgia",1009,959,50,95.0445986125,4.95540138751
5381,1500000US133059701004,133059701004,"Block Group 4, Census Tract 9701, Wayne County, Georgia",1134,877,257,77.3368606702,22.6631393298
5382,1500000US133059702001,133059702001,"Block Group 1, Census Tract 9702, Wayne County, Georgia",2671,1899,772,71.0969674279,28.9030325721
5383,1500000US133059702002,133059702002,"Block Group 2, Census Tract 9702, Wayne County, Georgia",2847,2206,641,77.4850720056,22.5149279944
5384,1500000US133059702003,133059702003,"Block Group 3, Census Tract 9702, Wayne County, Georgia",942,679,263,72.0806794055,27.9193205945
5385,1500000US133059702004,133059702004,"Block Group 4, Census Tract 9702, Wayne County, Georgia",890,547,343,61.4606741573,38.5393258427
5386,1500000US133059702005,133059702005,"Block Group 5, Census Tract 9702, Wayne County, Georgia",401,318,83,79.3017456359,20.6982543641
5387,1500000US133059703001,133059703001,"Block Group 1, Census Tract 9703, Wayne County, Georgia",1224,641,583,52.3692810458,47.6307189542
5388,1500000US133059703002,133059703002,"Block Group 2, Census Tract 9703, Wayne County, Georgia",1490,837,653,56.1744966443,43.8255033557
5389,1500000US133059703003,133059703003,"Block Group 3, Census Tract 9703, Wayne County, Georgia",1518,484,1034,31.884057971,68.115942029
5390,1500000US133059703004,133059703004,"Block Group 4, Census Tract 9703, Wayne County, Georgia",649,366,283,56.3944530046,43.6055469954
5391,1500000US133059704001,133059704001,"Block Group 1, Census Tract 9704, Wayne County, Georgia",1840,1510,330,82.0652173913,17.9347826087
5392,1500000US133059704002,133059704002,"Block Group 2, Census Tract 9704, Wayne County, Georgia",1128,895,233,79.3439716312,20.6560283688
5393,1500000US133059704003,133059704003,"Block Group 3, Census Tract 9704, Wayne County, Georgia",706,377,329,53.3994334278,46.6005665722
5394,1500000US133059705001,133059705001,"Block Group 1, Census Tract 9705, Wayne County, Georgia",1065,731,334,68.6384976526,31.3615023474
5395,1500000US133059705002,133059705002,"Block Group 2, Census Tract 9705, Wayne County, Georgia",972,434,538,44.6502057613,55.3497942387
5396,1500000US133059705003,133059705003,"Block Group 3, Census Tract 9705, Wayne County, Georgia",881,513,368,58.2292849035,41.7707150965
5397,1500000US133059705004,133059705004,"Block Group 4, Census Tract 9705, Wayne County, Georgia",757,453,304,59.8414795244,40.1585204756
5398,1500000US133059706001,133059706001,"Block Group 1, Census Tract 9706, Wayne County, Georgia",1910,1218,692,63.7696335079,36.2303664921
5399,1500000US133059706002,133059706002,"Block Group 2, Census Tract 9706, Wayne County, Georgia",909,758,151,83.3883388339,16.6116611661
5400,1500000US133059706003,133059706003,"Block Group 3, Census Tract 9706, Wayne County, Georgia",1085,872,213,80.3686635945,19.6313364055
5401,1500000US133079601001,133079601001,"Block Group 1, Census Tract 9601, Webster County, Georgia",1420,1257,163,88.5211267606,11.4788732394
5402,1500000US133079602001,133079602001,"Block Group 1, Census Tract 9602, Webster County, Georgia",1295,1092,203,84.3243243243,15.6756756757
5403,1500000US133097801001,133097801001,"Block Group 1, Census Tract 7801, Wheeler County, Georgia",644,291,353,45.1863354037,54.8136645963
5404,1500000US133097801002,133097801002,"Block Group 2, Census Tract 7801, Wheeler County, Georgia",527,230,297,43.6432637571,56.3567362429
5405,1500000US133097801003,133097801003,"Block Group 3, Census Tract 7801, Wheeler County, Georgia",916,743,173,81.1135371179,18.8864628821
5406,1500000US133097802001,133097802001,"Block Group 1, Census Tract 7802, Wheeler County, Georgia",513,305,208,59.4541910331,40.5458089669
5407,1500000US133097802002,133097802002,"Block Group 2, Census Tract 7802, Wheeler County, Georgia",1207,1019,188,84.4241922121,15.5758077879
5408,1500000US133097802003,133097802003,"Block Group 3, Census Tract 7802, Wheeler County, Georgia",542,340,202,62.7306273063,37.2693726937
5409,1500000US133119501001,133119501001,"Block Group 1, Census Tract 9501, White County, Georgia",1460,1053,407,72.1232876712,27.8767123288
5410,1500000US133119501002,133119501002,"Block Group 2, Census Tract 9501, White County, Georgia",1272,938,334,73.7421383648,26.2578616352
5411,1500000US133119502011,133119502011,"Block Group 1, Census Tract 9502.01, White County, Georgia",2050,1574,476,76.7804878049,23.2195121951
5412,1500000US133119502012,133119502012,"Block Group 2, Census Tract 9502.01, White County, Georgia",2963,1797,1166,60.6479919001,39.3520080999
5413,1500000US133119502013,133119502013,"Block Group 3, Census Tract 9502.01, White County, Georgia",3594,2327,1267,64.7468002226,35.2531997774
5414,1500000US133119502021,133119502021,"Block Group 1, Census Tract 9502.02, White County, Georgia",1343,1133,210,84.3633655994,15.6366344006
5415,1500000US133119502022,133119502022,"Block Group 2, Census Tract 9502.02, White County, Georgia",1794,1573,221,87.6811594203,12.3188405797
5416,1500000US133119502031,133119502031,"Block Group 1, Census Tract 9502.03, White County, Georgia",2854,2282,572,79.9579537491,20.0420462509
5417,1500000US133119502032,133119502032,"Block Group 2, Census Tract 9502.03, White County, Georgia",2398,2151,247,89.6997497915,10.3002502085
5418,1500000US133119503001,133119503001,"Block Group 1, Census Tract 9503, White County, Georgia",796,425,371,53.391959799,46.608040201
5419,1500000US133119503002,133119503002,"Block Group 2, Census Tract 9503, White County, Georgia",4132,2906,1226,70.3291384318,29.6708615682
5420,1500000US133119503003,133119503003,"Block Group 3, Census Tract 9503, White County, Georgia",2714,1880,834,69.270449521,30.729550479
5421,1500000US133130001011,133130001011,"Block Group 1, Census Tract 1.01, Whitfield County, Georgia",1196,868,328,72.5752508361,27.4247491639
5422,1500000US133130001012,133130001012,"Block Group 2, Census Tract 1.01, Whitfield County, Georgia",1648,1494,154,90.6553398058,9.34466019417
5423,1500000US133130001013,133130001013,"Block Group 3, Census Tract 1.01, Whitfield County, Georgia",1133,987,146,87.1138570168,12.8861429832
5424,1500000US133130001021,133130001021,"Block Group 1, Census Tract 1.02, Whitfield County, Georgia",1089,700,389,64.2791551882,35.7208448118
5425,1500000US133130001022,133130001022,"Block Group 2, Census Tract 1.02, Whitfield County, Georgia",3451,2708,743,78.4700086931,21.5299913069
5426,1500000US133130001023,133130001023,"Block Group 3, Census Tract 1.02, Whitfield County, Georgia",1514,930,584,61.4266842801,38.5733157199
5427,1500000US133130001024,133130001024,"Block Group 4, Census Tract 1.02, Whitfield County, Georgia",2298,1387,911,60.3568320279,39.6431679721
5428,1500000US133130002001,133130002001,"Block Group 1, Census Tract 2, Whitfield County, Georgia",1916,1222,694,63.7787056367,36.2212943633
5429,1500000US133130002002,133130002002,"Block Group 2, Census Tract 2, Whitfield County, Georgia",965,790,175,81.8652849741,18.1347150259
5430,1500000US133130002003,133130002003,"Block Group 3, Census Tract 2, Whitfield County, Georgia",1052,806,246,76.6159695817,23.3840304183
5431,1500000US133130003011,133130003011,"Block Group 1, Census Tract 3.01, Whitfield County, Georgia",434,286,148,65.8986175115,34.1013824885
5432,1500000US133130003012,133130003012,"Block Group 2, Census Tract 3.01, Whitfield County, Georgia",1094,551,543,50.365630713,49.634369287
5433,1500000US133130003013,133130003013,"Block Group 3, Census Tract 3.01, Whitfield County, Georgia",2751,1911,840,69.465648855,30.534351145
5434,1500000US133130003021,133130003021,"Block Group 1, Census Tract 3.02, Whitfield County, Georgia",1226,1215,11,99.1027732463,0.89722675367
5435,1500000US133130003022,133130003022,"Block Group 2, Census Tract 3.02, Whitfield County, Georgia",3603,2333,1270,64.7515958923,35.2484041077
5436,1500000US133130003023,133130003023,"Block Group 3, Census Tract 3.02, Whitfield County, Georgia",1819,1134,685,62.3419461242,37.6580538758
5437,1500000US133130003024,133130003024,"Block Group 4, Census Tract 3.02, Whitfield County, Georgia",2603,2306,297,88.5900883596,11.4099116404
5438,1500000US133130004001,133130004001,"Block Group 1, Census Tract 4, Whitfield County, Georgia",905,483,422,53.3701657459,46.6298342541
5439,1500000US133130004002,133130004002,"Block Group 2, Census Tract 4, Whitfield County, Georgia",1089,431,658,39.577594123,60.422405877
5440,1500000US133130004003,133130004003,"Block Group 3, Census Tract 4, Whitfield County, Georgia",1180,951,229,80.593220339,19.406779661
5441,1500000US133130004004,133130004004,"Block Group 4, Census Tract 4, Whitfield County, Georgia",2536,1770,766,69.7949526814,30.2050473186
5442,1500000US133130004005,133130004005,"Block Group 5, Census Tract 4, Whitfield County, Georgia",1590,781,809,49.1194968553,50.8805031447
5443,1500000US133130004006,133130004006,"Block Group 6, Census Tract 4, Whitfield County, Georgia",511,186,325,36.3992172211,63.6007827789
5444,1500000US133130005011,133130005011,"Block Group 1, Census Tract 5.01, Whitfield County, Georgia",965,928,37,96.1658031088,3.83419689119
5445,1500000US133130005012,133130005012,"Block Group 2, Census Tract 5.01, Whitfield County, Georgia",2279,1562,717,68.5388328214,31.4611671786
5446,1500000US133130005013,133130005013,"Block Group 3, Census Tract 5.01, Whitfield County, Georgia",974,760,214,78.0287474333,21.9712525667
5447,1500000US133130005021,133130005021,"Block Group 1, Census Tract 5.02, Whitfield County, Georgia",1648,288,1360,17.4757281553,82.5242718447
5448,1500000US133130005022,133130005022,"Block Group 2, Census Tract 5.02, Whitfield County, Georgia",630,202,428,32.0634920635,67.9365079365
5449,1500000US133130005023,133130005023,"Block Group 3, Census Tract 5.02, Whitfield County, Georgia",1736,512,1224,29.4930875576,70.5069124424
5450,1500000US133130005024,133130005024,"Block Group 4, Census Tract 5.02, Whitfield County, Georgia",1975,144,1831,7.29113924051,92.7088607595
5451,1500000US133130006001,133130006001,"Block Group 1, Census Tract 6, Whitfield County, Georgia",2108,1601,507,75.9487666034,24.0512333966
5452,1500000US133130006002,133130006002,"Block Group 2, Census Tract 6, Whitfield County, Georgia",1278,723,555,56.5727699531,43.4272300469
5453,1500000US133130006003,133130006003,"Block Group 3, Census Tract 6, Whitfield County, Georgia",868,756,112,87.0967741935,12.9032258065
5454,1500000US133130007001,133130007001,"Block Group 1, Census Tract 7, Whitfield County, Georgia",1143,934,209,81.7147856518,18.2852143482
5455,1500000US133130007002,133130007002,"Block Group 2, Census Tract 7, Whitfield County, Georgia",1418,1128,290,79.5486600846,20.4513399154
5456,1500000US133130007003,133130007003,"Block Group 3, Census Tract 7, Whitfield County, Georgia",1171,905,266,77.2843723313,22.7156276687
5457,1500000US133130007004,133130007004,"Block Group 4, Census Tract 7, Whitfield County, Georgia",1030,470,560,45.6310679612,54.3689320388
5458,1500000US133130008001,133130008001,"Block Group 1, Census Tract 8, Whitfield County, Georgia",2899,1291,1608,44.5325974474,55.4674025526
5459,1500000US133130008002,133130008002,"Block Group 2, Census Tract 8, Whitfield County, Georgia",1418,1088,330,76.7277856135,23.2722143865
5460,1500000US133130008003,133130008003,"Block Group 3, Census Tract 8, Whitfield County, Georgia",717,589,128,82.1478382148,17.8521617852
5461,1500000US133130008004,133130008004,"Block Group 4, Census Tract 8, Whitfield County, Georgia",1151,995,156,86.4465682016,13.5534317984
5462,1500000US133130008005,133130008005,"Block Group 5, Census Tract 8, Whitfield County, Georgia",1598,1319,279,82.5406758448,17.4593241552
5463,1500000US133130009001,133130009001,"Block Group 1, Census Tract 9, Whitfield County, Georgia",486,331,155,68.1069958848,31.8930041152
5464,1500000US133130009002,133130009002,"Block Group 2, Census Tract 9, Whitfield County, Georgia",1595,1158,437,72.6018808777,27.3981191223
5465,1500000US133130009003,133130009003,"Block Group 3, Census Tract 9, Whitfield County, Georgia",1627,1069,558,65.7037492317,34.2962507683
5466,1500000US133130010001,133130010001,"Block Group 1, Census Tract 10, Whitfield County, Georgia",1944,1191,753,61.2654320988,38.7345679012
5467,1500000US133130010002,133130010002,"Block Group 2, Census Tract 10, Whitfield County, Georgia",1509,543,966,35.9840954274,64.0159045726
5468,1500000US133130010003,133130010003,"Block Group 3, Census Tract 10, Whitfield County, Georgia",1031,398,633,38.6032977692,61.3967022308
5469,1500000US133130011001,133130011001,"Block Group 1, Census Tract 11, Whitfield County, Georgia",592,312,280,52.7027027027,47.2972972973
5470,1500000US133130011002,133130011002,"Block Group 2, Census Tract 11, Whitfield County, Georgia",1494,1324,170,88.6211512718,11.3788487282
5471,1500000US133130011003,133130011003,"Block Group 3, Census Tract 11, Whitfield County, Georgia",1104,636,468,57.6086956522,42.3913043478
5472,1500000US133130011004,133130011004,"Block Group 4, Census Tract 11, Whitfield County, Georgia",1838,1332,506,72.4700761697,27.5299238303
5473,1500000US133130012001,133130012001,"Block Group 1, Census Tract 12, Whitfield County, Georgia",1517,1217,300,80.2241265656,19.7758734344
5474,1500000US133130012002,133130012002,"Block Group 2, Census Tract 12, Whitfield County, Georgia",1453,672,781,46.2491397109,53.7508602891
5475,1500000US133130012003,133130012003,"Block Group 3, Census Tract 12, Whitfield County, Georgia",1620,1098,522,67.7777777778,32.2222222222
5476,1500000US133130012004,133130012004,"Block Group 4, Census Tract 12, Whitfield County, Georgia",1387,624,763,44.989185292,55.010814708
5477,1500000US133130012005,133130012005,"Block Group 5, Census Tract 12, Whitfield County, Georgia",1079,467,612,43.28081557,56.71918443
5478,1500000US133130012006,133130012006,"Block Group 6, Census Tract 12, Whitfield County, Georgia",747,354,393,47.3895582329,52.6104417671
5479,1500000US133130013001,133130013001,"Block Group 1, Census Tract 13, Whitfield County, Georgia",2213,737,1476,33.3032083145,66.6967916855
5480,1500000US133130013002,133130013002,"Block Group 2, Census Tract 13, Whitfield County, Georgia",499,208,291,41.6833667335,58.3166332665
5481,1500000US133130013003,133130013003,"Block Group 3, Census Tract 13, Whitfield County, Georgia",1679,196,1483,11.6736152472,88.3263847528
5482,1500000US133130014001,133130014001,"Block Group 1, Census Tract 14, Whitfield County, Georgia",1231,889,342,72.2177091795,27.7822908205
5483,1500000US133130014002,133130014002,"Block Group 2, Census Tract 14, Whitfield County, Georgia",1979,1778,201,89.8433552299,10.1566447701
5484,1500000US133130014003,133130014003,"Block Group 3, Census Tract 14, Whitfield County, Georgia",1389,832,557,59.8992080634,40.1007919366
5485,1500000US133130014004,133130014004,"Block Group 4, Census Tract 14, Whitfield County, Georgia",534,343,191,64.2322097378,35.7677902622
5486,1500000US133130014005,133130014005,"Block Group 5, Census Tract 14, Whitfield County, Georgia",1527,1353,174,88.605108055,11.394891945
5487,1500000US133130015001,133130015001,"Block Group 1, Census Tract 15, Whitfield County, Georgia",1013,786,227,77.5913129319,22.4086870681
5488,1500000US133130015002,133130015002,"Block Group 2, Census Tract 15, Whitfield County, Georgia",814,581,233,71.3759213759,28.6240786241
5489,1500000US133130015003,133130015003,"Block Group 3, Census Tract 15, Whitfield County, Georgia",896,644,252,71.875,28.125
5490,1500000US133130015004,133130015004,"Block Group 4, Census Tract 15, Whitfield County, Georgia",1068,955,113,89.4194756554,10.5805243446
5491,1500000US133130015005,133130015005,"Block Group 5, Census Tract 15, Whitfield County, Georgia",1843,1574,269,85.4042322301,14.5957677699
5492,1500000US133159601001,133159601001,"Block Group 1, Census Tract 9601, Wilcox County, Georgia",1203,623,580,51.78719867,48.21280133
5493,1500000US133159601002,133159601002,"Block Group 2, Census Tract 9601, Wilcox County, Georgia",854,748,106,87.5878220141,12.4121779859
5494,1500000US133159602001,133159602001,"Block Group 1, Census Tract 9602, Wilcox County, Georgia",1360,996,364,73.2352941176,26.7647058824
5495,1500000US133159603001,133159603001,"Block Group 1, Census Tract 9603, Wilcox County, Georgia",1431,1076,355,75.1921733054,24.8078266946
5496,1500000US133159604001,133159604001,"Block Group 1, Census Tract 9604, Wilcox County, Georgia",1397,1005,392,71.9398711525,28.0601288475
5497,1500000US133159604002,133159604002,"Block Group 2, Census Tract 9604, Wilcox County, Georgia",678,521,157,76.8436578171,23.1563421829
5498,1500000US133170101011,133170101011,"Block Group 1, Census Tract 101.01, Wilkes County, Georgia",795,602,193,75.7232704403,24.2767295597
5499,1500000US133170101012,133170101012,"Block Group 2, Census Tract 101.01, Wilkes County, Georgia",778,659,119,84.7043701799,15.2956298201
5500,1500000US133170101021,133170101021,"Block Group 1, Census Tract 101.02, Wilkes County, Georgia",763,439,324,57.5360419397,42.4639580603
5501,1500000US133170101022,133170101022,"Block Group 2, Census Tract 101.02, Wilkes County, Georgia",820,545,275,66.4634146341,33.5365853659
5502,1500000US133170103011,133170103011,"Block Group 1, Census Tract 103.01, Wilkes County, Georgia",1228,951,277,77.4429967427,22.5570032573
5503,1500000US133170103012,133170103012,"Block Group 2, Census Tract 103.01, Wilkes County, Georgia",1065,852,213,80.0,20.0
5504,1500000US133170103021,133170103021,"Block Group 1, Census Tract 103.02, Wilkes County, Georgia",1533,899,634,58.6431833007,41.3568166993
5505,1500000US133170103022,133170103022,"Block Group 2, Census Tract 103.02, Wilkes County, Georgia",791,627,164,79.2667509482,20.7332490518
5506,1500000US133170103023,133170103023,"Block Group 3, Census Tract 103.02, Wilkes County, Georgia",503,427,76,84.8906560636,15.1093439364
5507,1500000US133170103024,133170103024,"Block Group 4, Census Tract 103.02, Wilkes County, Georgia",775,387,388,49.935483871,50.064516129
5508,1500000US133170103025,133170103025,"Block Group 5, Census Tract 103.02, Wilkes County, Georgia",762,436,326,57.217847769,42.782152231
5509,1500000US133199602001,133199602001,"Block Group 1, Census Tract 9602, Wilkinson County, Georgia",1392,1095,297,78.6637931034,21.3362068966
5510,1500000US133199602002,133199602002,"Block Group 2, Census Tract 9602, Wilkinson County, Georgia",1055,791,264,74.9763033175,25.0236966825
5511,1500000US133199602003,133199602003,"Block Group 3, Census Tract 9602, Wilkinson County, Georgia",701,527,174,75.1783166904,24.8216833096
5512,1500000US133199603001,133199603001,"Block Group 1, Census Tract 9603, Wilkinson County, Georgia",662,498,164,75.2265861027,24.7734138973
5513,1500000US133199603002,133199603002,"Block Group 2, Census Tract 9603, Wilkinson County, Georgia",1147,852,295,74.2807323452,25.7192676548
5514,1500000US133199603003,133199603003,"Block Group 3, Census Tract 9603, Wilkinson County, Georgia",1386,757,629,54.6176046176,45.3823953824
5515,1500000US133199603004,133199603004,"Block Group 4, Census Tract 9603, Wilkinson County, Georgia",1324,1159,165,87.5377643505,12.4622356495
5516,1500000US133199604001,133199604001,"Block Group 1, Census Tract 9604, Wilkinson County, Georgia",1065,979,86,91.9248826291,8.07511737089
5517,1500000US133199604002,133199604002,"Block Group 2, Census Tract 9604, Wilkinson County, Georgia",542,414,128,76.3837638376,23.6162361624
5518,1500000US133219501001,133219501001,"Block Group 1, Census Tract 9501, Worth County, Georgia",822,635,187,77.2506082725,22.7493917275
5519,1500000US133219501002,133219501002,"Block Group 2, Census Tract 9501, Worth County, Georgia",2006,1538,468,76.6699900299,23.3300099701
5520,1500000US133219502001,133219502001,"Block Group 1, Census Tract 9502, Worth County, Georgia",1693,1426,267,84.2291789722,15.7708210278
5521,1500000US133219502002,133219502002,"Block Group 2, Census Tract 9502, Worth County, Georgia",2592,2391,201,92.2453703704,7.75462962963
5522,1500000US133219502003,133219502003,"Block Group 3, Census Tract 9502, Worth County, Georgia",1304,813,491,62.3466257669,37.6533742331
5523,1500000US133219502004,133219502004,"Block Group 4, Census Tract 9502, Worth County, Georgia",1473,959,514,65.105227427,34.894772573
5524,1500000US133219504001,133219504001,"Block Group 1, Census Tract 9504, Worth County, Georgia",1905,1272,633,66.7716535433,33.2283464567
5525,1500000US133219504002,133219504002,"Block Group 2, Census Tract 9504, Worth County, Georgia",651,422,229,64.8233486943,35.1766513057
5526,1500000US133219504003,133219504003,"Block Group 3, Census Tract 9504, Worth County, Georgia",1012,904,108,89.3280632411,10.6719367589
5527,1500000US133219504004,133219504004,"Block Group 4, Census Tract 9504, Worth County, Georgia",1253,1069,184,85.3152434158,14.6847565842
5528,1500000US133219505001,133219505001,"Block Group 1, Census Tract 9505, Worth County, Georgia",1601,1149,452,71.7676452217,28.2323547783
5529,1500000US133219505002,133219505002,"Block Group 2, Census Tract 9505, Worth County, Georgia",1134,686,448,60.4938271605,39.5061728395
5530,1500000US133219505003,133219505003,"Block Group 3, Census Tract 9505, Worth County, Georgia",1396,548,848,39.2550143266,60.7449856734
5531,1500000US133219506001,133219506001,"Block Group 1, Census Tract 9506, Worth County, Georgia",1295,1008,287,77.8378378378,22.1621621622
5532,1500000US133219506002,133219506002,"Block Group 2, Census Tract 9506, Worth County, Georgia",860,544,316,63.2558139535,36.7441860465
