,ID,ID2,GEOGRAPHY,EST_T,EST_T_NOT_HISPANIC_OR_LATINO,EST_T_HISPANIC_OR_LATINO,PCT_Latino
0,1500000US130019501001,130019501001,"Block Group 1, Census Tract 9501, Appling County, Georgia",912,912,0,0.0
1,1500000US130019501002,130019501002,"Block Group 2, Census Tract 9501, Appling County, Georgia",2498,2498,0,0.0
2,1500000US130019502001,130019502001,"Block Group 1, Census Tract 9502, Appling County, Georgia",2036,1722,314,15.4223968566
3,1500000US130019502002,130019502002,"Block Group 2, Census Tract 9502, Appling County, Georgia",1593,1371,222,13.9359698682
4,1500000US130019502003,130019502003,"Block Group 3, Census Tract 9502, Appling County, Georgia",1036,1036,0,0.0
5,1500000US130019503001,130019503001,"Block Group 1, Census Tract 9503, Appling County, Georgia",708,708,0,0.0
6,1500000US130019503002,130019503002,"Block Group 2, Census Tract 9503, Appling County, Georgia",1585,1338,247,15.5835962145
7,1500000US130019503003,130019503003,"Block Group 3, Census Tract 9503, Appling County, Georgia",1085,1034,51,4.70046082949
8,1500000US130019503004,130019503004,"Block Group 4, Census Tract 9503, Appling County, Georgia",1493,1204,289,19.3569993302
9,1500000US130019504001,130019504001,"Block Group 1, Census Tract 9504, Appling County, Georgia",755,741,14,1.85430463576
10,1500000US130019504002,130019504002,"Block Group 2, Census Tract 9504, Appling County, Georgia",698,685,13,1.86246418338
11,1500000US130019505001,130019505001,"Block Group 1, Census Tract 9505, Appling County, Georgia",695,695,0,0.0
12,1500000US130019505002,130019505002,"Block Group 2, Census Tract 9505, Appling County, Georgia",1678,1634,44,2.62216924911
13,1500000US130019505003,130019505003,"Block Group 3, Census Tract 9505, Appling County, Georgia",1645,1116,529,32.1580547112
14,1500000US130039601001,130039601001,"Block Group 1, Census Tract 9601, Atkinson County, Georgia",1031,827,204,19.786614937
15,1500000US130039601002,130039601002,"Block Group 2, Census Tract 9601, Atkinson County, Georgia",1054,717,337,31.9734345351
16,1500000US130039602001,130039602001,"Block Group 1, Census Tract 9602, Atkinson County, Georgia",2046,1387,659,32.2091886608
17,1500000US130039602002,130039602002,"Block Group 2, Census Tract 9602, Atkinson County, Georgia",1072,740,332,30.9701492537
18,1500000US130039602003,130039602003,"Block Group 3, Census Tract 9602, Atkinson County, Georgia",1784,1448,336,18.8340807175
19,1500000US130039603001,130039603001,"Block Group 1, Census Tract 9603, Atkinson County, Georgia",1307,1165,142,10.8645753634
20,1500000US130059701001,130059701001,"Block Group 1, Census Tract 9701, Bacon County, Georgia",1527,1257,270,17.6817288802
21,1500000US130059701002,130059701002,"Block Group 2, Census Tract 9701, Bacon County, Georgia",820,795,25,3.0487804878
22,1500000US130059701003,130059701003,"Block Group 3, Census Tract 9701, Bacon County, Georgia",741,741,0,0.0
23,1500000US130059702011,130059702011,"Block Group 1, Census Tract 9702.01, Bacon County, Georgia",1562,1498,64,4.09731113956
24,1500000US130059702012,130059702012,"Block Group 2, Census Tract 9702.01, Bacon County, Georgia",1161,828,333,28.6821705426
25,1500000US130059702013,130059702013,"Block Group 3, Census Tract 9702.01, Bacon County, Georgia",1287,1287,0,0.0
26,1500000US130059702021,130059702021,"Block Group 1, Census Tract 9702.02, Bacon County, Georgia",2324,2163,161,6.92771084337
27,1500000US130059702022,130059702022,"Block Group 2, Census Tract 9702.02, Bacon County, Georgia",1251,1225,26,2.07833733014
28,1500000US130059702023,130059702023,"Block Group 3, Census Tract 9702.02, Bacon County, Georgia",549,549,0,0.0
29,1500000US130079601001,130079601001,"Block Group 1, Census Tract 9601, Baker County, Georgia",815,811,4,0.490797546012
30,1500000US130079601002,130079601002,"Block Group 2, Census Tract 9601, Baker County, Georgia",1394,1356,38,2.72596843615
31,1500000US130079602001,130079602001,"Block Group 1, Census Tract 9602, Baker County, Georgia",468,446,22,4.70085470085
32,1500000US130079602002,130079602002,"Block Group 2, Census Tract 9602, Baker County, Georgia",615,615,0,0.0
33,1500000US130099701001,130099701001,"Block Group 1, Census Tract 9701, Baldwin County, Georgia",1461,1461,0,0.0
34,1500000US130099701002,130099701002,"Block Group 2, Census Tract 9701, Baldwin County, Georgia",1264,1264,0,0.0
35,1500000US130099701003,130099701003,"Block Group 3, Census Tract 9701, Baldwin County, Georgia",2489,2366,123,4.94174367216
36,1500000US130099702001,130099702001,"Block Group 1, Census Tract 9702, Baldwin County, Georgia",1025,855,170,16.5853658537
37,1500000US130099702002,130099702002,"Block Group 2, Census Tract 9702, Baldwin County, Georgia",2291,2267,24,1.04757747708
38,1500000US130099702003,130099702003,"Block Group 3, Census Tract 9702, Baldwin County, Georgia",2092,2073,19,0.908221797323
39,1500000US130099702004,130099702004,"Block Group 4, Census Tract 9702, Baldwin County, Georgia",313,313,0,0.0
40,1500000US130099702005,130099702005,"Block Group 5, Census Tract 9702, Baldwin County, Georgia",803,778,25,3.11332503113
41,1500000US130099703001,130099703001,"Block Group 1, Census Tract 9703, Baldwin County, Georgia",2826,2757,69,2.44161358811
42,1500000US130099703002,130099703002,"Block Group 2, Census Tract 9703, Baldwin County, Georgia",3535,3391,144,4.07355021216
43,1500000US130099704001,130099704001,"Block Group 1, Census Tract 9704, Baldwin County, Georgia",1106,1043,63,5.69620253165
44,1500000US130099704002,130099704002,"Block Group 2, Census Tract 9704, Baldwin County, Georgia",1177,1165,12,1.01954120646
45,1500000US130099704003,130099704003,"Block Group 3, Census Tract 9704, Baldwin County, Georgia",1003,981,22,2.19341974078
46,1500000US130099704004,130099704004,"Block Group 4, Census Tract 9704, Baldwin County, Georgia",241,241,0,0.0
47,1500000US130099704005,130099704005,"Block Group 5, Census Tract 9704, Baldwin County, Georgia",1399,1383,16,1.14367405289
48,1500000US130099705001,130099705001,"Block Group 1, Census Tract 9705, Baldwin County, Georgia",3454,3277,177,5.12449334105
49,1500000US130099705002,130099705002,"Block Group 2, Census Tract 9705, Baldwin County, Georgia",544,544,0,0.0
50,1500000US130099705003,130099705003,"Block Group 3, Census Tract 9705, Baldwin County, Georgia",2393,2393,0,0.0
51,1500000US130099706001,130099706001,"Block Group 1, Census Tract 9706, Baldwin County, Georgia",1214,1214,0,0.0
52,1500000US130099706002,130099706002,"Block Group 2, Census Tract 9706, Baldwin County, Georgia",857,857,0,0.0
53,1500000US130099706003,130099706003,"Block Group 3, Census Tract 9706, Baldwin County, Georgia",694,694,0,0.0
54,1500000US130099706004,130099706004,"Block Group 4, Census Tract 9706, Baldwin County, Georgia",886,886,0,0.0
55,1500000US130099707011,130099707011,"Block Group 1, Census Tract 9707.01, Baldwin County, Georgia",823,823,0,0.0
56,1500000US130099707012,130099707012,"Block Group 2, Census Tract 9707.01, Baldwin County, Georgia",440,440,0,0.0
57,1500000US130099707013,130099707013,"Block Group 3, Census Tract 9707.01, Baldwin County, Georgia",1722,1722,0,0.0
58,1500000US130099707021,130099707021,"Block Group 1, Census Tract 9707.02, Baldwin County, Georgia",1189,1186,3,0.252312867956
59,1500000US130099707022,130099707022,"Block Group 2, Census Tract 9707.02, Baldwin County, Georgia",1136,1110,26,2.28873239437
60,1500000US130099708001,130099708001,"Block Group 1, Census Tract 9708, Baldwin County, Georgia",1792,1725,67,3.73883928571
61,1500000US130099708002,130099708002,"Block Group 2, Census Tract 9708, Baldwin County, Georgia",3044,3044,0,0.0
62,1500000US130099708003,130099708003,"Block Group 3, Census Tract 9708, Baldwin County, Georgia",1257,1245,12,0.954653937947
63,1500000US130099708004,130099708004,"Block Group 4, Census Tract 9708, Baldwin County, Georgia",1325,1325,0,0.0
64,1500000US130119701001,130119701001,"Block Group 1, Census Tract 9701, Banks County, Georgia",2360,2002,358,15.1694915254
65,1500000US130119701002,130119701002,"Block Group 2, Census Tract 9701, Banks County, Georgia",2909,2694,215,7.39085596425
66,1500000US130119702001,130119702001,"Block Group 1, Census Tract 9702, Banks County, Georgia",2555,2478,77,3.01369863014
67,1500000US130119702002,130119702002,"Block Group 2, Census Tract 9702, Banks County, Georgia",2458,2436,22,0.895036615134
68,1500000US130119703001,130119703001,"Block Group 1, Census Tract 9703, Banks County, Georgia",1475,1453,22,1.49152542373
69,1500000US130119703002,130119703002,"Block Group 2, Census Tract 9703, Banks County, Georgia",2691,2691,0,0.0
70,1500000US130119704001,130119704001,"Block Group 1, Census Tract 9704, Banks County, Georgia",3888,3424,464,11.9341563786
71,1500000US130131801031,130131801031,"Block Group 1, Census Tract 1801.03, Barrow County, Georgia",4674,4428,246,5.26315789474
72,1500000US130131801041,130131801041,"Block Group 1, Census Tract 1801.04, Barrow County, Georgia",1976,1791,185,9.36234817814
73,1500000US130131801051,130131801051,"Block Group 1, Census Tract 1801.05, Barrow County, Georgia",2802,2570,232,8.27980014276
74,1500000US130131801061,130131801061,"Block Group 1, Census Tract 1801.06, Barrow County, Georgia",1946,1740,206,10.5858170606
75,1500000US130131801062,130131801062,"Block Group 2, Census Tract 1801.06, Barrow County, Georgia",885,833,52,5.87570621469
76,1500000US130131801071,130131801071,"Block Group 1, Census Tract 1801.07, Barrow County, Georgia",1214,1194,20,1.64744645799
77,1500000US130131801072,130131801072,"Block Group 2, Census Tract 1801.07, Barrow County, Georgia",2639,2136,503,19.0602500947
78,1500000US130131801081,130131801081,"Block Group 1, Census Tract 1801.08, Barrow County, Georgia",1568,1463,105,6.69642857143
79,1500000US130131801082,130131801082,"Block Group 2, Census Tract 1801.08, Barrow County, Georgia",1634,1562,72,4.40636474908
80,1500000US130131802031,130131802031,"Block Group 1, Census Tract 1802.03, Barrow County, Georgia",1827,1562,265,14.5046524357
81,1500000US130131802032,130131802032,"Block Group 2, Census Tract 1802.03, Barrow County, Georgia",1594,1166,428,26.8506900878
82,1500000US130131802041,130131802041,"Block Group 1, Census Tract 1802.04, Barrow County, Georgia",1165,1053,112,9.61373390558
83,1500000US130131802042,130131802042,"Block Group 2, Census Tract 1802.04, Barrow County, Georgia",1567,1352,215,13.7204850032
84,1500000US130131802051,130131802051,"Block Group 1, Census Tract 1802.05, Barrow County, Georgia",1196,1065,131,10.9531772575
85,1500000US130131802052,130131802052,"Block Group 2, Census Tract 1802.05, Barrow County, Georgia",653,638,15,2.29709035222
86,1500000US130131802053,130131802053,"Block Group 3, Census Tract 1802.05, Barrow County, Georgia",2540,2417,123,4.84251968504
87,1500000US130131802061,130131802061,"Block Group 1, Census Tract 1802.06, Barrow County, Georgia",1358,1350,8,0.589101620029
88,1500000US130131802062,130131802062,"Block Group 2, Census Tract 1802.06, Barrow County, Georgia",1358,1226,132,9.72017673049
89,1500000US130131803011,130131803011,"Block Group 1, Census Tract 1803.01, Barrow County, Georgia",2167,2049,118,5.44531610521
90,1500000US130131803021,130131803021,"Block Group 1, Census Tract 1803.02, Barrow County, Georgia",2276,2050,226,9.92970123023
91,1500000US130131803022,130131803022,"Block Group 2, Census Tract 1803.02, Barrow County, Georgia",3231,3133,98,3.03311668214
92,1500000US130131803031,130131803031,"Block Group 1, Census Tract 1803.03, Barrow County, Georgia",2334,2054,280,11.9965724079
93,1500000US130131803032,130131803032,"Block Group 2, Census Tract 1803.03, Barrow County, Georgia",1989,1841,148,7.44092508798
94,1500000US130131804011,130131804011,"Block Group 1, Census Tract 1804.01, Barrow County, Georgia",1852,1852,0,0.0
95,1500000US130131804012,130131804012,"Block Group 2, Census Tract 1804.01, Barrow County, Georgia",3616,3415,201,5.55862831858
96,1500000US130131804021,130131804021,"Block Group 1, Census Tract 1804.02, Barrow County, Georgia",1197,1095,102,8.52130325815
97,1500000US130131804022,130131804022,"Block Group 2, Census Tract 1804.02, Barrow County, Georgia",4149,3502,647,15.5941190648
98,1500000US130131804023,130131804023,"Block Group 3, Census Tract 1804.02, Barrow County, Georgia",747,747,0,0.0
99,1500000US130131805011,130131805011,"Block Group 1, Census Tract 1805.01, Barrow County, Georgia",5718,4986,732,12.8016789087
100,1500000US130131805021,130131805021,"Block Group 1, Census Tract 1805.02, Barrow County, Georgia",1667,1461,206,12.3575284943
101,1500000US130131805022,130131805022,"Block Group 2, Census Tract 1805.02, Barrow County, Georgia",1451,1436,15,1.03376981392
102,1500000US130131805023,130131805023,"Block Group 3, Census Tract 1805.02, Barrow County, Georgia",1064,974,90,8.45864661654
103,1500000US130131805024,130131805024,"Block Group 4, Census Tract 1805.02, Barrow County, Georgia",366,366,0,0.0
104,1500000US130131805031,130131805031,"Block Group 1, Census Tract 1805.03, Barrow County, Georgia",5592,4688,904,16.1659513591
105,1500000US130159601011,130159601011,"Block Group 1, Census Tract 9601.01, Bartow County, Georgia",1474,1453,21,1.42469470828
106,1500000US130159601021,130159601021,"Block Group 1, Census Tract 9601.02, Bartow County, Georgia",3913,3681,232,5.92895476616
107,1500000US130159601022,130159601022,"Block Group 2, Census Tract 9601.02, Bartow County, Georgia",2919,2854,65,2.22678999657
108,1500000US130159601023,130159601023,"Block Group 3, Census Tract 9601.02, Bartow County, Georgia",2386,2246,140,5.86756077117
109,1500000US130159602001,130159602001,"Block Group 1, Census Tract 9602, Bartow County, Georgia",2727,2594,133,4.8771543821
110,1500000US130159602002,130159602002,"Block Group 2, Census Tract 9602, Bartow County, Georgia",1029,888,141,13.7026239067
111,1500000US130159602003,130159602003,"Block Group 3, Census Tract 9602, Bartow County, Georgia",2579,2482,97,3.76114773168
112,1500000US130159602004,130159602004,"Block Group 4, Census Tract 9602, Bartow County, Georgia",3156,2995,161,5.10139416984
113,1500000US130159602005,130159602005,"Block Group 5, Census Tract 9602, Bartow County, Georgia",2260,2118,142,6.28318584071
114,1500000US130159603001,130159603001,"Block Group 1, Census Tract 9603, Bartow County, Georgia",3139,2768,371,11.8190506531
115,1500000US130159603002,130159603002,"Block Group 2, Census Tract 9603, Bartow County, Georgia",3501,3365,136,3.88460439874
116,1500000US130159604011,130159604011,"Block Group 1, Census Tract 9604.01, Bartow County, Georgia",1259,1259,0,0.0
117,1500000US130159604012,130159604012,"Block Group 2, Census Tract 9604.01, Bartow County, Georgia",4563,4107,456,9.99342537804
118,1500000US130159604013,130159604013,"Block Group 3, Census Tract 9604.01, Bartow County, Georgia",3565,2968,597,16.7461430575
119,1500000US130159604021,130159604021,"Block Group 1, Census Tract 9604.02, Bartow County, Georgia",1627,1580,47,2.88875230486
120,1500000US130159604022,130159604022,"Block Group 2, Census Tract 9604.02, Bartow County, Georgia",3594,3594,0,0.0
121,1500000US130159604023,130159604023,"Block Group 3, Census Tract 9604.02, Bartow County, Georgia",3631,3291,340,9.36381162214
122,1500000US130159605001,130159605001,"Block Group 1, Census Tract 9605, Bartow County, Georgia",1342,1087,255,19.001490313
123,1500000US130159605002,130159605002,"Block Group 2, Census Tract 9605, Bartow County, Georgia",1317,1174,143,10.8580106302
124,1500000US130159605003,130159605003,"Block Group 3, Census Tract 9605, Bartow County, Georgia",1779,1459,320,17.987633502
125,1500000US130159605004,130159605004,"Block Group 4, Census Tract 9605, Bartow County, Georgia",3724,3586,138,3.70569280344
126,1500000US130159606001,130159606001,"Block Group 1, Census Tract 9606, Bartow County, Georgia",2025,1388,637,31.4567901235
127,1500000US130159606002,130159606002,"Block Group 2, Census Tract 9606, Bartow County, Georgia",487,487,0,0.0
128,1500000US130159606003,130159606003,"Block Group 3, Census Tract 9606, Bartow County, Georgia",872,610,262,30.0458715596
129,1500000US130159606004,130159606004,"Block Group 4, Census Tract 9606, Bartow County, Georgia",1408,1344,64,4.54545454545
130,1500000US130159606005,130159606005,"Block Group 5, Census Tract 9606, Bartow County, Georgia",4008,3778,230,5.73852295409
131,1500000US130159606006,130159606006,"Block Group 6, Census Tract 9606, Bartow County, Georgia",523,523,0,0.0
132,1500000US130159607001,130159607001,"Block Group 1, Census Tract 9607, Bartow County, Georgia",1655,1598,57,3.44410876133
133,1500000US130159607002,130159607002,"Block Group 2, Census Tract 9607, Bartow County, Georgia",2143,1467,676,31.5445636958
134,1500000US130159607003,130159607003,"Block Group 3, Census Tract 9607, Bartow County, Georgia",1912,1888,24,1.25523012552
135,1500000US130159607004,130159607004,"Block Group 4, Census Tract 9607, Bartow County, Georgia",1018,973,45,4.42043222004
136,1500000US130159607005,130159607005,"Block Group 5, Census Tract 9607, Bartow County, Georgia",544,443,101,18.5661764706
137,1500000US130159608011,130159608011,"Block Group 1, Census Tract 9608.01, Bartow County, Georgia",1152,1152,0,0.0
138,1500000US130159608012,130159608012,"Block Group 2, Census Tract 9608.01, Bartow County, Georgia",2333,2051,282,12.087441063
139,1500000US130159608021,130159608021,"Block Group 1, Census Tract 9608.02, Bartow County, Georgia",1712,1223,489,28.5630841121
140,1500000US130159608022,130159608022,"Block Group 2, Census Tract 9608.02, Bartow County, Georgia",1111,1110,1,0.0900090009001
141,1500000US130159608031,130159608031,"Block Group 1, Census Tract 9608.03, Bartow County, Georgia",1756,1741,15,0.854214123007
142,1500000US130159608032,130159608032,"Block Group 2, Census Tract 9608.03, Bartow County, Georgia",1181,1181,0,0.0
143,1500000US130159608033,130159608033,"Block Group 3, Census Tract 9608.03, Bartow County, Georgia",2785,2550,235,8.43806104129
144,1500000US130159609011,130159609011,"Block Group 1, Census Tract 9609.01, Bartow County, Georgia",975,918,57,5.84615384615
145,1500000US130159609012,130159609012,"Block Group 2, Census Tract 9609.01, Bartow County, Georgia",2261,2101,160,7.07651481645
146,1500000US130159609021,130159609021,"Block Group 1, Census Tract 9609.02, Bartow County, Georgia",2467,2403,64,2.59424402108
147,1500000US130159609022,130159609022,"Block Group 2, Census Tract 9609.02, Bartow County, Georgia",953,921,32,3.35781741868
148,1500000US130159609023,130159609023,"Block Group 3, Census Tract 9609.02, Bartow County, Georgia",1044,1000,44,4.21455938697
149,1500000US130159609024,130159609024,"Block Group 4, Census Tract 9609.02, Bartow County, Georgia",1850,1522,328,17.7297297297
150,1500000US130159610001,130159610001,"Block Group 1, Census Tract 9610, Bartow County, Georgia",770,770,0,0.0
151,1500000US130159610002,130159610002,"Block Group 2, Census Tract 9610, Bartow County, Georgia",1922,1768,154,8.01248699272
152,1500000US130159610003,130159610003,"Block Group 3, Census Tract 9610, Bartow County, Georgia",2409,2324,85,3.52843503528
153,1500000US130159610004,130159610004,"Block Group 4, Census Tract 9610, Bartow County, Georgia",2576,2507,69,2.67857142857
154,1500000US130179601001,130179601001,"Block Group 1, Census Tract 9601, Ben Hill County, Georgia",2674,2674,0,0.0
155,1500000US130179602001,130179602001,"Block Group 1, Census Tract 9602, Ben Hill County, Georgia",1730,1676,54,3.12138728324
156,1500000US130179603001,130179603001,"Block Group 1, Census Tract 9603, Ben Hill County, Georgia",1165,1165,0,0.0
157,1500000US130179603002,130179603002,"Block Group 2, Census Tract 9603, Ben Hill County, Georgia",533,415,118,22.138836773
158,1500000US130179603003,130179603003,"Block Group 3, Census Tract 9603, Ben Hill County, Georgia",1075,937,138,12.8372093023
159,1500000US130179603004,130179603004,"Block Group 4, Census Tract 9603, Ben Hill County, Georgia",521,521,0,0.0
160,1500000US130179604001,130179604001,"Block Group 1, Census Tract 9604, Ben Hill County, Georgia",1766,1193,573,32.4462061155
161,1500000US130179604002,130179604002,"Block Group 2, Census Tract 9604, Ben Hill County, Georgia",1104,1104,0,0.0
162,1500000US130179604003,130179604003,"Block Group 3, Census Tract 9604, Ben Hill County, Georgia",248,139,109,43.9516129032
163,1500000US130179604004,130179604004,"Block Group 4, Census Tract 9604, Ben Hill County, Georgia",858,858,0,0.0
164,1500000US130179605001,130179605001,"Block Group 1, Census Tract 9605, Ben Hill County, Georgia",1231,1217,14,1.13728675873
165,1500000US130179605002,130179605002,"Block Group 2, Census Tract 9605, Ben Hill County, Georgia",1322,1309,13,0.983358547655
166,1500000US130179605003,130179605003,"Block Group 3, Census Tract 9605, Ben Hill County, Georgia",1176,1176,0,0.0
167,1500000US130179605004,130179605004,"Block Group 4, Census Tract 9605, Ben Hill County, Georgia",1162,1114,48,4.13080895009
168,1500000US130179605005,130179605005,"Block Group 5, Census Tract 9605, Ben Hill County, Georgia",912,898,14,1.5350877193
169,1500000US130199701001,130199701001,"Block Group 1, Census Tract 9701, Berrien County, Georgia",850,823,27,3.17647058824
170,1500000US130199701002,130199701002,"Block Group 2, Census Tract 9701, Berrien County, Georgia",994,994,0,0.0
171,1500000US130199702001,130199702001,"Block Group 1, Census Tract 9702, Berrien County, Georgia",2022,1770,252,12.4629080119
172,1500000US130199702002,130199702002,"Block Group 2, Census Tract 9702, Berrien County, Georgia",1834,1617,217,11.8320610687
173,1500000US130199703001,130199703001,"Block Group 1, Census Tract 9703, Berrien County, Georgia",1037,873,164,15.8148505304
174,1500000US130199703002,130199703002,"Block Group 2, Census Tract 9703, Berrien County, Georgia",1275,1243,32,2.50980392157
175,1500000US130199703003,130199703003,"Block Group 3, Census Tract 9703, Berrien County, Georgia",911,906,5,0.548847420417
176,1500000US130199704001,130199704001,"Block Group 1, Census Tract 9704, Berrien County, Georgia",843,843,0,0.0
177,1500000US130199704002,130199704002,"Block Group 2, Census Tract 9704, Berrien County, Georgia",803,747,56,6.97384806974
178,1500000US130199704003,130199704003,"Block Group 3, Census Tract 9704, Berrien County, Georgia",1217,1217,0,0.0
179,1500000US130199705001,130199705001,"Block Group 1, Census Tract 9705, Berrien County, Georgia",859,850,9,1.04772991851
180,1500000US130199705002,130199705002,"Block Group 2, Census Tract 9705, Berrien County, Georgia",2627,2510,117,4.45374952417
181,1500000US130199706001,130199706001,"Block Group 1, Census Tract 9706, Berrien County, Georgia",1198,1184,14,1.16861435726
182,1500000US130199706002,130199706002,"Block Group 2, Census Tract 9706, Berrien County, Georgia",1697,1696,1,0.0589275191514
183,1500000US130199706003,130199706003,"Block Group 3, Census Tract 9706, Berrien County, Georgia",852,816,36,4.22535211268
184,1500000US130210101001,130210101001,"Block Group 1, Census Tract 101, Bibb County, Georgia",630,620,10,1.5873015873
185,1500000US130210101002,130210101002,"Block Group 2, Census Tract 101, Bibb County, Georgia",865,865,0,0.0
186,1500000US130210102001,130210102001,"Block Group 1, Census Tract 102, Bibb County, Georgia",420,420,0,0.0
187,1500000US130210102002,130210102002,"Block Group 2, Census Tract 102, Bibb County, Georgia",572,551,21,3.67132867133
188,1500000US130210102003,130210102003,"Block Group 3, Census Tract 102, Bibb County, Georgia",949,913,36,3.79346680717
189,1500000US130210103001,130210103001,"Block Group 1, Census Tract 103, Bibb County, Georgia",767,767,0,0.0
190,1500000US130210104001,130210104001,"Block Group 1, Census Tract 104, Bibb County, Georgia",421,399,22,5.22565320665
191,1500000US130210104002,130210104002,"Block Group 2, Census Tract 104, Bibb County, Georgia",433,433,0,0.0
192,1500000US130210104003,130210104003,"Block Group 3, Census Tract 104, Bibb County, Georgia",588,588,0,0.0
193,1500000US130210104004,130210104004,"Block Group 4, Census Tract 104, Bibb County, Georgia",808,808,0,0.0
194,1500000US130210105001,130210105001,"Block Group 1, Census Tract 105, Bibb County, Georgia",3360,3324,36,1.07142857143
195,1500000US130210105002,130210105002,"Block Group 2, Census Tract 105, Bibb County, Georgia",446,446,0,0.0
196,1500000US130210108001,130210108001,"Block Group 1, Census Tract 108, Bibb County, Georgia",1464,1405,59,4.03005464481
197,1500000US130210110001,130210110001,"Block Group 1, Census Tract 110, Bibb County, Georgia",527,513,14,2.65654648956
198,1500000US130210110002,130210110002,"Block Group 2, Census Tract 110, Bibb County, Georgia",1890,1774,116,6.13756613757
199,1500000US130210110003,130210110003,"Block Group 3, Census Tract 110, Bibb County, Georgia",615,615,0,0.0
200,1500000US130210110004,130210110004,"Block Group 4, Census Tract 110, Bibb County, Georgia",674,621,53,7.86350148368
201,1500000US130210110005,130210110005,"Block Group 5, Census Tract 110, Bibb County, Georgia",913,913,0,0.0
202,1500000US130210111001,130210111001,"Block Group 1, Census Tract 111, Bibb County, Georgia",877,877,0,0.0
203,1500000US130210111002,130210111002,"Block Group 2, Census Tract 111, Bibb County, Georgia",665,665,0,0.0
204,1500000US130210111003,130210111003,"Block Group 3, Census Tract 111, Bibb County, Georgia",391,391,0,0.0
205,1500000US130210115001,130210115001,"Block Group 1, Census Tract 115, Bibb County, Georgia",504,493,11,2.18253968254
206,1500000US130210115002,130210115002,"Block Group 2, Census Tract 115, Bibb County, Georgia",694,683,11,1.58501440922
207,1500000US130210117011,130210117011,"Block Group 1, Census Tract 117.01, Bibb County, Georgia",1092,1087,5,0.457875457875
208,1500000US130210117012,130210117012,"Block Group 2, Census Tract 117.01, Bibb County, Georgia",1426,1406,20,1.40252454418
209,1500000US130210117021,130210117021,"Block Group 1, Census Tract 117.02, Bibb County, Georgia",555,555,0,0.0
210,1500000US130210117022,130210117022,"Block Group 2, Census Tract 117.02, Bibb County, Georgia",759,759,0,0.0
211,1500000US130210117023,130210117023,"Block Group 3, Census Tract 117.02, Bibb County, Georgia",960,960,0,0.0
212,1500000US130210117024,130210117024,"Block Group 4, Census Tract 117.02, Bibb County, Georgia",894,894,0,0.0
213,1500000US130210117025,130210117025,"Block Group 5, Census Tract 117.02, Bibb County, Georgia",815,815,0,0.0
214,1500000US130210117026,130210117026,"Block Group 6, Census Tract 117.02, Bibb County, Georgia",586,586,0,0.0
215,1500000US130210118001,130210118001,"Block Group 1, Census Tract 118, Bibb County, Georgia",1330,1324,6,0.451127819549
216,1500000US130210118002,130210118002,"Block Group 2, Census Tract 118, Bibb County, Georgia",755,745,10,1.32450331126
217,1500000US130210118003,130210118003,"Block Group 3, Census Tract 118, Bibb County, Georgia",378,378,0,0.0
218,1500000US130210118004,130210118004,"Block Group 4, Census Tract 118, Bibb County, Georgia",1110,1110,0,0.0
219,1500000US130210119001,130210119001,"Block Group 1, Census Tract 119, Bibb County, Georgia",454,437,17,3.74449339207
220,1500000US130210119002,130210119002,"Block Group 2, Census Tract 119, Bibb County, Georgia",859,859,0,0.0
221,1500000US130210119003,130210119003,"Block Group 3, Census Tract 119, Bibb County, Georgia",547,547,0,0.0
222,1500000US130210120001,130210120001,"Block Group 1, Census Tract 120, Bibb County, Georgia",964,907,57,5.91286307054
223,1500000US130210120002,130210120002,"Block Group 2, Census Tract 120, Bibb County, Georgia",689,689,0,0.0
224,1500000US130210120003,130210120003,"Block Group 3, Census Tract 120, Bibb County, Georgia",1367,1367,0,0.0
225,1500000US130210120004,130210120004,"Block Group 4, Census Tract 120, Bibb County, Georgia",1375,1320,55,4.0
226,1500000US130210121011,130210121011,"Block Group 1, Census Tract 121.01, Bibb County, Georgia",2065,2062,3,0.145278450363
227,1500000US130210121021,130210121021,"Block Group 1, Census Tract 121.02, Bibb County, Georgia",1720,1613,107,6.22093023256
228,1500000US130210121022,130210121022,"Block Group 2, Census Tract 121.02, Bibb County, Georgia",1954,1937,17,0.870010235415
229,1500000US130210121023,130210121023,"Block Group 3, Census Tract 121.02, Bibb County, Georgia",1333,1196,137,10.2775693923
230,1500000US130210122001,130210122001,"Block Group 1, Census Tract 122, Bibb County, Georgia",970,937,33,3.40206185567
231,1500000US130210122002,130210122002,"Block Group 2, Census Tract 122, Bibb County, Georgia",1410,1405,5,0.354609929078
232,1500000US130210123001,130210123001,"Block Group 1, Census Tract 123, Bibb County, Georgia",895,883,12,1.34078212291
233,1500000US130210123002,130210123002,"Block Group 2, Census Tract 123, Bibb County, Georgia",377,377,0,0.0
234,1500000US130210123003,130210123003,"Block Group 3, Census Tract 123, Bibb County, Georgia",1265,1260,5,0.395256916996
235,1500000US130210124001,130210124001,"Block Group 1, Census Tract 124, Bibb County, Georgia",1685,1685,0,0.0
236,1500000US130210124002,130210124002,"Block Group 2, Census Tract 124, Bibb County, Georgia",1135,1135,0,0.0
237,1500000US130210124003,130210124003,"Block Group 3, Census Tract 124, Bibb County, Georgia",897,897,0,0.0
238,1500000US130210124004,130210124004,"Block Group 4, Census Tract 124, Bibb County, Georgia",579,579,0,0.0
239,1500000US130210125001,130210125001,"Block Group 1, Census Tract 125, Bibb County, Georgia",776,748,28,3.60824742268
240,1500000US130210125002,130210125002,"Block Group 2, Census Tract 125, Bibb County, Georgia",1045,1045,0,0.0
241,1500000US130210125003,130210125003,"Block Group 3, Census Tract 125, Bibb County, Georgia",1395,1358,37,2.6523297491
242,1500000US130210126001,130210126001,"Block Group 1, Census Tract 126, Bibb County, Georgia",1637,1637,0,0.0
243,1500000US130210126002,130210126002,"Block Group 2, Census Tract 126, Bibb County, Georgia",646,624,22,3.40557275542
244,1500000US130210126003,130210126003,"Block Group 3, Census Tract 126, Bibb County, Georgia",1312,1207,105,8.00304878049
245,1500000US130210126004,130210126004,"Block Group 4, Census Tract 126, Bibb County, Georgia",1275,1275,0,0.0
246,1500000US130210127001,130210127001,"Block Group 1, Census Tract 127, Bibb County, Georgia",956,943,13,1.35983263598
247,1500000US130210127002,130210127002,"Block Group 2, Census Tract 127, Bibb County, Georgia",778,778,0,0.0
248,1500000US130210127003,130210127003,"Block Group 3, Census Tract 127, Bibb County, Georgia",423,416,7,1.6548463357
249,1500000US130210128001,130210128001,"Block Group 1, Census Tract 128, Bibb County, Georgia",2049,2038,11,0.536847242557
250,1500000US130210128002,130210128002,"Block Group 2, Census Tract 128, Bibb County, Georgia",1137,1137,0,0.0
251,1500000US130210128003,130210128003,"Block Group 3, Census Tract 128, Bibb County, Georgia",396,341,55,13.8888888889
252,1500000US130210129001,130210129001,"Block Group 1, Census Tract 129, Bibb County, Georgia",949,947,2,0.210748155954
253,1500000US130210129002,130210129002,"Block Group 2, Census Tract 129, Bibb County, Georgia",881,876,5,0.567536889898
254,1500000US130210131011,130210131011,"Block Group 1, Census Tract 131.01, Bibb County, Georgia",2693,2406,287,10.6572595618
255,1500000US130210131012,130210131012,"Block Group 2, Census Tract 131.01, Bibb County, Georgia",1581,1472,109,6.89437065149
256,1500000US130210131013,130210131013,"Block Group 3, Census Tract 131.01, Bibb County, Georgia",1482,1482,0,0.0
257,1500000US130210131021,130210131021,"Block Group 1, Census Tract 131.02, Bibb County, Georgia",528,528,0,0.0
258,1500000US130210131022,130210131022,"Block Group 2, Census Tract 131.02, Bibb County, Georgia",2087,2087,0,0.0
259,1500000US130210131023,130210131023,"Block Group 3, Census Tract 131.02, Bibb County, Georgia",1072,1072,0,0.0
260,1500000US130210131024,130210131024,"Block Group 4, Census Tract 131.02, Bibb County, Georgia",653,653,0,0.0
261,1500000US130210132011,130210132011,"Block Group 1, Census Tract 132.01, Bibb County, Georgia",764,626,138,18.0628272251
262,1500000US130210132012,130210132012,"Block Group 2, Census Tract 132.01, Bibb County, Georgia",3342,3241,101,3.02214242968
263,1500000US130210132013,130210132013,"Block Group 3, Census Tract 132.01, Bibb County, Georgia",1175,1175,0,0.0
264,1500000US130210132014,130210132014,"Block Group 4, Census Tract 132.01, Bibb County, Georgia",765,765,0,0.0
265,1500000US130210132021,130210132021,"Block Group 1, Census Tract 132.02, Bibb County, Georgia",1035,946,89,8.59903381643
266,1500000US130210132022,130210132022,"Block Group 2, Census Tract 132.02, Bibb County, Georgia",854,854,0,0.0
267,1500000US130210132023,130210132023,"Block Group 3, Census Tract 132.02, Bibb County, Georgia",1025,782,243,23.7073170732
268,1500000US130210133021,130210133021,"Block Group 1, Census Tract 133.02, Bibb County, Georgia",519,519,0,0.0
269,1500000US130210133022,130210133022,"Block Group 2, Census Tract 133.02, Bibb County, Georgia",826,826,0,0.0
270,1500000US130210133023,130210133023,"Block Group 3, Census Tract 133.02, Bibb County, Georgia",883,882,1,0.113250283126
271,1500000US130210133024,130210133024,"Block Group 4, Census Tract 133.02, Bibb County, Georgia",1725,1725,0,0.0
272,1500000US130210134071,130210134071,"Block Group 1, Census Tract 134.07, Bibb County, Georgia",2057,2039,18,0.875060768109
273,1500000US130210134072,130210134072,"Block Group 2, Census Tract 134.07, Bibb County, Georgia",1618,1471,147,9.08529048208
274,1500000US130210134073,130210134073,"Block Group 3, Census Tract 134.07, Bibb County, Georgia",1038,1020,18,1.73410404624
275,1500000US130210134081,130210134081,"Block Group 1, Census Tract 134.08, Bibb County, Georgia",3394,3360,34,1.00176782557
276,1500000US130210134082,130210134082,"Block Group 2, Census Tract 134.08, Bibb County, Georgia",1141,1130,11,0.964066608238
277,1500000US130210134091,130210134091,"Block Group 1, Census Tract 134.09, Bibb County, Georgia",2316,2177,139,6.00172711572
278,1500000US130210134092,130210134092,"Block Group 2, Census Tract 134.09, Bibb County, Georgia",1661,1462,199,11.9807344973
279,1500000US130210134101,130210134101,"Block Group 1, Census Tract 134.10, Bibb County, Georgia",1733,1733,0,0.0
280,1500000US130210134102,130210134102,"Block Group 2, Census Tract 134.10, Bibb County, Georgia",2030,2029,1,0.0492610837438
281,1500000US130210134103,130210134103,"Block Group 3, Census Tract 134.10, Bibb County, Georgia",1442,1442,0,0.0
282,1500000US130210134111,130210134111,"Block Group 1, Census Tract 134.11, Bibb County, Georgia",1333,1242,91,6.82670667667
283,1500000US130210134112,130210134112,"Block Group 2, Census Tract 134.11, Bibb County, Georgia",2435,2359,76,3.12114989733
284,1500000US130210135021,130210135021,"Block Group 1, Census Tract 135.02, Bibb County, Georgia",470,459,11,2.34042553191
285,1500000US130210135022,130210135022,"Block Group 2, Census Tract 135.02, Bibb County, Georgia",1285,1113,172,13.3852140078
286,1500000US130210135031,130210135031,"Block Group 1, Census Tract 135.03, Bibb County, Georgia",2754,1997,757,27.4872912128
287,1500000US130210135041,130210135041,"Block Group 1, Census Tract 135.04, Bibb County, Georgia",2423,2423,0,0.0
288,1500000US130210135042,130210135042,"Block Group 2, Census Tract 135.04, Bibb County, Georgia",2275,2242,33,1.45054945055
289,1500000US130210135043,130210135043,"Block Group 3, Census Tract 135.04, Bibb County, Georgia",1537,1537,0,0.0
290,1500000US130210135044,130210135044,"Block Group 4, Census Tract 135.04, Bibb County, Georgia",2258,2213,45,1.99291408326
291,1500000US130210136031,130210136031,"Block Group 1, Census Tract 136.03, Bibb County, Georgia",3329,3211,118,3.54460799039
292,1500000US130210136032,130210136032,"Block Group 2, Census Tract 136.03, Bibb County, Georgia",1654,1419,235,14.207980653
293,1500000US130210136041,130210136041,"Block Group 1, Census Tract 136.04, Bibb County, Georgia",1686,1686,0,0.0
294,1500000US130210136042,130210136042,"Block Group 2, Census Tract 136.04, Bibb County, Georgia",1782,1732,50,2.80583613917
295,1500000US130210136043,130210136043,"Block Group 3, Census Tract 136.04, Bibb County, Georgia",1833,1725,108,5.89198036007
296,1500000US130210136051,130210136051,"Block Group 1, Census Tract 136.05, Bibb County, Georgia",1683,1683,0,0.0
297,1500000US130210136052,130210136052,"Block Group 2, Census Tract 136.05, Bibb County, Georgia",1459,1418,41,2.8101439342
298,1500000US130210136053,130210136053,"Block Group 3, Census Tract 136.05, Bibb County, Georgia",1585,1438,147,9.27444794953
299,1500000US130210136061,130210136061,"Block Group 1, Census Tract 136.06, Bibb County, Georgia",753,753,0,0.0
300,1500000US130210136062,130210136062,"Block Group 2, Census Tract 136.06, Bibb County, Georgia",1180,1180,0,0.0
301,1500000US130210136063,130210136063,"Block Group 3, Census Tract 136.06, Bibb County, Georgia",1207,1207,0,0.0
302,1500000US130210136064,130210136064,"Block Group 4, Census Tract 136.06, Bibb County, Georgia",2969,2969,0,0.0
303,1500000US130210137001,130210137001,"Block Group 1, Census Tract 137, Bibb County, Georgia",1719,1696,23,1.33798720186
304,1500000US130210137002,130210137002,"Block Group 2, Census Tract 137, Bibb County, Georgia",779,779,0,0.0
305,1500000US130210137003,130210137003,"Block Group 3, Census Tract 137, Bibb County, Georgia",395,380,15,3.79746835443
306,1500000US130210138001,130210138001,"Block Group 1, Census Tract 138, Bibb County, Georgia",778,764,14,1.79948586118
307,1500000US130210138002,130210138002,"Block Group 2, Census Tract 138, Bibb County, Georgia",1457,1407,50,3.43170899108
308,1500000US130210139001,130210139001,"Block Group 1, Census Tract 139, Bibb County, Georgia",984,874,110,11.1788617886
309,1500000US130210139002,130210139002,"Block Group 2, Census Tract 139, Bibb County, Georgia",1047,988,59,5.63514804202
310,1500000US130237901001,130237901001,"Block Group 1, Census Tract 7901, Bleckley County, Georgia",2159,2143,16,0.741083835109
311,1500000US130237901002,130237901002,"Block Group 2, Census Tract 7901, Bleckley County, Georgia",2528,2509,19,0.751582278481
312,1500000US130237902001,130237902001,"Block Group 1, Census Tract 7902, Bleckley County, Georgia",1863,1594,269,14.4390767579
313,1500000US130237902002,130237902002,"Block Group 2, Census Tract 7902, Bleckley County, Georgia",675,661,14,2.07407407407
314,1500000US130237903001,130237903001,"Block Group 1, Census Tract 7903, Bleckley County, Georgia",1880,1865,15,0.797872340426
315,1500000US130237903002,130237903002,"Block Group 2, Census Tract 7903, Bleckley County, Georgia",744,744,0,0.0
316,1500000US130237903003,130237903003,"Block Group 3, Census Tract 7903, Bleckley County, Georgia",1539,1539,0,0.0
317,1500000US130237903004,130237903004,"Block Group 4, Census Tract 7903, Bleckley County, Georgia",1358,1352,6,0.441826215022
318,1500000US130259601001,130259601001,"Block Group 1, Census Tract 9601, Brantley County, Georgia",3188,3166,22,0.69008782936
319,1500000US130259601002,130259601002,"Block Group 2, Census Tract 9601, Brantley County, Georgia",2626,2626,0,0.0
320,1500000US130259601003,130259601003,"Block Group 3, Census Tract 9601, Brantley County, Georgia",1428,1415,13,0.910364145658
321,1500000US130259602001,130259602001,"Block Group 1, Census Tract 9602, Brantley County, Georgia",2301,2025,276,11.9947848761
322,1500000US130259602002,130259602002,"Block Group 2, Census Tract 9602, Brantley County, Georgia",1749,1745,4,0.228702115495
323,1500000US130259602003,130259602003,"Block Group 3, Census Tract 9602, Brantley County, Georgia",1941,1912,29,1.49407521896
324,1500000US130259603001,130259603001,"Block Group 1, Census Tract 9603, Brantley County, Georgia",976,964,12,1.22950819672
325,1500000US130259603002,130259603002,"Block Group 2, Census Tract 9603, Brantley County, Georgia",2202,2192,10,0.454132606721
326,1500000US130259603003,130259603003,"Block Group 3, Census Tract 9603, Brantley County, Georgia",2041,2017,24,1.17589416952
327,1500000US130279602001,130279602001,"Block Group 1, Census Tract 9602, Brooks County, Georgia",872,653,219,25.1146788991
328,1500000US130279602002,130279602002,"Block Group 2, Census Tract 9602, Brooks County, Georgia",707,707,0,0.0
329,1500000US130279603001,130279603001,"Block Group 1, Census Tract 9603, Brooks County, Georgia",1330,1249,81,6.09022556391
330,1500000US130279603002,130279603002,"Block Group 2, Census Tract 9603, Brooks County, Georgia",894,894,0,0.0
331,1500000US130279603003,130279603003,"Block Group 3, Census Tract 9603, Brooks County, Georgia",2028,2016,12,0.591715976331
332,1500000US130279603004,130279603004,"Block Group 4, Census Tract 9603, Brooks County, Georgia",1338,1018,320,23.9162929746
333,1500000US130279604001,130279604001,"Block Group 1, Census Tract 9604, Brooks County, Georgia",780,747,33,4.23076923077
334,1500000US130279604002,130279604002,"Block Group 2, Census Tract 9604, Brooks County, Georgia",1649,1618,31,1.87992722862
335,1500000US130279604003,130279604003,"Block Group 3, Census Tract 9604, Brooks County, Georgia",951,882,69,7.25552050473
336,1500000US130279605001,130279605001,"Block Group 1, Census Tract 9605, Brooks County, Georgia",859,815,44,5.12223515716
337,1500000US130279605002,130279605002,"Block Group 2, Census Tract 9605, Brooks County, Georgia",700,700,0,0.0
338,1500000US130279605003,130279605003,"Block Group 3, Census Tract 9605, Brooks County, Georgia",1209,1203,6,0.496277915633
339,1500000US130279606001,130279606001,"Block Group 1, Census Tract 9606, Brooks County, Georgia",1122,1074,48,4.27807486631
340,1500000US130279606002,130279606002,"Block Group 2, Census Tract 9606, Brooks County, Georgia",636,636,0,0.0
341,1500000US130279606003,130279606003,"Block Group 3, Census Tract 9606, Brooks County, Georgia",562,562,0,0.0
342,1500000US130299201011,130299201011,"Block Group 1, Census Tract 9201.01, Bryan County, Georgia",2259,2177,82,3.62992474546
343,1500000US130299201012,130299201012,"Block Group 2, Census Tract 9201.01, Bryan County, Georgia",2826,2799,27,0.955414012739
344,1500000US130299201021,130299201021,"Block Group 1, Census Tract 9201.02, Bryan County, Georgia",2594,2538,56,2.15882806476
345,1500000US130299201022,130299201022,"Block Group 2, Census Tract 9201.02, Bryan County, Georgia",1673,1628,45,2.68977884041
346,1500000US130299201023,130299201023,"Block Group 3, Census Tract 9201.02, Bryan County, Georgia",1480,1373,107,7.22972972973
347,1500000US130299203011,130299203011,"Block Group 1, Census Tract 9203.01, Bryan County, Georgia",2041,1863,178,8.72121509064
348,1500000US130299203031,130299203031,"Block Group 1, Census Tract 9203.03, Bryan County, Georgia",2972,2722,250,8.41184387618
349,1500000US130299203032,130299203032,"Block Group 2, Census Tract 9203.03, Bryan County, Georgia",3074,2802,272,8.84840598569
350,1500000US130299203051,130299203051,"Block Group 1, Census Tract 9203.05, Bryan County, Georgia",2298,1901,397,17.2758920801
351,1500000US130299203052,130299203052,"Block Group 2, Census Tract 9203.05, Bryan County, Georgia",2211,2127,84,3.79918588874
352,1500000US130299203061,130299203061,"Block Group 1, Census Tract 9203.06, Bryan County, Georgia",2508,2364,144,5.74162679426
353,1500000US130299203062,130299203062,"Block Group 2, Census Tract 9203.06, Bryan County, Georgia",5431,5035,396,7.29147486651
354,1500000US130299203063,130299203063,"Block Group 3, Census Tract 9203.06, Bryan County, Georgia",1784,1784,0,0.0
355,1500000US130299800001,130299800001,"Block Group 1, Census Tract 9800, Bryan County, Georgia",0,0,0,
356,1500000US130311101001,130311101001,"Block Group 1, Census Tract 1101, Bulloch County, Georgia",1084,1084,0,0.0
357,1500000US130311101002,130311101002,"Block Group 2, Census Tract 1101, Bulloch County, Georgia",1376,1359,17,1.23546511628
358,1500000US130311101003,130311101003,"Block Group 3, Census Tract 1101, Bulloch County, Georgia",1316,1314,2,0.151975683891
359,1500000US130311102001,130311102001,"Block Group 1, Census Tract 1102, Bulloch County, Georgia",1777,1719,58,3.26392796849
360,1500000US130311102002,130311102002,"Block Group 2, Census Tract 1102, Bulloch County, Georgia",1798,1713,85,4.72747497219
361,1500000US130311102003,130311102003,"Block Group 3, Census Tract 1102, Bulloch County, Georgia",969,860,109,11.2487100103
362,1500000US130311102004,130311102004,"Block Group 4, Census Tract 1102, Bulloch County, Georgia",613,613,0,0.0
363,1500000US130311102005,130311102005,"Block Group 5, Census Tract 1102, Bulloch County, Georgia",679,679,0,0.0
364,1500000US130311102006,130311102006,"Block Group 6, Census Tract 1102, Bulloch County, Georgia",1464,1408,56,3.82513661202
365,1500000US130311103001,130311103001,"Block Group 1, Census Tract 1103, Bulloch County, Georgia",2067,2067,0,0.0
366,1500000US130311103002,130311103002,"Block Group 2, Census Tract 1103, Bulloch County, Georgia",1591,1358,233,14.6448774356
367,1500000US130311103003,130311103003,"Block Group 3, Census Tract 1103, Bulloch County, Georgia",1982,1814,168,8.47628657921
368,1500000US130311103004,130311103004,"Block Group 4, Census Tract 1103, Bulloch County, Georgia",2744,2702,42,1.5306122449
369,1500000US130311104011,130311104011,"Block Group 1, Census Tract 1104.01, Bulloch County, Georgia",662,648,14,2.11480362538
370,1500000US130311104012,130311104012,"Block Group 2, Census Tract 1104.01, Bulloch County, Georgia",2107,2068,39,1.85097294732
371,1500000US130311104013,130311104013,"Block Group 3, Census Tract 1104.01, Bulloch County, Georgia",639,633,6,0.93896713615
372,1500000US130311104031,130311104031,"Block Group 1, Census Tract 1104.03, Bulloch County, Georgia",2775,2763,12,0.432432432432
373,1500000US130311104032,130311104032,"Block Group 2, Census Tract 1104.03, Bulloch County, Georgia",2741,2503,238,8.68296242247
374,1500000US130311104033,130311104033,"Block Group 3, Census Tract 1104.03, Bulloch County, Georgia",1485,1447,38,2.55892255892
375,1500000US130311104041,130311104041,"Block Group 1, Census Tract 1104.04, Bulloch County, Georgia",183,177,6,3.27868852459
376,1500000US130311104042,130311104042,"Block Group 2, Census Tract 1104.04, Bulloch County, Georgia",3969,3828,141,3.55253212396
377,1500000US130311104043,130311104043,"Block Group 3, Census Tract 1104.04, Bulloch County, Georgia",3107,2956,151,4.85999356292
378,1500000US130311105001,130311105001,"Block Group 1, Census Tract 1105, Bulloch County, Georgia",1023,911,112,10.9481915934
379,1500000US130311105002,130311105002,"Block Group 2, Census Tract 1105, Bulloch County, Georgia",1039,1039,0,0.0
380,1500000US130311105003,130311105003,"Block Group 3, Census Tract 1105, Bulloch County, Georgia",1712,1617,95,5.54906542056
381,1500000US130311105004,130311105004,"Block Group 4, Census Tract 1105, Bulloch County, Georgia",1026,1016,10,0.974658869396
382,1500000US130311106011,130311106011,"Block Group 1, Census Tract 1106.01, Bulloch County, Georgia",3422,3422,0,0.0
383,1500000US130311106012,130311106012,"Block Group 2, Census Tract 1106.01, Bulloch County, Georgia",965,907,58,6.0103626943
384,1500000US130311106013,130311106013,"Block Group 3, Census Tract 1106.01, Bulloch County, Georgia",2421,2345,76,3.13919867823
385,1500000US130311106021,130311106021,"Block Group 1, Census Tract 1106.02, Bulloch County, Georgia",818,773,45,5.50122249389
386,1500000US130311106022,130311106022,"Block Group 2, Census Tract 1106.02, Bulloch County, Georgia",552,546,6,1.08695652174
387,1500000US130311106023,130311106023,"Block Group 3, Census Tract 1106.02, Bulloch County, Georgia",2474,2265,209,8.44785772029
388,1500000US130311107001,130311107001,"Block Group 1, Census Tract 1107, Bulloch County, Georgia",4051,3872,179,4.41866205875
389,1500000US130311107002,130311107002,"Block Group 2, Census Tract 1107, Bulloch County, Georgia",2326,2288,38,1.63370593293
390,1500000US130311107003,130311107003,"Block Group 3, Census Tract 1107, Bulloch County, Georgia",1145,1142,3,0.262008733624
391,1500000US130311107004,130311107004,"Block Group 4, Census Tract 1107, Bulloch County, Georgia",2836,2656,180,6.34696755994
392,1500000US130311108001,130311108001,"Block Group 1, Census Tract 1108, Bulloch County, Georgia",1601,1601,0,0.0
393,1500000US130311108002,130311108002,"Block Group 2, Census Tract 1108, Bulloch County, Georgia",925,916,9,0.972972972973
394,1500000US130311109001,130311109001,"Block Group 1, Census Tract 1109, Bulloch County, Georgia",1263,1263,0,0.0
395,1500000US130311109002,130311109002,"Block Group 2, Census Tract 1109, Bulloch County, Georgia",2398,2231,167,6.96413678065
396,1500000US130311109003,130311109003,"Block Group 3, Census Tract 1109, Bulloch County, Georgia",2370,2359,11,0.464135021097
397,1500000US130311109004,130311109004,"Block Group 4, Census Tract 1109, Bulloch County, Georgia",891,874,17,1.90796857464
398,1500000US130339501001,130339501001,"Block Group 1, Census Tract 9501, Burke County, Georgia",2089,1935,154,7.37194830062
399,1500000US130339501002,130339501002,"Block Group 2, Census Tract 9501, Burke County, Georgia",3059,2995,64,2.09218698921
400,1500000US130339502001,130339502001,"Block Group 1, Census Tract 9502, Burke County, Georgia",1097,1039,58,5.2871467639
401,1500000US130339502002,130339502002,"Block Group 2, Census Tract 9502, Burke County, Georgia",1662,1643,19,1.1432009627
402,1500000US130339504001,130339504001,"Block Group 1, Census Tract 9504, Burke County, Georgia",1723,1723,0,0.0
403,1500000US130339504002,130339504002,"Block Group 2, Census Tract 9504, Burke County, Georgia",590,590,0,0.0
404,1500000US130339504003,130339504003,"Block Group 3, Census Tract 9504, Burke County, Georgia",1686,1686,0,0.0
405,1500000US130339504004,130339504004,"Block Group 4, Census Tract 9504, Burke County, Georgia",1129,1129,0,0.0
406,1500000US130339505001,130339505001,"Block Group 1, Census Tract 9505, Burke County, Georgia",1301,1301,0,0.0
407,1500000US130339505002,130339505002,"Block Group 2, Census Tract 9505, Burke County, Georgia",2401,2393,8,0.333194502291
408,1500000US130339505003,130339505003,"Block Group 3, Census Tract 9505, Burke County, Georgia",1802,1618,184,10.2108768036
409,1500000US130339507001,130339507001,"Block Group 1, Census Tract 9507, Burke County, Georgia",964,964,0,0.0
410,1500000US130339507002,130339507002,"Block Group 2, Census Tract 9507, Burke County, Georgia",778,778,0,0.0
411,1500000US130339507003,130339507003,"Block Group 3, Census Tract 9507, Burke County, Georgia",998,987,11,1.10220440882
412,1500000US130339509001,130339509001,"Block Group 1, Census Tract 9509, Burke County, Georgia",878,762,116,13.2118451025
413,1500000US130339509002,130339509002,"Block Group 2, Census Tract 9509, Burke County, Georgia",850,784,66,7.76470588235
414,1500000US130351501001,130351501001,"Block Group 1, Census Tract 1501, Butts County, Georgia",1519,1465,54,3.55497037525
415,1500000US130351501002,130351501002,"Block Group 2, Census Tract 1501, Butts County, Georgia",1330,1330,0,0.0
416,1500000US130351501003,130351501003,"Block Group 3, Census Tract 1501, Butts County, Georgia",1774,1774,0,0.0
417,1500000US130351501004,130351501004,"Block Group 4, Census Tract 1501, Butts County, Georgia",998,979,19,1.90380761523
418,1500000US130351501005,130351501005,"Block Group 5, Census Tract 1501, Butts County, Georgia",2298,2283,15,0.65274151436
419,1500000US130351502001,130351502001,"Block Group 1, Census Tract 1502, Butts County, Georgia",2947,2926,21,0.712589073634
420,1500000US130351502002,130351502002,"Block Group 2, Census Tract 1502, Butts County, Georgia",828,823,5,0.6038647343
421,1500000US130351502003,130351502003,"Block Group 3, Census Tract 1502, Butts County, Georgia",825,732,93,11.2727272727
422,1500000US130351502004,130351502004,"Block Group 4, Census Tract 1502, Butts County, Georgia",1154,1154,0,0.0
423,1500000US130351502005,130351502005,"Block Group 5, Census Tract 1502, Butts County, Georgia",2202,1995,207,9.40054495913
424,1500000US130351503001,130351503001,"Block Group 1, Census Tract 1503, Butts County, Georgia",2628,2620,8,0.304414003044
425,1500000US130351503002,130351503002,"Block Group 2, Census Tract 1503, Butts County, Georgia",1019,996,23,2.25711481845
426,1500000US130351503003,130351503003,"Block Group 3, Census Tract 1503, Butts County, Georgia",2995,2887,108,3.60601001669
427,1500000US130351503004,130351503004,"Block Group 4, Census Tract 1503, Butts County, Georgia",928,780,148,15.9482758621
428,1500000US130379501001,130379501001,"Block Group 1, Census Tract 9501, Calhoun County, Georgia",732,717,15,2.04918032787
429,1500000US130379501002,130379501002,"Block Group 2, Census Tract 9501, Calhoun County, Georgia",3033,2800,233,7.68216287504
430,1500000US130379502001,130379502001,"Block Group 1, Census Tract 9502, Calhoun County, Georgia",553,553,0,0.0
431,1500000US130379502002,130379502002,"Block Group 2, Census Tract 9502, Calhoun County, Georgia",527,527,0,0.0
432,1500000US130379502003,130379502003,"Block Group 3, Census Tract 9502, Calhoun County, Georgia",460,410,50,10.8695652174
433,1500000US130379502004,130379502004,"Block Group 4, Census Tract 9502, Calhoun County, Georgia",1184,1183,1,0.0844594594595
434,1500000US130390101001,130390101001,"Block Group 1, Census Tract 101, Camden County, Georgia",956,938,18,1.88284518828
435,1500000US130390101002,130390101002,"Block Group 2, Census Tract 101, Camden County, Georgia",1589,1575,14,0.881057268722
436,1500000US130390102001,130390102001,"Block Group 1, Census Tract 102, Camden County, Georgia",1137,1115,22,1.93491644679
437,1500000US130390102002,130390102002,"Block Group 2, Census Tract 102, Camden County, Georgia",1462,1354,108,7.38714090287
438,1500000US130390102003,130390102003,"Block Group 3, Census Tract 102, Camden County, Georgia",2515,2482,33,1.31212723658
439,1500000US130390103011,130390103011,"Block Group 1, Census Tract 103.01, Camden County, Georgia",1832,1814,18,0.982532751092
440,1500000US130390103012,130390103012,"Block Group 2, Census Tract 103.01, Camden County, Georgia",1871,1850,21,1.12239444148
441,1500000US130390103013,130390103013,"Block Group 3, Census Tract 103.01, Camden County, Georgia",3639,3610,29,0.796922231382
442,1500000US130390103014,130390103014,"Block Group 4, Census Tract 103.01, Camden County, Georgia",1039,1039,0,0.0
443,1500000US130390103021,130390103021,"Block Group 1, Census Tract 103.02, Camden County, Georgia",637,585,52,8.16326530612
444,1500000US130390103022,130390103022,"Block Group 2, Census Tract 103.02, Camden County, Georgia",2609,2490,119,4.5611345343
445,1500000US130390103023,130390103023,"Block Group 3, Census Tract 103.02, Camden County, Georgia",834,831,3,0.359712230216
446,1500000US130390104011,130390104011,"Block Group 1, Census Tract 104.01, Camden County, Georgia",5325,4957,368,6.91079812207
447,1500000US130390104012,130390104012,"Block Group 2, Census Tract 104.01, Camden County, Georgia",1317,1280,37,2.80941533789
448,1500000US130390104013,130390104013,"Block Group 3, Census Tract 104.01, Camden County, Georgia",5348,4769,579,10.8264771877
449,1500000US130390104021,130390104021,"Block Group 1, Census Tract 104.02, Camden County, Georgia",1484,1362,122,8.22102425876
450,1500000US130390104022,130390104022,"Block Group 2, Census Tract 104.02, Camden County, Georgia",3723,3070,653,17.5396185872
451,1500000US130390104031,130390104031,"Block Group 1, Census Tract 104.03, Camden County, Georgia",4094,4033,61,1.48998534441
452,1500000US130390105001,130390105001,"Block Group 1, Census Tract 105, Camden County, Georgia",2065,1642,423,20.4842615012
453,1500000US130390105002,130390105002,"Block Group 2, Census Tract 105, Camden County, Georgia",794,735,59,7.43073047859
454,1500000US130390106011,130390106011,"Block Group 1, Census Tract 106.01, Camden County, Georgia",1841,1680,161,8.74524714829
455,1500000US130390106012,130390106012,"Block Group 2, Census Tract 106.01, Camden County, Georgia",2028,2004,24,1.18343195266
456,1500000US130390106013,130390106013,"Block Group 3, Census Tract 106.01, Camden County, Georgia",2418,2418,0,0.0
457,1500000US130390106021,130390106021,"Block Group 1, Census Tract 106.02, Camden County, Georgia",888,794,94,10.5855855856
458,1500000US130399900000,130399900000,"Block Group 0, Census Tract 9900, Camden County, Georgia",0,0,0,
459,1500000US130439501001,130439501001,"Block Group 1, Census Tract 9501, Candler County, Georgia",1086,980,106,9.7605893186
460,1500000US130439501002,130439501002,"Block Group 2, Census Tract 9501, Candler County, Georgia",2206,2019,187,8.476881233
461,1500000US130439501003,130439501003,"Block Group 3, Census Tract 9501, Candler County, Georgia",1978,1770,208,10.5156723964
462,1500000US130439502001,130439502001,"Block Group 1, Census Tract 9502, Candler County, Georgia",1702,1463,239,14.0423031727
463,1500000US130439502002,130439502002,"Block Group 2, Census Tract 9502, Candler County, Georgia",1203,1147,56,4.65502909393
464,1500000US130439502003,130439502003,"Block Group 3, Census Tract 9502, Candler County, Georgia",678,638,40,5.89970501475
465,1500000US130439503001,130439503001,"Block Group 1, Census Tract 9503, Candler County, Georgia",1059,1002,57,5.38243626062
466,1500000US130439503002,130439503002,"Block Group 2, Census Tract 9503, Candler County, Georgia",1119,773,346,30.9204647006
467,1500000US130459101011,130459101011,"Block Group 1, Census Tract 9101.01, Carroll County, Georgia",4183,4115,68,1.62562754004
468,1500000US130459101012,130459101012,"Block Group 2, Census Tract 9101.01, Carroll County, Georgia",1785,1727,58,3.24929971989
469,1500000US130459101031,130459101031,"Block Group 1, Census Tract 9101.03, Carroll County, Georgia",2744,2468,276,10.0583090379
470,1500000US130459101032,130459101032,"Block Group 2, Census Tract 9101.03, Carroll County, Georgia",2188,2036,152,6.94698354662
471,1500000US130459101041,130459101041,"Block Group 1, Census Tract 9101.04, Carroll County, Georgia",1702,1485,217,12.749706228
472,1500000US130459101042,130459101042,"Block Group 2, Census Tract 9101.04, Carroll County, Georgia",5604,4985,619,11.045681656
473,1500000US130459101043,130459101043,"Block Group 3, Census Tract 9101.04, Carroll County, Georgia",1549,1537,12,0.774693350549
474,1500000US130459101044,130459101044,"Block Group 4, Census Tract 9101.04, Carroll County, Georgia",801,753,48,5.9925093633
475,1500000US130459102001,130459102001,"Block Group 1, Census Tract 9102, Carroll County, Georgia",2963,2925,38,1.28248396895
476,1500000US130459102002,130459102002,"Block Group 2, Census Tract 9102, Carroll County, Georgia",5624,5624,0,0.0
477,1500000US130459102003,130459102003,"Block Group 3, Census Tract 9102, Carroll County, Georgia",3576,3381,195,5.45302013423
478,1500000US130459103001,130459103001,"Block Group 1, Census Tract 9103, Carroll County, Georgia",1238,1238,0,0.0
479,1500000US130459103002,130459103002,"Block Group 2, Census Tract 9103, Carroll County, Georgia",3302,3018,284,8.60084797093
480,1500000US130459103003,130459103003,"Block Group 3, Census Tract 9103, Carroll County, Georgia",1329,1303,26,1.95635816403
481,1500000US130459104001,130459104001,"Block Group 1, Census Tract 9104, Carroll County, Georgia",1041,1041,0,0.0
482,1500000US130459104002,130459104002,"Block Group 2, Census Tract 9104, Carroll County, Georgia",1301,1283,18,1.38355111453
483,1500000US130459104003,130459104003,"Block Group 3, Census Tract 9104, Carroll County, Georgia",927,927,0,0.0
484,1500000US130459105011,130459105011,"Block Group 1, Census Tract 9105.01, Carroll County, Georgia",3690,3123,567,15.3658536585
485,1500000US130459105012,130459105012,"Block Group 2, Census Tract 9105.01, Carroll County, Georgia",3757,3623,134,3.56667553899
486,1500000US130459105013,130459105013,"Block Group 3, Census Tract 9105.01, Carroll County, Georgia",1125,1125,0,0.0
487,1500000US130459105014,130459105014,"Block Group 4, Census Tract 9105.01, Carroll County, Georgia",434,247,187,43.0875576037
488,1500000US130459105021,130459105021,"Block Group 1, Census Tract 9105.02, Carroll County, Georgia",1064,886,178,16.7293233083
489,1500000US130459105022,130459105022,"Block Group 2, Census Tract 9105.02, Carroll County, Georgia",1155,657,498,43.1168831169
490,1500000US130459105023,130459105023,"Block Group 3, Census Tract 9105.02, Carroll County, Georgia",787,643,144,18.2973316391
491,1500000US130459106001,130459106001,"Block Group 1, Census Tract 9106, Carroll County, Georgia",3638,3230,408,11.214953271
492,1500000US130459106002,130459106002,"Block Group 2, Census Tract 9106, Carroll County, Georgia",1543,1503,40,2.59235255995
493,1500000US130459106003,130459106003,"Block Group 3, Census Tract 9106, Carroll County, Georgia",819,576,243,29.6703296703
494,1500000US130459107011,130459107011,"Block Group 1, Census Tract 9107.01, Carroll County, Georgia",4128,3987,141,3.41569767442
495,1500000US130459107012,130459107012,"Block Group 2, Census Tract 9107.01, Carroll County, Georgia",1483,1312,171,11.5306810519
496,1500000US130459107013,130459107013,"Block Group 3, Census Tract 9107.01, Carroll County, Georgia",3040,2780,260,8.55263157895
497,1500000US130459107021,130459107021,"Block Group 1, Census Tract 9107.02, Carroll County, Georgia",2874,2673,201,6.99373695198
498,1500000US130459107022,130459107022,"Block Group 2, Census Tract 9107.02, Carroll County, Georgia",2319,2232,87,3.75161707633
499,1500000US130459107023,130459107023,"Block Group 3, Census Tract 9107.02, Carroll County, Georgia",2230,2213,17,0.762331838565
500,1500000US130459107031,130459107031,"Block Group 1, Census Tract 9107.03, Carroll County, Georgia",1997,1773,224,11.2168252379
501,1500000US130459107032,130459107032,"Block Group 2, Census Tract 9107.03, Carroll County, Georgia",998,998,0,0.0
502,1500000US130459107033,130459107033,"Block Group 3, Census Tract 9107.03, Carroll County, Georgia",3470,3316,154,4.43804034582
503,1500000US130459107034,130459107034,"Block Group 4, Census Tract 9107.03, Carroll County, Georgia",2405,2405,0,0.0
504,1500000US130459108001,130459108001,"Block Group 1, Census Tract 9108, Carroll County, Georgia",2007,1919,88,4.38465371201
505,1500000US130459108002,130459108002,"Block Group 2, Census Tract 9108, Carroll County, Georgia",2117,2056,61,2.88143599433
506,1500000US130459109001,130459109001,"Block Group 1, Census Tract 9109, Carroll County, Georgia",2005,1924,81,4.03990024938
507,1500000US130459109002,130459109002,"Block Group 2, Census Tract 9109, Carroll County, Georgia",2110,2086,24,1.13744075829
508,1500000US130459110001,130459110001,"Block Group 1, Census Tract 9110, Carroll County, Georgia",1452,1098,354,24.3801652893
509,1500000US130459110002,130459110002,"Block Group 2, Census Tract 9110, Carroll County, Georgia",3322,3068,254,7.64599638772
510,1500000US130459110003,130459110003,"Block Group 3, Census Tract 9110, Carroll County, Georgia",1383,1226,157,11.3521330441
511,1500000US130459111001,130459111001,"Block Group 1, Census Tract 9111, Carroll County, Georgia",1316,1316,0,0.0
512,1500000US130459111002,130459111002,"Block Group 2, Census Tract 9111, Carroll County, Georgia",2146,2006,140,6.52376514445
513,1500000US130459111003,130459111003,"Block Group 3, Census Tract 9111, Carroll County, Georgia",1008,997,11,1.09126984127
514,1500000US130459111004,130459111004,"Block Group 4, Census Tract 9111, Carroll County, Georgia",2352,1967,385,16.369047619
515,1500000US130459111005,130459111005,"Block Group 5, Census Tract 9111, Carroll County, Georgia",844,829,15,1.77725118483
516,1500000US130459112001,130459112001,"Block Group 1, Census Tract 9112, Carroll County, Georgia",1902,1902,0,0.0
517,1500000US130459112002,130459112002,"Block Group 2, Census Tract 9112, Carroll County, Georgia",1161,1134,27,2.32558139535
518,1500000US130459112003,130459112003,"Block Group 3, Census Tract 9112, Carroll County, Georgia",1407,1407,0,0.0
519,1500000US130459112004,130459112004,"Block Group 4, Census Tract 9112, Carroll County, Georgia",1250,1250,0,0.0
520,1500000US130470301001,130470301001,"Block Group 1, Census Tract 301, Catoosa County, Georgia",2667,2511,156,5.84926884139
521,1500000US130470301002,130470301002,"Block Group 2, Census Tract 301, Catoosa County, Georgia",565,525,40,7.0796460177
522,1500000US130470301003,130470301003,"Block Group 3, Census Tract 301, Catoosa County, Georgia",1322,1305,17,1.28593040847
523,1500000US130470301004,130470301004,"Block Group 4, Census Tract 301, Catoosa County, Georgia",1949,1949,0,0.0
524,1500000US130470302011,130470302011,"Block Group 1, Census Tract 302.01, Catoosa County, Georgia",1481,1451,30,2.02565833896
525,1500000US130470302012,130470302012,"Block Group 2, Census Tract 302.01, Catoosa County, Georgia",3089,3010,79,2.5574619618
526,1500000US130470302021,130470302021,"Block Group 1, Census Tract 302.02, Catoosa County, Georgia",1676,1676,0,0.0
527,1500000US130470302022,130470302022,"Block Group 2, Census Tract 302.02, Catoosa County, Georgia",1703,1703,0,0.0
528,1500000US130470302023,130470302023,"Block Group 3, Census Tract 302.02, Catoosa County, Georgia",2888,2822,66,2.28531855956
529,1500000US130470303011,130470303011,"Block Group 1, Census Tract 303.01, Catoosa County, Georgia",2300,2047,253,11.0
530,1500000US130470303012,130470303012,"Block Group 2, Census Tract 303.01, Catoosa County, Georgia",2385,2385,0,0.0
531,1500000US130470303013,130470303013,"Block Group 3, Census Tract 303.01, Catoosa County, Georgia",2841,2841,0,0.0
532,1500000US130470303031,130470303031,"Block Group 1, Census Tract 303.03, Catoosa County, Georgia",3175,3092,83,2.61417322835
533,1500000US130470303041,130470303041,"Block Group 1, Census Tract 303.04, Catoosa County, Georgia",3787,3763,24,0.633747029311
534,1500000US130470304011,130470304011,"Block Group 1, Census Tract 304.01, Catoosa County, Georgia",1589,1513,76,4.78288231592
535,1500000US130470304012,130470304012,"Block Group 2, Census Tract 304.01, Catoosa County, Georgia",3012,2959,53,1.75962815405
536,1500000US130470304013,130470304013,"Block Group 3, Census Tract 304.01, Catoosa County, Georgia",2428,2342,86,3.54200988468
537,1500000US130470304021,130470304021,"Block Group 1, Census Tract 304.02, Catoosa County, Georgia",1228,1058,170,13.8436482085
538,1500000US130470304022,130470304022,"Block Group 2, Census Tract 304.02, Catoosa County, Georgia",851,775,76,8.93066980024
539,1500000US130470304023,130470304023,"Block Group 3, Census Tract 304.02, Catoosa County, Georgia",2479,2479,0,0.0
540,1500000US130470304024,130470304024,"Block Group 4, Census Tract 304.02, Catoosa County, Georgia",1915,1828,87,4.54308093995
541,1500000US130470305001,130470305001,"Block Group 1, Census Tract 305, Catoosa County, Georgia",3705,3646,59,1.59244264507
542,1500000US130470305002,130470305002,"Block Group 2, Census Tract 305, Catoosa County, Georgia",805,805,0,0.0
543,1500000US130470305003,130470305003,"Block Group 3, Census Tract 305, Catoosa County, Georgia",1596,1596,0,0.0
544,1500000US130470306001,130470306001,"Block Group 1, Census Tract 306, Catoosa County, Georgia",674,648,26,3.85756676558
545,1500000US130470306002,130470306002,"Block Group 2, Census Tract 306, Catoosa County, Georgia",1667,1667,0,0.0
546,1500000US130470306003,130470306003,"Block Group 3, Census Tract 306, Catoosa County, Georgia",1282,1199,83,6.47425897036
547,1500000US130470306004,130470306004,"Block Group 4, Census Tract 306, Catoosa County, Georgia",905,783,122,13.4806629834
548,1500000US130470306005,130470306005,"Block Group 5, Census Tract 306, Catoosa County, Georgia",1112,1012,100,8.9928057554
549,1500000US130470307001,130470307001,"Block Group 1, Census Tract 307, Catoosa County, Georgia",2698,2612,86,3.18754633062
550,1500000US130470307002,130470307002,"Block Group 2, Census Tract 307, Catoosa County, Georgia",954,954,0,0.0
551,1500000US130470307003,130470307003,"Block Group 3, Census Tract 307, Catoosa County, Georgia",3053,3053,0,0.0
552,1500000US130470307004,130470307004,"Block Group 4, Census Tract 307, Catoosa County, Georgia",968,968,0,0.0
553,1500000US130470307005,130470307005,"Block Group 5, Census Tract 307, Catoosa County, Georgia",626,626,0,0.0
554,1500000US130490101001,130490101001,"Block Group 1, Census Tract 101, Charlton County, Georgia",1516,1498,18,1.18733509235
555,1500000US130490101002,130490101002,"Block Group 2, Census Tract 101, Charlton County, Georgia",2732,1662,1070,39.1654465593
556,1500000US130490101003,130490101003,"Block Group 3, Census Tract 101, Charlton County, Georgia",2244,2130,114,5.08021390374
557,1500000US130490101004,130490101004,"Block Group 4, Census Tract 101, Charlton County, Georgia",3285,3112,173,5.26636225266
558,1500000US130490102001,130490102001,"Block Group 1, Census Tract 102, Charlton County, Georgia",1647,1604,43,2.61080752884
559,1500000US130490102002,130490102002,"Block Group 2, Census Tract 102, Charlton County, Georgia",1706,1635,71,4.16178194607
560,1500000US130510001001,130510001001,"Block Group 1, Census Tract 1, Chatham County, Georgia",1916,1752,164,8.55949895616
561,1500000US130510003001,130510003001,"Block Group 1, Census Tract 3, Chatham County, Georgia",982,876,106,10.7942973523
562,1500000US130510003002,130510003002,"Block Group 2, Census Tract 3, Chatham County, Georgia",701,652,49,6.99001426534
563,1500000US130510006011,130510006011,"Block Group 1, Census Tract 6.01, Chatham County, Georgia",349,349,0,0.0
564,1500000US130510006012,130510006012,"Block Group 2, Census Tract 6.01, Chatham County, Georgia",481,481,0,0.0
565,1500000US130510006013,130510006013,"Block Group 3, Census Tract 6.01, Chatham County, Georgia",774,774,0,0.0
566,1500000US130510006014,130510006014,"Block Group 4, Census Tract 6.01, Chatham County, Georgia",1621,1440,181,11.1659469463
567,1500000US130510006015,130510006015,"Block Group 5, Census Tract 6.01, Chatham County, Georgia",995,995,0,0.0
568,1500000US130510009001,130510009001,"Block Group 1, Census Tract 9, Chatham County, Georgia",1171,1076,95,8.11272416738
569,1500000US130510011001,130510011001,"Block Group 1, Census Tract 11, Chatham County, Georgia",1080,1035,45,4.16666666667
570,1500000US130510011002,130510011002,"Block Group 2, Census Tract 11, Chatham County, Georgia",997,997,0,0.0
571,1500000US130510012001,130510012001,"Block Group 1, Census Tract 12, Chatham County, Georgia",1962,1947,15,0.764525993884
572,1500000US130510015001,130510015001,"Block Group 1, Census Tract 15, Chatham County, Georgia",1416,1226,190,13.418079096
573,1500000US130510020001,130510020001,"Block Group 1, Census Tract 20, Chatham County, Georgia",595,559,36,6.05042016807
574,1500000US130510020002,130510020002,"Block Group 2, Census Tract 20, Chatham County, Georgia",681,672,9,1.32158590308
575,1500000US130510021001,130510021001,"Block Group 1, Census Tract 21, Chatham County, Georgia",629,624,5,0.794912559618
576,1500000US130510021002,130510021002,"Block Group 2, Census Tract 21, Chatham County, Georgia",574,574,0,0.0
577,1500000US130510021003,130510021003,"Block Group 3, Census Tract 21, Chatham County, Georgia",948,948,0,0.0
578,1500000US130510022001,130510022001,"Block Group 1, Census Tract 22, Chatham County, Georgia",923,892,31,3.35861321777
579,1500000US130510022002,130510022002,"Block Group 2, Census Tract 22, Chatham County, Georgia",796,790,6,0.753768844221
580,1500000US130510022003,130510022003,"Block Group 3, Census Tract 22, Chatham County, Georgia",692,692,0,0.0
581,1500000US130510022004,130510022004,"Block Group 4, Census Tract 22, Chatham County, Georgia",970,970,0,0.0
582,1500000US130510022005,130510022005,"Block Group 5, Census Tract 22, Chatham County, Georgia",726,726,0,0.0
583,1500000US130510023001,130510023001,"Block Group 1, Census Tract 23, Chatham County, Georgia",1287,1287,0,0.0
584,1500000US130510023002,130510023002,"Block Group 2, Census Tract 23, Chatham County, Georgia",775,775,0,0.0
585,1500000US130510026001,130510026001,"Block Group 1, Census Tract 26, Chatham County, Georgia",788,779,9,1.1421319797
586,1500000US130510026002,130510026002,"Block Group 2, Census Tract 26, Chatham County, Georgia",781,774,7,0.89628681178
587,1500000US130510027001,130510027001,"Block Group 1, Census Tract 27, Chatham County, Georgia",534,534,0,0.0
588,1500000US130510027002,130510027002,"Block Group 2, Census Tract 27, Chatham County, Georgia",1332,1332,0,0.0
589,1500000US130510027003,130510027003,"Block Group 3, Census Tract 27, Chatham County, Georgia",696,660,36,5.1724137931
590,1500000US130510027004,130510027004,"Block Group 4, Census Tract 27, Chatham County, Georgia",406,406,0,0.0
591,1500000US130510028001,130510028001,"Block Group 1, Census Tract 28, Chatham County, Georgia",643,643,0,0.0
592,1500000US130510028002,130510028002,"Block Group 2, Census Tract 28, Chatham County, Georgia",570,570,0,0.0
593,1500000US130510028003,130510028003,"Block Group 3, Census Tract 28, Chatham County, Georgia",1248,1194,54,4.32692307692
594,1500000US130510029001,130510029001,"Block Group 1, Census Tract 29, Chatham County, Georgia",1083,1052,31,2.86241920591
595,1500000US130510029002,130510029002,"Block Group 2, Census Tract 29, Chatham County, Georgia",700,684,16,2.28571428571
596,1500000US130510029003,130510029003,"Block Group 3, Census Tract 29, Chatham County, Georgia",769,769,0,0.0
597,1500000US130510029004,130510029004,"Block Group 4, Census Tract 29, Chatham County, Georgia",601,569,32,5.32445923461
598,1500000US130510030001,130510030001,"Block Group 1, Census Tract 30, Chatham County, Georgia",541,484,57,10.5360443623
599,1500000US130510030002,130510030002,"Block Group 2, Census Tract 30, Chatham County, Georgia",1494,1385,109,7.29585006693
600,1500000US130510033011,130510033011,"Block Group 1, Census Tract 33.01, Chatham County, Georgia",1033,1024,9,0.871248789932
601,1500000US130510033012,130510033012,"Block Group 2, Census Tract 33.01, Chatham County, Georgia",971,971,0,0.0
602,1500000US130510033021,130510033021,"Block Group 1, Census Tract 33.02, Chatham County, Georgia",768,768,0,0.0
603,1500000US130510033022,130510033022,"Block Group 2, Census Tract 33.02, Chatham County, Georgia",891,891,0,0.0
604,1500000US130510034001,130510034001,"Block Group 1, Census Tract 34, Chatham County, Georgia",777,777,0,0.0
605,1500000US130510034002,130510034002,"Block Group 2, Census Tract 34, Chatham County, Georgia",714,714,0,0.0
606,1500000US130510034003,130510034003,"Block Group 3, Census Tract 34, Chatham County, Georgia",737,707,30,4.07055630936
607,1500000US130510034004,130510034004,"Block Group 4, Census Tract 34, Chatham County, Georgia",1293,1277,16,1.23743232792
608,1500000US130510034005,130510034005,"Block Group 5, Census Tract 34, Chatham County, Georgia",685,667,18,2.62773722628
609,1500000US130510035011,130510035011,"Block Group 1, Census Tract 35.01, Chatham County, Georgia",1052,1046,6,0.570342205323
610,1500000US130510035012,130510035012,"Block Group 2, Census Tract 35.01, Chatham County, Georgia",1152,1130,22,1.90972222222
611,1500000US130510035013,130510035013,"Block Group 3, Census Tract 35.01, Chatham County, Georgia",585,578,7,1.19658119658
612,1500000US130510035021,130510035021,"Block Group 1, Census Tract 35.02, Chatham County, Georgia",561,561,0,0.0
613,1500000US130510035022,130510035022,"Block Group 2, Census Tract 35.02, Chatham County, Georgia",1220,1220,0,0.0
614,1500000US130510035023,130510035023,"Block Group 3, Census Tract 35.02, Chatham County, Georgia",1107,1107,0,0.0
615,1500000US130510035024,130510035024,"Block Group 4, Census Tract 35.02, Chatham County, Georgia",1268,1246,22,1.73501577287
616,1500000US130510036011,130510036011,"Block Group 1, Census Tract 36.01, Chatham County, Georgia",2310,2134,176,7.61904761905
617,1500000US130510036012,130510036012,"Block Group 2, Census Tract 36.01, Chatham County, Georgia",713,713,0,0.0
618,1500000US130510036021,130510036021,"Block Group 1, Census Tract 36.02, Chatham County, Georgia",515,515,0,0.0
619,1500000US130510036022,130510036022,"Block Group 2, Census Tract 36.02, Chatham County, Georgia",1039,1010,29,2.79114533205
620,1500000US130510036023,130510036023,"Block Group 3, Census Tract 36.02, Chatham County, Georgia",806,788,18,2.23325062035
621,1500000US130510036024,130510036024,"Block Group 4, Census Tract 36.02, Chatham County, Georgia",858,764,94,10.9557109557
622,1500000US130510036025,130510036025,"Block Group 5, Census Tract 36.02, Chatham County, Georgia",1210,1210,0,0.0
623,1500000US130510037001,130510037001,"Block Group 1, Census Tract 37, Chatham County, Georgia",884,866,18,2.03619909502
624,1500000US130510037002,130510037002,"Block Group 2, Census Tract 37, Chatham County, Georgia",879,857,22,2.50284414107
625,1500000US130510038001,130510038001,"Block Group 1, Census Tract 38, Chatham County, Georgia",1214,1214,0,0.0
626,1500000US130510038002,130510038002,"Block Group 2, Census Tract 38, Chatham County, Georgia",1632,1588,44,2.69607843137
627,1500000US130510039001,130510039001,"Block Group 1, Census Tract 39, Chatham County, Georgia",783,770,13,1.66028097063
628,1500000US130510039002,130510039002,"Block Group 2, Census Tract 39, Chatham County, Georgia",765,765,0,0.0
629,1500000US130510039003,130510039003,"Block Group 3, Census Tract 39, Chatham County, Georgia",924,894,30,3.24675324675
630,1500000US130510039004,130510039004,"Block Group 4, Census Tract 39, Chatham County, Georgia",1202,1202,0,0.0
631,1500000US130510040011,130510040011,"Block Group 1, Census Tract 40.01, Chatham County, Georgia",735,735,0,0.0
632,1500000US130510040012,130510040012,"Block Group 2, Census Tract 40.01, Chatham County, Georgia",657,657,0,0.0
633,1500000US130510040013,130510040013,"Block Group 3, Census Tract 40.01, Chatham County, Georgia",1072,1027,45,4.19776119403
634,1500000US130510040014,130510040014,"Block Group 4, Census Tract 40.01, Chatham County, Georgia",842,820,22,2.61282660333
635,1500000US130510040015,130510040015,"Block Group 5, Census Tract 40.01, Chatham County, Georgia",957,913,44,4.59770114943
636,1500000US130510040021,130510040021,"Block Group 1, Census Tract 40.02, Chatham County, Georgia",896,871,25,2.79017857143
637,1500000US130510040022,130510040022,"Block Group 2, Census Tract 40.02, Chatham County, Georgia",1279,1268,11,0.86004691165
638,1500000US130510040023,130510040023,"Block Group 3, Census Tract 40.02, Chatham County, Georgia",711,608,103,14.4866385373
639,1500000US130510040024,130510040024,"Block Group 4, Census Tract 40.02, Chatham County, Georgia",841,742,99,11.7717003567
640,1500000US130510041001,130510041001,"Block Group 1, Census Tract 41, Chatham County, Georgia",1258,1235,23,1.82829888712
641,1500000US130510041002,130510041002,"Block Group 2, Census Tract 41, Chatham County, Georgia",575,549,26,4.52173913043
642,1500000US130510042071,130510042071,"Block Group 1, Census Tract 42.07, Chatham County, Georgia",2293,2250,43,1.87527256869
643,1500000US130510042072,130510042072,"Block Group 2, Census Tract 42.07, Chatham County, Georgia",1153,1143,10,0.867302688638
644,1500000US130510042073,130510042073,"Block Group 3, Census Tract 42.07, Chatham County, Georgia",187,187,0,0.0
645,1500000US130510042081,130510042081,"Block Group 1, Census Tract 42.08, Chatham County, Georgia",1308,1221,87,6.65137614679
646,1500000US130510042082,130510042082,"Block Group 2, Census Tract 42.08, Chatham County, Georgia",861,636,225,26.1324041812
647,1500000US130510042083,130510042083,"Block Group 3, Census Tract 42.08, Chatham County, Georgia",703,621,82,11.6642958748
648,1500000US130510042084,130510042084,"Block Group 4, Census Tract 42.08, Chatham County, Georgia",1245,1117,128,10.281124498
649,1500000US130510042085,130510042085,"Block Group 5, Census Tract 42.08, Chatham County, Georgia",1113,941,172,15.4537286613
650,1500000US130510042091,130510042091,"Block Group 1, Census Tract 42.09, Chatham County, Georgia",1537,1488,49,3.1880286272
651,1500000US130510042092,130510042092,"Block Group 2, Census Tract 42.09, Chatham County, Georgia",1280,1074,206,16.09375
652,1500000US130510042093,130510042093,"Block Group 3, Census Tract 42.09, Chatham County, Georgia",564,556,8,1.41843971631
653,1500000US130510042101,130510042101,"Block Group 1, Census Tract 42.10, Chatham County, Georgia",422,390,32,7.58293838863
654,1500000US130510042102,130510042102,"Block Group 2, Census Tract 42.10, Chatham County, Georgia",1637,1394,243,14.844227245
655,1500000US130510042103,130510042103,"Block Group 3, Census Tract 42.10, Chatham County, Georgia",1481,1313,168,11.3436866982
656,1500000US130510042104,130510042104,"Block Group 4, Census Tract 42.10, Chatham County, Georgia",1462,1436,26,1.77838577291
657,1500000US130510042111,130510042111,"Block Group 1, Census Tract 42.11, Chatham County, Georgia",796,779,17,2.13567839196
658,1500000US130510042112,130510042112,"Block Group 2, Census Tract 42.11, Chatham County, Georgia",1737,1567,170,9.7869890616
659,1500000US130510042113,130510042113,"Block Group 3, Census Tract 42.11, Chatham County, Georgia",1352,1323,29,2.1449704142
660,1500000US130510042114,130510042114,"Block Group 4, Census Tract 42.11, Chatham County, Georgia",1410,1394,16,1.13475177305
661,1500000US130510042121,130510042121,"Block Group 1, Census Tract 42.12, Chatham County, Georgia",3597,3363,234,6.50542118432
662,1500000US130510042122,130510042122,"Block Group 2, Census Tract 42.12, Chatham County, Georgia",1438,1293,145,10.083449235
663,1500000US130510042123,130510042123,"Block Group 3, Census Tract 42.12, Chatham County, Georgia",1204,1152,52,4.31893687708
664,1500000US130510043001,130510043001,"Block Group 1, Census Tract 43, Chatham County, Georgia",2711,2253,458,16.8941350055
665,1500000US130510044001,130510044001,"Block Group 1, Census Tract 44, Chatham County, Georgia",1232,1201,31,2.51623376623
666,1500000US130510044002,130510044002,"Block Group 2, Census Tract 44, Chatham County, Georgia",884,884,0,0.0
667,1500000US130510045001,130510045001,"Block Group 1, Census Tract 45, Chatham County, Georgia",556,556,0,0.0
668,1500000US130510045002,130510045002,"Block Group 2, Census Tract 45, Chatham County, Georgia",1026,960,66,6.43274853801
669,1500000US130510045003,130510045003,"Block Group 3, Census Tract 45, Chatham County, Georgia",1498,1498,0,0.0
670,1500000US130510045004,130510045004,"Block Group 4, Census Tract 45, Chatham County, Georgia",1177,1177,0,0.0
671,1500000US130510101011,130510101011,"Block Group 1, Census Tract 101.01, Chatham County, Georgia",553,553,0,0.0
672,1500000US130510101012,130510101012,"Block Group 2, Census Tract 101.01, Chatham County, Georgia",362,358,4,1.10497237569
673,1500000US130510101021,130510101021,"Block Group 1, Census Tract 101.02, Chatham County, Georgia",1021,823,198,19.3927522037
674,1500000US130510101022,130510101022,"Block Group 2, Census Tract 101.02, Chatham County, Georgia",1519,1506,13,0.855826201448
675,1500000US130510101023,130510101023,"Block Group 3, Census Tract 101.02, Chatham County, Georgia",1697,1659,38,2.23924572775
676,1500000US130510102001,130510102001,"Block Group 1, Census Tract 102, Chatham County, Georgia",1687,1687,0,0.0
677,1500000US130510102002,130510102002,"Block Group 2, Census Tract 102, Chatham County, Georgia",1686,1675,11,0.652431791222
678,1500000US130510102003,130510102003,"Block Group 3, Census Tract 102, Chatham County, Georgia",1481,1383,98,6.61715057394
679,1500000US130510105011,130510105011,"Block Group 1, Census Tract 105.01, Chatham County, Georgia",868,366,502,57.8341013825
680,1500000US130510105012,130510105012,"Block Group 2, Census Tract 105.01, Chatham County, Georgia",901,100,801,88.9012208657
681,1500000US130510105013,130510105013,"Block Group 3, Census Tract 105.01, Chatham County, Georgia",3246,2750,496,15.28034504
682,1500000US130510105014,130510105014,"Block Group 4, Census Tract 105.01, Chatham County, Georgia",536,536,0,0.0
683,1500000US130510105015,130510105015,"Block Group 5, Census Tract 105.01, Chatham County, Georgia",560,449,111,19.8214285714
684,1500000US130510105021,130510105021,"Block Group 1, Census Tract 105.02, Chatham County, Georgia",923,904,19,2.05850487541
685,1500000US130510105022,130510105022,"Block Group 2, Census Tract 105.02, Chatham County, Georgia",2674,2674,0,0.0
686,1500000US130510106011,130510106011,"Block Group 1, Census Tract 106.01, Chatham County, Georgia",349,349,0,0.0
687,1500000US130510106012,130510106012,"Block Group 2, Census Tract 106.01, Chatham County, Georgia",1017,973,44,4.32645034415
688,1500000US130510106013,130510106013,"Block Group 3, Census Tract 106.01, Chatham County, Georgia",429,377,52,12.1212121212
689,1500000US130510106014,130510106014,"Block Group 4, Census Tract 106.01, Chatham County, Georgia",784,784,0,0.0
690,1500000US130510106015,130510106015,"Block Group 5, Census Tract 106.01, Chatham County, Georgia",733,696,37,5.04774897681
691,1500000US130510106016,130510106016,"Block Group 6, Census Tract 106.01, Chatham County, Georgia",918,489,429,46.7320261438
692,1500000US130510106031,130510106031,"Block Group 1, Census Tract 106.03, Chatham County, Georgia",1869,1837,32,1.71214553237
693,1500000US130510106051,130510106051,"Block Group 1, Census Tract 106.05, Chatham County, Georgia",10,10,0,0.0
694,1500000US130510107001,130510107001,"Block Group 1, Census Tract 107, Chatham County, Georgia",19601,17889,1712,8.73424825264
695,1500000US130510107002,130510107002,"Block Group 2, Census Tract 107, Chatham County, Georgia",748,649,99,13.2352941176
696,1500000US130510107003,130510107003,"Block Group 3, Census Tract 107, Chatham County, Georgia",683,683,0,0.0
697,1500000US130510108011,130510108011,"Block Group 1, Census Tract 108.01, Chatham County, Georgia",1340,1297,43,3.20895522388
698,1500000US130510108012,130510108012,"Block Group 2, Census Tract 108.01, Chatham County, Georgia",1313,1236,77,5.86443259711
699,1500000US130510108021,130510108021,"Block Group 1, Census Tract 108.02, Chatham County, Georgia",7320,6974,346,4.72677595628
700,1500000US130510108022,130510108022,"Block Group 2, Census Tract 108.02, Chatham County, Georgia",2052,2040,12,0.584795321637
701,1500000US130510108031,130510108031,"Block Group 1, Census Tract 108.03, Chatham County, Georgia",1284,1284,0,0.0
702,1500000US130510108032,130510108032,"Block Group 2, Census Tract 108.03, Chatham County, Georgia",826,826,0,0.0
703,1500000US130510108033,130510108033,"Block Group 3, Census Tract 108.03, Chatham County, Georgia",4337,3946,391,9.01544846668
704,1500000US130510108034,130510108034,"Block Group 4, Census Tract 108.03, Chatham County, Georgia",4768,4692,76,1.59395973154
705,1500000US130510108061,130510108061,"Block Group 1, Census Tract 108.06, Chatham County, Georgia",2010,1964,46,2.28855721393
706,1500000US130510108062,130510108062,"Block Group 2, Census Tract 108.06, Chatham County, Georgia",702,650,52,7.40740740741
707,1500000US130510108063,130510108063,"Block Group 3, Census Tract 108.06, Chatham County, Georgia",1330,1221,109,8.1954887218
708,1500000US130510108064,130510108064,"Block Group 4, Census Tract 108.06, Chatham County, Georgia",2342,2135,207,8.83859948762
709,1500000US130510108071,130510108071,"Block Group 1, Census Tract 108.07, Chatham County, Georgia",2707,2463,244,9.01366826745
710,1500000US130510108072,130510108072,"Block Group 2, Census Tract 108.07, Chatham County, Georgia",299,299,0,0.0
711,1500000US130510108073,130510108073,"Block Group 3, Census Tract 108.07, Chatham County, Georgia",1959,1759,200,10.2092904543
712,1500000US130510108081,130510108081,"Block Group 1, Census Tract 108.08, Chatham County, Georgia",3843,3395,448,11.6575591985
713,1500000US130510108082,130510108082,"Block Group 2, Census Tract 108.08, Chatham County, Georgia",1294,670,624,48.2225656878
714,1500000US130510108083,130510108083,"Block Group 3, Census Tract 108.08, Chatham County, Georgia",2249,1810,439,19.5197865718
715,1500000US130510108084,130510108084,"Block Group 4, Census Tract 108.08, Chatham County, Georgia",3335,3027,308,9.23538230885
716,1500000US130510108091,130510108091,"Block Group 1, Census Tract 108.09, Chatham County, Georgia",4719,4362,357,7.56516211062
717,1500000US130510108092,130510108092,"Block Group 2, Census Tract 108.09, Chatham County, Georgia",7075,6777,298,4.21201413428
718,1500000US130510109011,130510109011,"Block Group 1, Census Tract 109.01, Chatham County, Georgia",1946,1483,463,23.7923946557
719,1500000US130510109012,130510109012,"Block Group 2, Census Tract 109.01, Chatham County, Georgia",1526,1262,264,17.3001310616
720,1500000US130510109013,130510109013,"Block Group 3, Census Tract 109.01, Chatham County, Georgia",809,806,3,0.370828182942
721,1500000US130510110031,130510110031,"Block Group 1, Census Tract 110.03, Chatham County, Georgia",2042,1888,154,7.541625857
722,1500000US130510110032,130510110032,"Block Group 2, Census Tract 110.03, Chatham County, Georgia",1343,1081,262,19.5085629188
723,1500000US130510110033,130510110033,"Block Group 3, Census Tract 110.03, Chatham County, Georgia",1649,1649,0,0.0
724,1500000US130510110034,130510110034,"Block Group 4, Census Tract 110.03, Chatham County, Georgia",643,555,88,13.6858475894
725,1500000US130510110035,130510110035,"Block Group 5, Census Tract 110.03, Chatham County, Georgia",909,909,0,0.0
726,1500000US130510110041,130510110041,"Block Group 1, Census Tract 110.04, Chatham County, Georgia",1729,1701,28,1.61943319838
727,1500000US130510110042,130510110042,"Block Group 2, Census Tract 110.04, Chatham County, Georgia",1019,1019,0,0.0
728,1500000US130510110043,130510110043,"Block Group 3, Census Tract 110.04, Chatham County, Georgia",756,745,11,1.45502645503
729,1500000US130510110051,130510110051,"Block Group 1, Census Tract 110.05, Chatham County, Georgia",684,659,25,3.65497076023
730,1500000US130510110052,130510110052,"Block Group 2, Census Tract 110.05, Chatham County, Georgia",1071,1071,0,0.0
731,1500000US130510110053,130510110053,"Block Group 3, Census Tract 110.05, Chatham County, Georgia",1156,1129,27,2.33564013841
732,1500000US130510110054,130510110054,"Block Group 4, Census Tract 110.05, Chatham County, Georgia",1597,1542,55,3.44395742016
733,1500000US130510110061,130510110061,"Block Group 1, Census Tract 110.06, Chatham County, Georgia",1188,1162,26,2.18855218855
734,1500000US130510110062,130510110062,"Block Group 2, Census Tract 110.06, Chatham County, Georgia",2417,2360,57,2.35829540753
735,1500000US130510111031,130510111031,"Block Group 1, Census Tract 111.03, Chatham County, Georgia",825,816,9,1.09090909091
736,1500000US130510111032,130510111032,"Block Group 2, Census Tract 111.03, Chatham County, Georgia",841,841,0,0.0
737,1500000US130510111033,130510111033,"Block Group 3, Census Tract 111.03, Chatham County, Georgia",809,809,0,0.0
738,1500000US130510111034,130510111034,"Block Group 4, Census Tract 111.03, Chatham County, Georgia",918,918,0,0.0
739,1500000US130510111041,130510111041,"Block Group 1, Census Tract 111.04, Chatham County, Georgia",1560,1560,0,0.0
740,1500000US130510111042,130510111042,"Block Group 2, Census Tract 111.04, Chatham County, Georgia",2562,2503,59,2.30288836846
741,1500000US130510111043,130510111043,"Block Group 3, Census Tract 111.04, Chatham County, Georgia",836,836,0,0.0
742,1500000US130510111061,130510111061,"Block Group 1, Census Tract 111.06, Chatham County, Georgia",2597,2524,73,2.81093569503
743,1500000US130510111062,130510111062,"Block Group 2, Census Tract 111.06, Chatham County, Georgia",3197,3060,137,4.28526743822
744,1500000US130510111071,130510111071,"Block Group 1, Census Tract 111.07, Chatham County, Georgia",662,602,60,9.06344410876
745,1500000US130510111072,130510111072,"Block Group 2, Census Tract 111.07, Chatham County, Georgia",1237,1210,27,2.18270008084
746,1500000US130510111073,130510111073,"Block Group 3, Census Tract 111.07, Chatham County, Georgia",1175,1168,7,0.595744680851
747,1500000US130510111081,130510111081,"Block Group 1, Census Tract 111.08, Chatham County, Georgia",1493,1466,27,1.80843938379
748,1500000US130510111082,130510111082,"Block Group 2, Census Tract 111.08, Chatham County, Georgia",1511,1503,8,0.529450694904
749,1500000US130510111091,130510111091,"Block Group 1, Census Tract 111.09, Chatham County, Georgia",2143,2109,34,1.58656089594
750,1500000US130510111092,130510111092,"Block Group 2, Census Tract 111.09, Chatham County, Georgia",3031,2873,158,5.21280105576
751,1500000US130510111093,130510111093,"Block Group 3, Census Tract 111.09, Chatham County, Georgia",962,912,50,5.19750519751
752,1500000US130510111094,130510111094,"Block Group 4, Census Tract 111.09, Chatham County, Georgia",683,683,0,0.0
753,1500000US130510112001,130510112001,"Block Group 1, Census Tract 112, Chatham County, Georgia",911,873,38,4.17124039517
754,1500000US130510112002,130510112002,"Block Group 2, Census Tract 112, Chatham County, Georgia",846,788,58,6.85579196217
755,1500000US130510113001,130510113001,"Block Group 1, Census Tract 113, Chatham County, Georgia",1181,1168,13,1.10076206605
756,1500000US130510113002,130510113002,"Block Group 2, Census Tract 113, Chatham County, Georgia",1284,1238,46,3.58255451713
757,1500000US130510114001,130510114001,"Block Group 1, Census Tract 114, Chatham County, Georgia",1262,1176,86,6.8145800317
758,1500000US130510114002,130510114002,"Block Group 2, Census Tract 114, Chatham County, Georgia",823,807,16,1.94410692588
759,1500000US130510115001,130510115001,"Block Group 1, Census Tract 115, Chatham County, Georgia",1123,1102,21,1.86999109528
760,1500000US130510115002,130510115002,"Block Group 2, Census Tract 115, Chatham County, Georgia",1469,1456,13,0.884955752212
761,1500000US130510116001,130510116001,"Block Group 1, Census Tract 116, Chatham County, Georgia",1028,1028,0,0.0
762,1500000US130510116002,130510116002,"Block Group 2, Census Tract 116, Chatham County, Georgia",1416,1129,287,20.2683615819
763,1500000US130519800001,130519800001,"Block Group 1, Census Tract 9800, Chatham County, Georgia",0,0,0,
764,1500000US130519900000,130519900000,"Block Group 0, Census Tract 9900, Chatham County, Georgia",0,0,0,
765,1500000US130530201001,130530201001,"Block Group 1, Census Tract 201, Chattahoochee County, Georgia",1600,1567,33,2.0625
766,1500000US130530201002,130530201002,"Block Group 2, Census Tract 201, Chattahoochee County, Georgia",948,948,0,0.0
767,1500000US130530202011,130530202011,"Block Group 1, Census Tract 202.01, Chattahoochee County, Georgia",3071,2547,524,17.0628459785
768,1500000US130530202012,130530202012,"Block Group 2, Census Tract 202.01, Chattahoochee County, Georgia",750,642,108,14.4
769,1500000US130530202031,130530202031,"Block Group 1, Census Tract 202.03, Chattahoochee County, Georgia",1972,1541,431,21.8559837728
770,1500000US130530202032,130530202032,"Block Group 2, Census Tract 202.03, Chattahoochee County, Georgia",210,196,14,6.66666666667
771,1500000US130530202051,130530202051,"Block Group 1, Census Tract 202.05, Chattahoochee County, Georgia",1341,1037,304,22.6696495153
772,1500000US130530202052,130530202052,"Block Group 2, Census Tract 202.05, Chattahoochee County, Georgia",458,320,138,30.1310043668
773,1500000US130530202053,130530202053,"Block Group 3, Census Tract 202.05, Chattahoochee County, Georgia",1039,914,125,12.030798845
774,1500000US130530202061,130530202061,"Block Group 1, Census Tract 202.06, Chattahoochee County, Georgia",525,421,104,19.8095238095
775,1500000US130550101001,130550101001,"Block Group 1, Census Tract 101, Chattooga County, Georgia",756,747,9,1.19047619048
776,1500000US130550101002,130550101002,"Block Group 2, Census Tract 101, Chattooga County, Georgia",1233,1218,15,1.21654501217
777,1500000US130550102001,130550102001,"Block Group 1, Census Tract 102, Chattooga County, Georgia",809,745,64,7.91100123609
778,1500000US130550102002,130550102002,"Block Group 2, Census Tract 102, Chattooga County, Georgia",989,817,172,17.3913043478
779,1500000US130550102003,130550102003,"Block Group 3, Census Tract 102, Chattooga County, Georgia",862,806,56,6.49651972158
780,1500000US130550102004,130550102004,"Block Group 4, Census Tract 102, Chattooga County, Georgia",1519,1434,85,5.59578670178
781,1500000US130550102005,130550102005,"Block Group 5, Census Tract 102, Chattooga County, Georgia",1170,723,447,38.2051282051
782,1500000US130550102006,130550102006,"Block Group 6, Census Tract 102, Chattooga County, Georgia",978,978,0,0.0
783,1500000US130550103001,130550103001,"Block Group 1, Census Tract 103, Chattooga County, Georgia",919,906,13,1.41458106638
784,1500000US130550103002,130550103002,"Block Group 2, Census Tract 103, Chattooga County, Georgia",1074,1074,0,0.0
785,1500000US130550103003,130550103003,"Block Group 3, Census Tract 103, Chattooga County, Georgia",934,934,0,0.0
786,1500000US130550104001,130550104001,"Block Group 1, Census Tract 104, Chattooga County, Georgia",2421,2421,0,0.0
787,1500000US130550104002,130550104002,"Block Group 2, Census Tract 104, Chattooga County, Georgia",1358,1358,0,0.0
788,1500000US130550104003,130550104003,"Block Group 3, Census Tract 104, Chattooga County, Georgia",968,968,0,0.0
789,1500000US130550104004,130550104004,"Block Group 4, Census Tract 104, Chattooga County, Georgia",644,644,0,0.0
790,1500000US130550105001,130550105001,"Block Group 1, Census Tract 105, Chattooga County, Georgia",978,978,0,0.0
791,1500000US130550105002,130550105002,"Block Group 2, Census Tract 105, Chattooga County, Georgia",2664,2481,183,6.86936936937
792,1500000US130550105003,130550105003,"Block Group 3, Census Tract 105, Chattooga County, Georgia",716,686,30,4.18994413408
793,1500000US130550105004,130550105004,"Block Group 4, Census Tract 105, Chattooga County, Georgia",854,854,0,0.0
794,1500000US130550105005,130550105005,"Block Group 5, Census Tract 105, Chattooga County, Georgia",879,879,0,0.0
795,1500000US130550106001,130550106001,"Block Group 1, Census Tract 106, Chattooga County, Georgia",1477,1382,95,6.43195666892
796,1500000US130550106002,130550106002,"Block Group 2, Census Tract 106, Chattooga County, Georgia",1039,1038,1,0.0962463907603
797,1500000US130570901001,130570901001,"Block Group 1, Census Tract 901, Cherokee County, Georgia",999,754,245,24.5245245245
798,1500000US130570901002,130570901002,"Block Group 2, Census Tract 901, Cherokee County, Georgia",2904,2861,43,1.48071625344
799,1500000US130570901003,130570901003,"Block Group 3, Census Tract 901, Cherokee County, Georgia",1649,1637,12,0.727713765919
800,1500000US130570901004,130570901004,"Block Group 4, Census Tract 901, Cherokee County, Georgia",3378,3378,0,0.0
801,1500000US130570902001,130570902001,"Block Group 1, Census Tract 902, Cherokee County, Georgia",2037,2011,26,1.2763868434
802,1500000US130570902002,130570902002,"Block Group 2, Census Tract 902, Cherokee County, Georgia",3132,3033,99,3.16091954023
803,1500000US130570902003,130570902003,"Block Group 3, Census Tract 902, Cherokee County, Georgia",2926,2926,0,0.0
804,1500000US130570903001,130570903001,"Block Group 1, Census Tract 903, Cherokee County, Georgia",5057,4788,269,5.31935930394
805,1500000US130570903002,130570903002,"Block Group 2, Census Tract 903, Cherokee County, Georgia",7346,7147,199,2.70895725565
806,1500000US130570904001,130570904001,"Block Group 1, Census Tract 904, Cherokee County, Georgia",1121,1068,53,4.72792149866
807,1500000US130570904002,130570904002,"Block Group 2, Census Tract 904, Cherokee County, Georgia",4952,3932,1020,20.5977382876
808,1500000US130570904003,130570904003,"Block Group 3, Census Tract 904, Cherokee County, Georgia",3763,2731,1032,27.42492692
809,1500000US130570905011,130570905011,"Block Group 1, Census Tract 905.01, Cherokee County, Georgia",1774,1774,0,0.0
810,1500000US130570905012,130570905012,"Block Group 2, Census Tract 905.01, Cherokee County, Georgia",4499,4353,146,3.24516559235
811,1500000US130570905021,130570905021,"Block Group 1, Census Tract 905.02, Cherokee County, Georgia",7259,6427,832,11.4616338339
812,1500000US130570905022,130570905022,"Block Group 2, Census Tract 905.02, Cherokee County, Georgia",1932,1734,198,10.248447205
813,1500000US130570905023,130570905023,"Block Group 3, Census Tract 905.02, Cherokee County, Georgia",3282,2571,711,21.6636197441
814,1500000US130570905024,130570905024,"Block Group 4, Census Tract 905.02, Cherokee County, Georgia",1470,1470,0,0.0
815,1500000US130570906011,130570906011,"Block Group 1, Census Tract 906.01, Cherokee County, Georgia",1408,1213,195,13.8494318182
816,1500000US130570906012,130570906012,"Block Group 2, Census Tract 906.01, Cherokee County, Georgia",4152,3396,756,18.2080924855
817,1500000US130570906013,130570906013,"Block Group 3, Census Tract 906.01, Cherokee County, Georgia",2037,610,1427,70.0540009818
818,1500000US130570906021,130570906021,"Block Group 1, Census Tract 906.02, Cherokee County, Georgia",5100,4383,717,14.0588235294
819,1500000US130570906022,130570906022,"Block Group 2, Census Tract 906.02, Cherokee County, Georgia",1809,1583,226,12.493090105
820,1500000US130570906023,130570906023,"Block Group 3, Census Tract 906.02, Cherokee County, Georgia",1468,888,580,39.5095367847
821,1500000US130570907011,130570907011,"Block Group 1, Census Tract 907.01, Cherokee County, Georgia",4068,3756,312,7.66961651917
822,1500000US130570907012,130570907012,"Block Group 2, Census Tract 907.01, Cherokee County, Georgia",2082,2055,27,1.29682997118
823,1500000US130570907013,130570907013,"Block Group 3, Census Tract 907.01, Cherokee County, Georgia",5284,5284,0,0.0
824,1500000US130570907014,130570907014,"Block Group 4, Census Tract 907.01, Cherokee County, Georgia",7376,6494,882,11.9577006508
825,1500000US130570907021,130570907021,"Block Group 1, Census Tract 907.02, Cherokee County, Georgia",2742,2266,476,17.359591539
826,1500000US130570907022,130570907022,"Block Group 2, Census Tract 907.02, Cherokee County, Georgia",1229,1018,211,17.1684296176
827,1500000US130570907023,130570907023,"Block Group 3, Census Tract 907.02, Cherokee County, Georgia",2197,1930,267,12.1529358216
828,1500000US130570907024,130570907024,"Block Group 4, Census Tract 907.02, Cherokee County, Georgia",1520,1520,0,0.0
829,1500000US130570908021,130570908021,"Block Group 1, Census Tract 908.02, Cherokee County, Georgia",1996,1736,260,13.0260521042
830,1500000US130570908022,130570908022,"Block Group 2, Census Tract 908.02, Cherokee County, Georgia",1949,1885,64,3.28373524885
831,1500000US130570908023,130570908023,"Block Group 3, Census Tract 908.02, Cherokee County, Georgia",2983,2917,66,2.21253771371
832,1500000US130570908031,130570908031,"Block Group 1, Census Tract 908.03, Cherokee County, Georgia",5678,5456,222,3.90982740402
833,1500000US130570908032,130570908032,"Block Group 2, Census Tract 908.03, Cherokee County, Georgia",2276,2214,62,2.72407732865
834,1500000US130570908033,130570908033,"Block Group 3, Census Tract 908.03, Cherokee County, Georgia",2301,2129,172,7.47501086484
835,1500000US130570908041,130570908041,"Block Group 1, Census Tract 908.04, Cherokee County, Georgia",3220,3204,16,0.496894409938
836,1500000US130570908042,130570908042,"Block Group 2, Census Tract 908.04, Cherokee County, Georgia",4687,4284,403,8.59825048005
837,1500000US130570908043,130570908043,"Block Group 3, Census Tract 908.04, Cherokee County, Georgia",1568,1348,220,14.0306122449
838,1500000US130570909011,130570909011,"Block Group 1, Census Tract 909.01, Cherokee County, Georgia",2676,2332,344,12.8550074738
839,1500000US130570909012,130570909012,"Block Group 2, Census Tract 909.01, Cherokee County, Georgia",3420,3140,280,8.18713450292
840,1500000US130570909013,130570909013,"Block Group 3, Census Tract 909.01, Cherokee County, Georgia",1697,1697,0,0.0
841,1500000US130570909021,130570909021,"Block Group 1, Census Tract 909.02, Cherokee County, Georgia",1603,1466,137,8.5464753587
842,1500000US130570909022,130570909022,"Block Group 2, Census Tract 909.02, Cherokee County, Georgia",2418,2015,403,16.6666666667
843,1500000US130570909023,130570909023,"Block Group 3, Census Tract 909.02, Cherokee County, Georgia",6168,5861,307,4.97730220493
844,1500000US130570909024,130570909024,"Block Group 4, Census Tract 909.02, Cherokee County, Georgia",2281,2087,194,8.5050416484
845,1500000US130570909025,130570909025,"Block Group 5, Census Tract 909.02, Cherokee County, Georgia",1969,1847,122,6.19603859827
846,1500000US130570909041,130570909041,"Block Group 1, Census Tract 909.04, Cherokee County, Georgia",3010,2632,378,12.5581395349
847,1500000US130570909042,130570909042,"Block Group 2, Census Tract 909.04, Cherokee County, Georgia",1642,992,650,39.5858708892
848,1500000US130570909043,130570909043,"Block Group 3, Census Tract 909.04, Cherokee County, Georgia",2562,2067,495,19.3208430913
849,1500000US130570909044,130570909044,"Block Group 4, Census Tract 909.04, Cherokee County, Georgia",1427,1406,21,1.47161878066
850,1500000US130570909051,130570909051,"Block Group 1, Census Tract 909.05, Cherokee County, Georgia",2048,1813,235,11.474609375
851,1500000US130570909052,130570909052,"Block Group 2, Census Tract 909.05, Cherokee County, Georgia",1524,1435,89,5.83989501312
852,1500000US130570910011,130570910011,"Block Group 1, Census Tract 910.01, Cherokee County, Georgia",802,658,144,17.9551122195
853,1500000US130570910012,130570910012,"Block Group 2, Census Tract 910.01, Cherokee County, Georgia",791,521,270,34.1340075853
854,1500000US130570910013,130570910013,"Block Group 3, Census Tract 910.01, Cherokee County, Georgia",2704,2674,30,1.10946745562
855,1500000US130570910031,130570910031,"Block Group 1, Census Tract 910.03, Cherokee County, Georgia",3000,2710,290,9.66666666667
856,1500000US130570910032,130570910032,"Block Group 2, Census Tract 910.03, Cherokee County, Georgia",1585,1001,584,36.8454258675
857,1500000US130570910033,130570910033,"Block Group 3, Census Tract 910.03, Cherokee County, Georgia",2662,2371,291,10.9316303531
858,1500000US130570910051,130570910051,"Block Group 1, Census Tract 910.05, Cherokee County, Georgia",2935,1466,1469,50.0511073254
859,1500000US130570910052,130570910052,"Block Group 2, Census Tract 910.05, Cherokee County, Georgia",779,779,0,0.0
860,1500000US130570910053,130570910053,"Block Group 3, Census Tract 910.05, Cherokee County, Georgia",2472,2319,153,6.18932038835
861,1500000US130570910054,130570910054,"Block Group 4, Census Tract 910.05, Cherokee County, Georgia",1833,1833,0,0.0
862,1500000US130570910061,130570910061,"Block Group 1, Census Tract 910.06, Cherokee County, Georgia",2345,2191,154,6.5671641791
863,1500000US130570910062,130570910062,"Block Group 2, Census Tract 910.06, Cherokee County, Georgia",2549,2450,99,3.88387602982
864,1500000US130570910071,130570910071,"Block Group 1, Census Tract 910.07, Cherokee County, Georgia",2091,1926,165,7.89096126255
865,1500000US130570910072,130570910072,"Block Group 2, Census Tract 910.07, Cherokee County, Georgia",2852,2701,151,5.29453015428
866,1500000US130570910073,130570910073,"Block Group 3, Census Tract 910.07, Cherokee County, Georgia",1657,1657,0,0.0
867,1500000US130570910081,130570910081,"Block Group 1, Census Tract 910.08, Cherokee County, Georgia",1174,1170,4,0.340715502555
868,1500000US130570910082,130570910082,"Block Group 2, Census Tract 910.08, Cherokee County, Georgia",1248,1241,7,0.560897435897
869,1500000US130570910083,130570910083,"Block Group 3, Census Tract 910.08, Cherokee County, Georgia",1876,1856,20,1.06609808102
870,1500000US130570910084,130570910084,"Block Group 4, Census Tract 910.08, Cherokee County, Georgia",3894,3662,232,5.95788392399
871,1500000US130570911011,130570911011,"Block Group 1, Census Tract 911.01, Cherokee County, Georgia",1871,1839,32,1.71031533939
872,1500000US130570911012,130570911012,"Block Group 2, Census Tract 911.01, Cherokee County, Georgia",1961,1895,66,3.36562978072
873,1500000US130570911013,130570911013,"Block Group 3, Census Tract 911.01, Cherokee County, Georgia",2164,2164,0,0.0
874,1500000US130570911021,130570911021,"Block Group 1, Census Tract 911.02, Cherokee County, Georgia",1965,1692,273,13.893129771
875,1500000US130570911022,130570911022,"Block Group 2, Census Tract 911.02, Cherokee County, Georgia",3188,2968,220,6.9008782936
876,1500000US130570911023,130570911023,"Block Group 3, Census Tract 911.02, Cherokee County, Georgia",1830,1657,173,9.45355191257
877,1500000US130570911024,130570911024,"Block Group 4, Census Tract 911.02, Cherokee County, Georgia",2004,1202,802,40.0199600798
878,1500000US130570911031,130570911031,"Block Group 1, Census Tract 911.03, Cherokee County, Georgia",2168,1926,242,11.1623616236
879,1500000US130570911032,130570911032,"Block Group 2, Census Tract 911.03, Cherokee County, Georgia",2699,2401,298,11.0411263431
880,1500000US130570911033,130570911033,"Block Group 3, Census Tract 911.03, Cherokee County, Georgia",1395,1395,0,0.0
881,1500000US130570911034,130570911034,"Block Group 4, Census Tract 911.03, Cherokee County, Georgia",2395,2233,162,6.76409185804
882,1500000US130590001001,130590001001,"Block Group 1, Census Tract 1, Clarke County, Georgia",1796,1753,43,2.39420935412
883,1500000US130590004011,130590004011,"Block Group 1, Census Tract 4.01, Clarke County, Georgia",1385,1356,29,2.09386281588
884,1500000US130590004021,130590004021,"Block Group 1, Census Tract 4.02, Clarke County, Georgia",1972,1882,90,4.56389452333
885,1500000US130590004022,130590004022,"Block Group 2, Census Tract 4.02, Clarke County, Georgia",3271,3143,128,3.91317639865
886,1500000US130590004023,130590004023,"Block Group 3, Census Tract 4.02, Clarke County, Georgia",2518,2378,140,5.55996822875
887,1500000US130590006001,130590006001,"Block Group 1, Census Tract 6, Clarke County, Georgia",991,952,39,3.93541876892
888,1500000US130590006002,130590006002,"Block Group 2, Census Tract 6, Clarke County, Georgia",2002,1782,220,10.989010989
889,1500000US130590009001,130590009001,"Block Group 1, Census Tract 9, Clarke County, Georgia",993,918,75,7.55287009063
890,1500000US130590009002,130590009002,"Block Group 2, Census Tract 9, Clarke County, Georgia",1268,1196,72,5.67823343849
891,1500000US130590009003,130590009003,"Block Group 3, Census Tract 9, Clarke County, Georgia",1029,1029,0,0.0
892,1500000US130590012001,130590012001,"Block Group 1, Census Tract 12, Clarke County, Georgia",2002,1899,103,5.14485514486
893,1500000US130590012002,130590012002,"Block Group 2, Census Tract 12, Clarke County, Georgia",1067,1065,2,0.187441424555
894,1500000US130590017001,130590017001,"Block Group 1, Census Tract 17, Clarke County, Georgia",2120,2050,70,3.30188679245
895,1500000US130590018001,130590018001,"Block Group 1, Census Tract 18, Clarke County, Georgia",1088,1088,0,0.0
896,1500000US130590018002,130590018002,"Block Group 2, Census Tract 18, Clarke County, Georgia",211,203,8,3.79146919431
897,1500000US130590018003,130590018003,"Block Group 3, Census Tract 18, Clarke County, Georgia",1094,1006,88,8.04387568556
898,1500000US130590019001,130590019001,"Block Group 1, Census Tract 19, Clarke County, Georgia",2111,2036,75,3.5528185694
899,1500000US130590019002,130590019002,"Block Group 2, Census Tract 19, Clarke County, Georgia",2066,1899,167,8.08325266215
900,1500000US130590020001,130590020001,"Block Group 1, Census Tract 20, Clarke County, Georgia",999,970,29,2.9029029029
901,1500000US130590020002,130590020002,"Block Group 2, Census Tract 20, Clarke County, Georgia",1081,1081,0,0.0
902,1500000US130590021001,130590021001,"Block Group 1, Census Tract 21, Clarke County, Georgia",2579,2470,109,4.22644435828
903,1500000US130590021002,130590021002,"Block Group 2, Census Tract 21, Clarke County, Georgia",1481,1481,0,0.0
904,1500000US130590022001,130590022001,"Block Group 1, Census Tract 22, Clarke County, Georgia",1064,1016,48,4.51127819549
905,1500000US130590022002,130590022002,"Block Group 2, Census Tract 22, Clarke County, Georgia",1210,1147,63,5.20661157025
906,1500000US130590301001,130590301001,"Block Group 1, Census Tract 301, Clarke County, Georgia",1902,1881,21,1.10410094637
907,1500000US130590301002,130590301002,"Block Group 2, Census Tract 301, Clarke County, Georgia",3006,2960,46,1.53027278776
908,1500000US130590302001,130590302001,"Block Group 1, Census Tract 302, Clarke County, Georgia",1011,964,47,4.64886251236
909,1500000US130590302002,130590302002,"Block Group 2, Census Tract 302, Clarke County, Georgia",1230,1048,182,14.7967479675
910,1500000US130590302003,130590302003,"Block Group 3, Census Tract 302, Clarke County, Georgia",2517,2517,0,0.0
911,1500000US130591303001,130591303001,"Block Group 1, Census Tract 1303, Clarke County, Georgia",2585,1179,1406,54.3907156673
912,1500000US130591303002,130591303002,"Block Group 2, Census Tract 1303, Clarke County, Georgia",3460,2362,1098,31.7341040462
913,1500000US130591304001,130591304001,"Block Group 1, Census Tract 1304, Clarke County, Georgia",2554,2297,257,10.0626468285
914,1500000US130591304002,130591304002,"Block Group 2, Census Tract 1304, Clarke County, Georgia",1736,1682,54,3.11059907834
915,1500000US130591304003,130591304003,"Block Group 3, Census Tract 1304, Clarke County, Georgia",1341,1326,15,1.11856823266
916,1500000US130591305001,130591305001,"Block Group 1, Census Tract 1305, Clarke County, Georgia",1245,1228,17,1.36546184739
917,1500000US130591305002,130591305002,"Block Group 2, Census Tract 1305, Clarke County, Georgia",896,834,62,6.91964285714
918,1500000US130591305003,130591305003,"Block Group 3, Census Tract 1305, Clarke County, Georgia",523,523,0,0.0
919,1500000US130591306001,130591306001,"Block Group 1, Census Tract 1306, Clarke County, Georgia",1608,1608,0,0.0
920,1500000US130591306002,130591306002,"Block Group 2, Census Tract 1306, Clarke County, Georgia",2981,2634,347,11.6403891312
921,1500000US130591306003,130591306003,"Block Group 3, Census Tract 1306, Clarke County, Georgia",2003,1174,829,41.3879181228
922,1500000US130591307001,130591307001,"Block Group 1, Census Tract 1307, Clarke County, Georgia",2381,2195,186,7.81184376312
923,1500000US130591307002,130591307002,"Block Group 2, Census Tract 1307, Clarke County, Georgia",1270,1196,74,5.82677165354
924,1500000US130591307003,130591307003,"Block Group 3, Census Tract 1307, Clarke County, Georgia",1658,1447,211,12.7261761158
925,1500000US130591403001,130591403001,"Block Group 1, Census Tract 1403, Clarke County, Georgia",1897,1054,843,44.438587243
926,1500000US130591403002,130591403002,"Block Group 2, Census Tract 1403, Clarke County, Georgia",1282,1142,140,10.9204368175
927,1500000US130591403003,130591403003,"Block Group 3, Census Tract 1403, Clarke County, Georgia",2034,1652,382,18.7807276303
928,1500000US130591404001,130591404001,"Block Group 1, Census Tract 1404, Clarke County, Georgia",1190,1012,178,14.9579831933
929,1500000US130591404002,130591404002,"Block Group 2, Census Tract 1404, Clarke County, Georgia",2418,918,1500,62.0347394541
930,1500000US130591405001,130591405001,"Block Group 1, Census Tract 1405, Clarke County, Georgia",2130,1735,395,18.544600939
931,1500000US130591406001,130591406001,"Block Group 1, Census Tract 1406, Clarke County, Georgia",672,533,139,20.6845238095
932,1500000US130591406002,130591406002,"Block Group 2, Census Tract 1406, Clarke County, Georgia",2793,2386,407,14.5721446473
933,1500000US130591406003,130591406003,"Block Group 3, Census Tract 1406, Clarke County, Georgia",1457,1326,131,8.99107755662
934,1500000US130591503001,130591503001,"Block Group 1, Census Tract 1503, Clarke County, Georgia",1117,831,286,25.6042972247
935,1500000US130591503002,130591503002,"Block Group 2, Census Tract 1503, Clarke County, Georgia",973,965,8,0.82219938335
936,1500000US130591503003,130591503003,"Block Group 3, Census Tract 1503, Clarke County, Georgia",1271,1111,160,12.5885129819
937,1500000US130591504001,130591504001,"Block Group 1, Census Tract 1504, Clarke County, Georgia",2276,2133,143,6.28295254833
938,1500000US130591504002,130591504002,"Block Group 2, Census Tract 1504, Clarke County, Georgia",1701,1668,33,1.94003527337
939,1500000US130591504003,130591504003,"Block Group 3, Census Tract 1504, Clarke County, Georgia",961,943,18,1.87304890739
940,1500000US130591505001,130591505001,"Block Group 1, Census Tract 1505, Clarke County, Georgia",1433,1342,91,6.35031402652
941,1500000US130591505002,130591505002,"Block Group 2, Census Tract 1505, Clarke County, Georgia",1352,1185,167,12.3520710059
942,1500000US130591505003,130591505003,"Block Group 3, Census Tract 1505, Clarke County, Georgia",1792,1659,133,7.421875
943,1500000US130591506001,130591506001,"Block Group 1, Census Tract 1506, Clarke County, Georgia",1361,1163,198,14.5481263777
944,1500000US130591506002,130591506002,"Block Group 2, Census Tract 1506, Clarke County, Georgia",1537,1364,173,11.2556929083
945,1500000US130591507001,130591507001,"Block Group 1, Census Tract 1507, Clarke County, Georgia",1480,1424,56,3.78378378378
946,1500000US130591507002,130591507002,"Block Group 2, Census Tract 1507, Clarke County, Georgia",2959,2921,38,1.28421764109
947,1500000US130591507003,130591507003,"Block Group 3, Census Tract 1507, Clarke County, Georgia",1215,1060,155,12.7572016461
948,1500000US130591508001,130591508001,"Block Group 1, Census Tract 1508, Clarke County, Georgia",1839,1583,256,13.9206090266
949,1500000US130591508002,130591508002,"Block Group 2, Census Tract 1508, Clarke County, Georgia",945,945,0,0.0
950,1500000US130591508003,130591508003,"Block Group 3, Census Tract 1508, Clarke County, Georgia",1334,1318,16,1.19940029985
951,1500000US130591508004,130591508004,"Block Group 4, Census Tract 1508, Clarke County, Georgia",2027,2007,20,0.986679822398
952,1500000US130591509001,130591509001,"Block Group 1, Census Tract 1509, Clarke County, Georgia",2170,2170,0,0.0
953,1500000US130591509002,130591509002,"Block Group 2, Census Tract 1509, Clarke County, Georgia",1984,1730,254,12.8024193548
954,1500000US130619603001,130619603001,"Block Group 1, Census Tract 9603, Clay County, Georgia",1699,1552,147,8.65214832254
955,1500000US130619603002,130619603002,"Block Group 2, Census Tract 9603, Clay County, Georgia",609,609,0,0.0
956,1500000US130619603003,130619603003,"Block Group 3, Census Tract 9603, Clay County, Georgia",796,791,5,0.628140703518
957,1500000US130630402021,130630402021,"Block Group 1, Census Tract 402.02, Clayton County, Georgia",1355,1287,68,5.0184501845
958,1500000US130630402022,130630402022,"Block Group 2, Census Tract 402.02, Clayton County, Georgia",1139,1017,122,10.7111501317
959,1500000US130630402031,130630402031,"Block Group 1, Census Tract 402.03, Clayton County, Georgia",763,763,0,0.0
960,1500000US130630402032,130630402032,"Block Group 2, Census Tract 402.03, Clayton County, Georgia",2434,2256,178,7.31306491372
961,1500000US130630402041,130630402041,"Block Group 1, Census Tract 402.04, Clayton County, Georgia",1149,1095,54,4.69973890339
962,1500000US130630402042,130630402042,"Block Group 2, Census Tract 402.04, Clayton County, Georgia",877,867,10,1.14025085519
963,1500000US130630402043,130630402043,"Block Group 3, Census Tract 402.04, Clayton County, Georgia",1554,1482,72,4.6332046332
964,1500000US130630403021,130630403021,"Block Group 1, Census Tract 403.02, Clayton County, Georgia",1190,844,346,29.0756302521
965,1500000US130630403022,130630403022,"Block Group 2, Census Tract 403.02, Clayton County, Georgia",1189,632,557,46.8460891505
966,1500000US130630403023,130630403023,"Block Group 3, Census Tract 403.02, Clayton County, Georgia",1275,1194,81,6.35294117647
967,1500000US130630403024,130630403024,"Block Group 4, Census Tract 403.02, Clayton County, Georgia",1177,758,419,35.5989804588
968,1500000US130630403031,130630403031,"Block Group 1, Census Tract 403.03, Clayton County, Georgia",1448,1151,297,20.5110497238
969,1500000US130630403032,130630403032,"Block Group 2, Census Tract 403.03, Clayton County, Georgia",947,719,228,24.0760295671
970,1500000US130630403033,130630403033,"Block Group 3, Census Tract 403.03, Clayton County, Georgia",784,690,94,11.9897959184
971,1500000US130630403034,130630403034,"Block Group 4, Census Tract 403.03, Clayton County, Georgia",1160,1130,30,2.58620689655
972,1500000US130630403035,130630403035,"Block Group 5, Census Tract 403.03, Clayton County, Georgia",1048,591,457,43.606870229
973,1500000US130630403036,130630403036,"Block Group 6, Census Tract 403.03, Clayton County, Georgia",968,697,271,27.9958677686
974,1500000US130630403061,130630403061,"Block Group 1, Census Tract 403.06, Clayton County, Georgia",2143,1158,985,45.9636024265
975,1500000US130630403062,130630403062,"Block Group 2, Census Tract 403.06, Clayton County, Georgia",1914,959,955,49.8955067921
976,1500000US130630403071,130630403071,"Block Group 1, Census Tract 403.07, Clayton County, Georgia",1803,1267,536,29.7282307266
977,1500000US130630403072,130630403072,"Block Group 2, Census Tract 403.07, Clayton County, Georgia",2753,2372,381,13.839447875
978,1500000US130630403081,130630403081,"Block Group 1, Census Tract 403.08, Clayton County, Georgia",1881,1245,636,33.8118022329
979,1500000US130630403082,130630403082,"Block Group 2, Census Tract 403.08, Clayton County, Georgia",1653,1127,526,31.8209316394
980,1500000US130630403083,130630403083,"Block Group 3, Census Tract 403.08, Clayton County, Georgia",819,525,294,35.8974358974
981,1500000US130630404071,130630404071,"Block Group 1, Census Tract 404.07, Clayton County, Georgia",1919,1655,264,13.7571651902
982,1500000US130630404072,130630404072,"Block Group 2, Census Tract 404.07, Clayton County, Georgia",2143,1743,400,18.6654223052
983,1500000US130630404081,130630404081,"Block Group 1, Census Tract 404.08, Clayton County, Georgia",2086,1713,373,17.8811121764
984,1500000US130630404082,130630404082,"Block Group 2, Census Tract 404.08, Clayton County, Georgia",3556,3448,108,3.03712035996
985,1500000US130630404083,130630404083,"Block Group 3, Census Tract 404.08, Clayton County, Georgia",2473,2281,192,7.76384957541
986,1500000US130630404091,130630404091,"Block Group 1, Census Tract 404.09, Clayton County, Georgia",2275,2010,265,11.6483516484
987,1500000US130630404092,130630404092,"Block Group 2, Census Tract 404.09, Clayton County, Georgia",3613,2967,646,17.8798782175
988,1500000US130630404101,130630404101,"Block Group 1, Census Tract 404.10, Clayton County, Georgia",5999,4710,1289,21.4869144857
989,1500000US130630404102,130630404102,"Block Group 2, Census Tract 404.10, Clayton County, Georgia",1317,589,728,55.2771450266
990,1500000US130630404111,130630404111,"Block Group 1, Census Tract 404.11, Clayton County, Georgia",2912,2831,81,2.78159340659
991,1500000US130630404112,130630404112,"Block Group 2, Census Tract 404.11, Clayton County, Georgia",2890,2403,487,16.8512110727
992,1500000US130630404113,130630404113,"Block Group 3, Census Tract 404.11, Clayton County, Georgia",2357,2135,222,9.41875265168
993,1500000US130630404114,130630404114,"Block Group 4, Census Tract 404.11, Clayton County, Georgia",4865,4865,0,0.0
994,1500000US130630404121,130630404121,"Block Group 1, Census Tract 404.12, Clayton County, Georgia",2743,2370,373,13.5982500911
995,1500000US130630404122,130630404122,"Block Group 2, Census Tract 404.12, Clayton County, Georgia",3161,2823,338,10.6928187283
996,1500000US130630404123,130630404123,"Block Group 3, Census Tract 404.12, Clayton County, Georgia",2139,2115,24,1.12201963534
997,1500000US130630404131,130630404131,"Block Group 1, Census Tract 404.13, Clayton County, Georgia",2950,2394,556,18.8474576271
998,1500000US130630404132,130630404132,"Block Group 2, Census Tract 404.13, Clayton County, Georgia",4002,3609,393,9.82008995502
999,1500000US130630404141,130630404141,"Block Group 1, Census Tract 404.14, Clayton County, Georgia",1870,1068,802,42.8877005348
1000,1500000US130630404151,130630404151,"Block Group 1, Census Tract 404.15, Clayton County, Georgia",1468,980,488,33.242506812
1001,1500000US130630404152,130630404152,"Block Group 2, Census Tract 404.15, Clayton County, Georgia",1858,1717,141,7.58880516685
1002,1500000US130630404153,130630404153,"Block Group 3, Census Tract 404.15, Clayton County, Georgia",689,401,288,41.7997097242
1003,1500000US130630404154,130630404154,"Block Group 4, Census Tract 404.15, Clayton County, Georgia",1985,1428,557,28.0604534005
1004,1500000US130630404161,130630404161,"Block Group 1, Census Tract 404.16, Clayton County, Georgia",2180,1592,588,26.9724770642
1005,1500000US130630404162,130630404162,"Block Group 2, Census Tract 404.16, Clayton County, Georgia",1997,1611,386,19.3289934902
1006,1500000US130630404171,130630404171,"Block Group 1, Census Tract 404.17, Clayton County, Georgia",2417,2237,180,7.44724865536
1007,1500000US130630404172,130630404172,"Block Group 2, Census Tract 404.17, Clayton County, Georgia",791,451,340,42.9835651075
1008,1500000US130630404173,130630404173,"Block Group 3, Census Tract 404.17, Clayton County, Georgia",1403,1340,63,4.49037776194
1009,1500000US130630405091,130630405091,"Block Group 1, Census Tract 405.09, Clayton County, Georgia",1909,1798,111,5.81456259822
1010,1500000US130630405092,130630405092,"Block Group 2, Census Tract 405.09, Clayton County, Georgia",2795,2655,140,5.00894454383
1011,1500000US130630405101,130630405101,"Block Group 1, Census Tract 405.10, Clayton County, Georgia",1808,1599,209,11.5597345133
1012,1500000US130630405102,130630405102,"Block Group 2, Census Tract 405.10, Clayton County, Georgia",1532,1508,24,1.56657963446
1013,1500000US130630405121,130630405121,"Block Group 1, Census Tract 405.12, Clayton County, Georgia",2436,2384,52,2.13464696223
1014,1500000US130630405122,130630405122,"Block Group 2, Census Tract 405.12, Clayton County, Georgia",595,575,20,3.36134453782
1015,1500000US130630405123,130630405123,"Block Group 3, Census Tract 405.12, Clayton County, Georgia",2331,2206,125,5.36250536251
1016,1500000US130630405131,130630405131,"Block Group 1, Census Tract 405.13, Clayton County, Georgia",1690,1690,0,0.0
1017,1500000US130630405132,130630405132,"Block Group 2, Census Tract 405.13, Clayton County, Georgia",985,969,16,1.62436548223
1018,1500000US130630405133,130630405133,"Block Group 3, Census Tract 405.13, Clayton County, Georgia",2098,2088,10,0.47664442326
1019,1500000US130630405141,130630405141,"Block Group 1, Census Tract 405.14, Clayton County, Georgia",1231,1206,25,2.03086921202
1020,1500000US130630405142,130630405142,"Block Group 2, Census Tract 405.14, Clayton County, Georgia",1717,643,1074,62.5509609785
1021,1500000US130630405143,130630405143,"Block Group 3, Census Tract 405.14, Clayton County, Georgia",3977,3884,93,2.33844606487
1022,1500000US130630405151,130630405151,"Block Group 1, Census Tract 405.15, Clayton County, Georgia",867,587,280,32.2952710496
1023,1500000US130630405152,130630405152,"Block Group 2, Census Tract 405.15, Clayton County, Georgia",2230,2082,148,6.63677130045
1024,1500000US130630405153,130630405153,"Block Group 3, Census Tract 405.15, Clayton County, Georgia",1670,1155,515,30.8383233533
1025,1500000US130630405154,130630405154,"Block Group 4, Census Tract 405.15, Clayton County, Georgia",3016,2840,176,5.83554376658
1026,1500000US130630405161,130630405161,"Block Group 1, Census Tract 405.16, Clayton County, Georgia",3561,3455,106,2.97669194047
1027,1500000US130630405162,130630405162,"Block Group 2, Census Tract 405.16, Clayton County, Georgia",1293,1025,268,20.7269914927
1028,1500000US130630405163,130630405163,"Block Group 3, Census Tract 405.16, Clayton County, Georgia",1178,1050,128,10.8658743633
1029,1500000US130630405181,130630405181,"Block Group 1, Census Tract 405.18, Clayton County, Georgia",698,640,58,8.30945558739
1030,1500000US130630405182,130630405182,"Block Group 2, Census Tract 405.18, Clayton County, Georgia",2841,2596,245,8.62372404083
1031,1500000US130630405183,130630405183,"Block Group 3, Census Tract 405.18, Clayton County, Georgia",1585,1200,385,24.2902208202
1032,1500000US130630405191,130630405191,"Block Group 1, Census Tract 405.19, Clayton County, Georgia",3414,3290,124,3.63210310486
1033,1500000US130630405192,130630405192,"Block Group 2, Census Tract 405.19, Clayton County, Georgia",785,714,71,9.04458598726
1034,1500000US130630405201,130630405201,"Block Group 1, Census Tract 405.20, Clayton County, Georgia",818,777,41,5.01222493888
1035,1500000US130630405202,130630405202,"Block Group 2, Census Tract 405.20, Clayton County, Georgia",580,580,0,0.0
1036,1500000US130630405203,130630405203,"Block Group 3, Census Tract 405.20, Clayton County, Georgia",2044,1914,130,6.36007827789
1037,1500000US130630405211,130630405211,"Block Group 1, Census Tract 405.21, Clayton County, Georgia",1977,1832,145,7.33434496712
1038,1500000US130630405212,130630405212,"Block Group 2, Census Tract 405.21, Clayton County, Georgia",1371,1330,41,2.99051787017
1039,1500000US130630405221,130630405221,"Block Group 1, Census Tract 405.22, Clayton County, Georgia",1972,1709,263,13.3367139959
1040,1500000US130630405222,130630405222,"Block Group 2, Census Tract 405.22, Clayton County, Georgia",1452,1395,57,3.92561983471
1041,1500000US130630405223,130630405223,"Block Group 3, Census Tract 405.22, Clayton County, Georgia",1106,966,140,12.6582278481
1042,1500000US130630405231,130630405231,"Block Group 1, Census Tract 405.23, Clayton County, Georgia",3115,2887,228,7.31942215088
1043,1500000US130630405241,130630405241,"Block Group 1, Census Tract 405.24, Clayton County, Georgia",2086,1914,172,8.24544582934
1044,1500000US130630405242,130630405242,"Block Group 2, Census Tract 405.24, Clayton County, Georgia",1966,1609,357,18.1586978637
1045,1500000US130630405243,130630405243,"Block Group 3, Census Tract 405.24, Clayton County, Georgia",1025,932,93,9.07317073171
1046,1500000US130630405244,130630405244,"Block Group 4, Census Tract 405.24, Clayton County, Georgia",2128,1636,492,23.1203007519
1047,1500000US130630405251,130630405251,"Block Group 1, Census Tract 405.25, Clayton County, Georgia",2729,2554,175,6.41260534995
1048,1500000US130630405261,130630405261,"Block Group 1, Census Tract 405.26, Clayton County, Georgia",2492,2325,167,6.70144462279
1049,1500000US130630405262,130630405262,"Block Group 2, Census Tract 405.26, Clayton County, Georgia",2289,1991,298,13.0187854958
1050,1500000US130630405263,130630405263,"Block Group 3, Census Tract 405.26, Clayton County, Georgia",1565,1515,50,3.19488817891
1051,1500000US130630406061,130630406061,"Block Group 1, Census Tract 406.06, Clayton County, Georgia",1879,1674,205,10.9100585418
1052,1500000US130630406062,130630406062,"Block Group 2, Census Tract 406.06, Clayton County, Georgia",1863,1192,671,36.0171765969
1053,1500000US130630406081,130630406081,"Block Group 1, Census Tract 406.08, Clayton County, Georgia",8648,8148,500,5.78168362627
1054,1500000US130630406082,130630406082,"Block Group 2, Census Tract 406.08, Clayton County, Georgia",2726,2687,39,1.4306676449
1055,1500000US130630406091,130630406091,"Block Group 1, Census Tract 406.09, Clayton County, Georgia",1633,1562,71,4.34782608696
1056,1500000US130630406092,130630406092,"Block Group 2, Census Tract 406.09, Clayton County, Georgia",2284,1993,291,12.7408056042
1057,1500000US130630406093,130630406093,"Block Group 3, Census Tract 406.09, Clayton County, Georgia",2243,2129,114,5.082478823
1058,1500000US130630406111,130630406111,"Block Group 1, Census Tract 406.11, Clayton County, Georgia",3422,2294,1128,32.9631794272
1059,1500000US130630406112,130630406112,"Block Group 2, Census Tract 406.11, Clayton County, Georgia",762,677,85,11.154855643
1060,1500000US130630406113,130630406113,"Block Group 3, Census Tract 406.11, Clayton County, Georgia",2025,1681,344,16.987654321
1061,1500000US130630406121,130630406121,"Block Group 1, Census Tract 406.12, Clayton County, Georgia",940,911,29,3.08510638298
1062,1500000US130630406122,130630406122,"Block Group 2, Census Tract 406.12, Clayton County, Georgia",2979,2491,488,16.3813360188
1063,1500000US130630406123,130630406123,"Block Group 3, Census Tract 406.12, Clayton County, Georgia",2521,2408,113,4.48234827449
1064,1500000US130630406131,130630406131,"Block Group 1, Census Tract 406.13, Clayton County, Georgia",2714,2526,188,6.9270449521
1065,1500000US130630406132,130630406132,"Block Group 2, Census Tract 406.13, Clayton County, Georgia",2869,2576,293,10.2126176368
1066,1500000US130630406133,130630406133,"Block Group 3, Census Tract 406.13, Clayton County, Georgia",2585,2497,88,3.40425531915
1067,1500000US130630406141,130630406141,"Block Group 1, Census Tract 406.14, Clayton County, Georgia",1207,1207,0,0.0
1068,1500000US130630406142,130630406142,"Block Group 2, Census Tract 406.14, Clayton County, Georgia",1943,1766,177,9.10962429233
1069,1500000US130630406143,130630406143,"Block Group 3, Census Tract 406.14, Clayton County, Georgia",1677,1546,131,7.81156827668
1070,1500000US130630406151,130630406151,"Block Group 1, Census Tract 406.15, Clayton County, Georgia",2107,1976,131,6.2173706692
1071,1500000US130630406161,130630406161,"Block Group 1, Census Tract 406.16, Clayton County, Georgia",5156,4826,330,6.40031031808
1072,1500000US130630406162,130630406162,"Block Group 2, Census Tract 406.16, Clayton County, Georgia",744,731,13,1.74731182796
1073,1500000US130630406163,130630406163,"Block Group 3, Census Tract 406.16, Clayton County, Georgia",2450,1632,818,33.387755102
1074,1500000US130630406171,130630406171,"Block Group 1, Census Tract 406.17, Clayton County, Georgia",1694,660,1034,61.038961039
1075,1500000US130630406191,130630406191,"Block Group 1, Census Tract 406.19, Clayton County, Georgia",3526,3189,337,9.55757231991
1076,1500000US130630406201,130630406201,"Block Group 1, Census Tract 406.20, Clayton County, Georgia",3302,3009,293,8.87341005451
1077,1500000US130630406211,130630406211,"Block Group 1, Census Tract 406.21, Clayton County, Georgia",5776,5314,462,7.99861495845
1078,1500000US130630406212,130630406212,"Block Group 2, Census Tract 406.21, Clayton County, Georgia",4633,4298,335,7.23073602417
1079,1500000US130630406221,130630406221,"Block Group 1, Census Tract 406.22, Clayton County, Georgia",3455,3091,364,10.5354558611
1080,1500000US130630406222,130630406222,"Block Group 2, Census Tract 406.22, Clayton County, Georgia",3382,2847,535,15.819041987
1081,1500000US130630406223,130630406223,"Block Group 3, Census Tract 406.22, Clayton County, Georgia",1651,1568,83,5.02725620836
1082,1500000US130639800001,130639800001,"Block Group 1, Census Tract 9800, Clayton County, Georgia",0,0,0,
1083,1500000US130659701001,130659701001,"Block Group 1, Census Tract 9701, Clinch County, Georgia",1008,1008,0,0.0
1084,1500000US130659701002,130659701002,"Block Group 2, Census Tract 9701, Clinch County, Georgia",1745,1686,59,3.38108882521
1085,1500000US130659701003,130659701003,"Block Group 3, Census Tract 9701, Clinch County, Georgia",491,491,0,0.0
1086,1500000US130659701004,130659701004,"Block Group 4, Census Tract 9701, Clinch County, Georgia",895,895,0,0.0
1087,1500000US130659701005,130659701005,"Block Group 5, Census Tract 9701, Clinch County, Georgia",1175,984,191,16.2553191489
1088,1500000US130659702001,130659702001,"Block Group 1, Census Tract 9702, Clinch County, Georgia",653,628,25,3.82848392037
1089,1500000US130659702002,130659702002,"Block Group 2, Census Tract 9702, Clinch County, Georgia",824,814,10,1.21359223301
1090,1500000US130670301011,130670301011,"Block Group 1, Census Tract 301.01, Cobb County, Georgia",1402,1214,188,13.4094151213
1091,1500000US130670301012,130670301012,"Block Group 2, Census Tract 301.01, Cobb County, Georgia",1858,1615,243,13.0785791173
1092,1500000US130670301013,130670301013,"Block Group 3, Census Tract 301.01, Cobb County, Georgia",2656,2461,195,7.34186746988
1093,1500000US130670301014,130670301014,"Block Group 4, Census Tract 301.01, Cobb County, Georgia",1883,1866,17,0.902814657461
1094,1500000US130670301031,130670301031,"Block Group 1, Census Tract 301.03, Cobb County, Georgia",2252,2184,68,3.01953818828
1095,1500000US130670301032,130670301032,"Block Group 2, Census Tract 301.03, Cobb County, Georgia",2793,2767,26,0.93089867526
1096,1500000US130670301033,130670301033,"Block Group 3, Census Tract 301.03, Cobb County, Georgia",4074,3764,310,7.60922925871
1097,1500000US130670301041,130670301041,"Block Group 1, Census Tract 301.04, Cobb County, Georgia",951,773,178,18.7171398528
1098,1500000US130670301042,130670301042,"Block Group 2, Census Tract 301.04, Cobb County, Georgia",2695,2403,292,10.8348794063
1099,1500000US130670301061,130670301061,"Block Group 1, Census Tract 301.06, Cobb County, Georgia",2365,2157,208,8.79492600423
1100,1500000US130670301062,130670301062,"Block Group 2, Census Tract 301.06, Cobb County, Georgia",2241,1844,397,17.7153056671
1101,1500000US130670301063,130670301063,"Block Group 3, Census Tract 301.06, Cobb County, Georgia",3234,3059,175,5.41125541126
1102,1500000US130670301071,130670301071,"Block Group 1, Census Tract 301.07, Cobb County, Georgia",1813,1631,182,10.0386100386
1103,1500000US130670301072,130670301072,"Block Group 2, Census Tract 301.07, Cobb County, Georgia",3006,2684,322,10.7119095143
1104,1500000US130670302091,130670302091,"Block Group 1, Census Tract 302.09, Cobb County, Georgia",1727,1617,110,6.36942675159
1105,1500000US130670302092,130670302092,"Block Group 2, Census Tract 302.09, Cobb County, Georgia",1980,1980,0,0.0
1106,1500000US130670302093,130670302093,"Block Group 3, Census Tract 302.09, Cobb County, Georgia",2961,2713,248,8.37554880108
1107,1500000US130670302141,130670302141,"Block Group 1, Census Tract 302.14, Cobb County, Georgia",2945,2945,0,0.0
1108,1500000US130670302142,130670302142,"Block Group 2, Census Tract 302.14, Cobb County, Georgia",2324,2193,131,5.63683304647
1109,1500000US130670302143,130670302143,"Block Group 3, Census Tract 302.14, Cobb County, Georgia",2930,2548,382,13.0375426621
1110,1500000US130670302151,130670302151,"Block Group 1, Census Tract 302.15, Cobb County, Georgia",2687,2376,311,11.5742463714
1111,1500000US130670302152,130670302152,"Block Group 2, Census Tract 302.15, Cobb County, Georgia",2236,1722,514,22.9874776386
1112,1500000US130670302153,130670302153,"Block Group 3, Census Tract 302.15, Cobb County, Georgia",1559,1173,386,24.7594611931
1113,1500000US130670302154,130670302154,"Block Group 4, Census Tract 302.15, Cobb County, Georgia",2968,2858,110,3.70619946092
1114,1500000US130670302181,130670302181,"Block Group 1, Census Tract 302.18, Cobb County, Georgia",2864,2604,260,9.0782122905
1115,1500000US130670302182,130670302182,"Block Group 2, Census Tract 302.18, Cobb County, Georgia",2777,2508,269,9.68671227944
1116,1500000US130670302191,130670302191,"Block Group 1, Census Tract 302.19, Cobb County, Georgia",2257,2066,191,8.46256092158
1117,1500000US130670302192,130670302192,"Block Group 2, Census Tract 302.19, Cobb County, Georgia",2357,2184,173,7.33983877811
1118,1500000US130670302193,130670302193,"Block Group 3, Census Tract 302.19, Cobb County, Georgia",2215,2175,40,1.80586907449
1119,1500000US130670302194,130670302194,"Block Group 4, Census Tract 302.19, Cobb County, Georgia",2406,2257,149,6.19285120532
1120,1500000US130670302201,130670302201,"Block Group 1, Census Tract 302.20, Cobb County, Georgia",1866,1732,134,7.18113612004
1121,1500000US130670302221,130670302221,"Block Group 1, Census Tract 302.22, Cobb County, Georgia",2660,2624,36,1.35338345865
1122,1500000US130670302222,130670302222,"Block Group 2, Census Tract 302.22, Cobb County, Georgia",2365,2162,203,8.58350951374
1123,1500000US130670302223,130670302223,"Block Group 3, Census Tract 302.22, Cobb County, Georgia",860,833,27,3.13953488372
1124,1500000US130670302231,130670302231,"Block Group 1, Census Tract 302.23, Cobb County, Georgia",3135,2590,545,17.3843700159
1125,1500000US130670302232,130670302232,"Block Group 2, Census Tract 302.23, Cobb County, Georgia",2132,2006,126,5.90994371482
1126,1500000US130670302233,130670302233,"Block Group 3, Census Tract 302.23, Cobb County, Georgia",650,598,52,8.0
1127,1500000US130670302241,130670302241,"Block Group 1, Census Tract 302.24, Cobb County, Georgia",5609,4815,794,14.155821002
1128,1500000US130670302242,130670302242,"Block Group 2, Census Tract 302.24, Cobb County, Georgia",1040,827,213,20.4807692308
1129,1500000US130670302261,130670302261,"Block Group 1, Census Tract 302.26, Cobb County, Georgia",4182,3435,747,17.862266858
1130,1500000US130670302262,130670302262,"Block Group 2, Census Tract 302.26, Cobb County, Georgia",1749,1508,241,13.7793024585
1131,1500000US130670302263,130670302263,"Block Group 3, Census Tract 302.26, Cobb County, Georgia",2959,2792,167,5.6437985806
1132,1500000US130670302271,130670302271,"Block Group 1, Census Tract 302.27, Cobb County, Georgia",2002,1448,554,27.6723276723
1133,1500000US130670302272,130670302272,"Block Group 2, Census Tract 302.27, Cobb County, Georgia",3512,3110,402,11.4464692483
1134,1500000US130670302273,130670302273,"Block Group 3, Census Tract 302.27, Cobb County, Georgia",2367,2214,153,6.463878327
1135,1500000US130670302281,130670302281,"Block Group 1, Census Tract 302.28, Cobb County, Georgia",2369,1945,424,17.8978471929
1136,1500000US130670302282,130670302282,"Block Group 2, Census Tract 302.28, Cobb County, Georgia",1212,1154,58,4.78547854785
1137,1500000US130670302283,130670302283,"Block Group 3, Census Tract 302.28, Cobb County, Georgia",2131,1678,453,21.2576255279
1138,1500000US130670302284,130670302284,"Block Group 4, Census Tract 302.28, Cobb County, Georgia",1377,1351,26,1.88816267248
1139,1500000US130670302291,130670302291,"Block Group 1, Census Tract 302.29, Cobb County, Georgia",171,171,0,0.0
1140,1500000US130670302292,130670302292,"Block Group 2, Census Tract 302.29, Cobb County, Georgia",5681,5418,263,4.6294666432
1141,1500000US130670302301,130670302301,"Block Group 1, Census Tract 302.30, Cobb County, Georgia",7581,5917,1664,21.9496108693
1142,1500000US130670302302,130670302302,"Block Group 2, Census Tract 302.30, Cobb County, Georgia",5400,5231,169,3.12962962963
1143,1500000US130670302311,130670302311,"Block Group 1, Census Tract 302.31, Cobb County, Georgia",827,775,52,6.28778718259
1144,1500000US130670302312,130670302312,"Block Group 2, Census Tract 302.31, Cobb County, Georgia",1777,1777,0,0.0
1145,1500000US130670302313,130670302313,"Block Group 3, Census Tract 302.31, Cobb County, Georgia",1755,1702,53,3.01994301994
1146,1500000US130670302314,130670302314,"Block Group 4, Census Tract 302.31, Cobb County, Georgia",2838,2789,49,1.72656800564
1147,1500000US130670302321,130670302321,"Block Group 1, Census Tract 302.32, Cobb County, Georgia",2481,2219,262,10.5602579605
1148,1500000US130670302322,130670302322,"Block Group 2, Census Tract 302.32, Cobb County, Georgia",3201,2898,303,9.46579194002
1149,1500000US130670302331,130670302331,"Block Group 1, Census Tract 302.33, Cobb County, Georgia",1411,1212,199,14.1034727144
1150,1500000US130670302332,130670302332,"Block Group 2, Census Tract 302.33, Cobb County, Georgia",2835,2710,125,4.40917107584
1151,1500000US130670302341,130670302341,"Block Group 1, Census Tract 302.34, Cobb County, Georgia",3140,3042,98,3.12101910828
1152,1500000US130670302342,130670302342,"Block Group 2, Census Tract 302.34, Cobb County, Georgia",2989,2856,133,4.44964871194
1153,1500000US130670302351,130670302351,"Block Group 1, Census Tract 302.35, Cobb County, Georgia",1696,1566,130,7.66509433962
1154,1500000US130670302352,130670302352,"Block Group 2, Census Tract 302.35, Cobb County, Georgia",3184,3068,116,3.6432160804
1155,1500000US130670302361,130670302361,"Block Group 1, Census Tract 302.36, Cobb County, Georgia",2306,2260,46,1.99479618387
1156,1500000US130670302362,130670302362,"Block Group 2, Census Tract 302.36, Cobb County, Georgia",2451,2377,74,3.01917584659
1157,1500000US130670302381,130670302381,"Block Group 1, Census Tract 302.38, Cobb County, Georgia",3335,3300,35,1.04947526237
1158,1500000US130670302382,130670302382,"Block Group 2, Census Tract 302.38, Cobb County, Georgia",3376,3060,316,9.36018957346
1159,1500000US130670302391,130670302391,"Block Group 1, Census Tract 302.39, Cobb County, Georgia",1978,1608,370,18.7057633974
1160,1500000US130670302392,130670302392,"Block Group 2, Census Tract 302.39, Cobb County, Georgia",3033,2988,45,1.48367952522
1161,1500000US130670302393,130670302393,"Block Group 3, Census Tract 302.39, Cobb County, Georgia",3453,3340,113,3.27251665219
1162,1500000US130670303101,130670303101,"Block Group 1, Census Tract 303.10, Cobb County, Georgia",1497,1323,174,11.623246493
1163,1500000US130670303102,130670303102,"Block Group 2, Census Tract 303.10, Cobb County, Georgia",2530,2485,45,1.77865612648
1164,1500000US130670303103,130670303103,"Block Group 3, Census Tract 303.10, Cobb County, Georgia",687,582,105,15.2838427948
1165,1500000US130670303104,130670303104,"Block Group 4, Census Tract 303.10, Cobb County, Georgia",1998,1801,197,9.85985985986
1166,1500000US130670303105,130670303105,"Block Group 5, Census Tract 303.10, Cobb County, Georgia",1415,1332,83,5.86572438163
1167,1500000US130670303111,130670303111,"Block Group 1, Census Tract 303.11, Cobb County, Georgia",1687,1687,0,0.0
1168,1500000US130670303112,130670303112,"Block Group 2, Census Tract 303.11, Cobb County, Georgia",1137,1112,25,2.19876868953
1169,1500000US130670303113,130670303113,"Block Group 3, Census Tract 303.11, Cobb County, Georgia",973,973,0,0.0
1170,1500000US130670303114,130670303114,"Block Group 4, Census Tract 303.11, Cobb County, Georgia",2066,1759,307,14.8596321394
1171,1500000US130670303121,130670303121,"Block Group 1, Census Tract 303.12, Cobb County, Georgia",2640,2618,22,0.833333333333
1172,1500000US130670303122,130670303122,"Block Group 2, Census Tract 303.12, Cobb County, Georgia",1380,1313,67,4.85507246377
1173,1500000US130670303123,130670303123,"Block Group 3, Census Tract 303.12, Cobb County, Georgia",1373,1160,213,15.5134741442
1174,1500000US130670303124,130670303124,"Block Group 4, Census Tract 303.12, Cobb County, Georgia",686,611,75,10.9329446064
1175,1500000US130670303131,130670303131,"Block Group 1, Census Tract 303.13, Cobb County, Georgia",1697,1374,323,19.0335886859
1176,1500000US130670303132,130670303132,"Block Group 2, Census Tract 303.13, Cobb County, Georgia",679,679,0,0.0
1177,1500000US130670303133,130670303133,"Block Group 3, Census Tract 303.13, Cobb County, Georgia",1109,1018,91,8.20559062218
1178,1500000US130670303134,130670303134,"Block Group 4, Census Tract 303.13, Cobb County, Georgia",1751,1654,97,5.5396916048
1179,1500000US130670303135,130670303135,"Block Group 5, Census Tract 303.13, Cobb County, Georgia",3177,3177,0,0.0
1180,1500000US130670303141,130670303141,"Block Group 1, Census Tract 303.14, Cobb County, Georgia",2244,1907,337,15.0178253119
1181,1500000US130670303142,130670303142,"Block Group 2, Census Tract 303.14, Cobb County, Georgia",2252,2166,86,3.8188277087
1182,1500000US130670303143,130670303143,"Block Group 3, Census Tract 303.14, Cobb County, Georgia",3420,3167,253,7.39766081871
1183,1500000US130670303181,130670303181,"Block Group 1, Census Tract 303.18, Cobb County, Georgia",2577,2577,0,0.0
1184,1500000US130670303182,130670303182,"Block Group 2, Census Tract 303.18, Cobb County, Georgia",2748,2652,96,3.49344978166
1185,1500000US130670303183,130670303183,"Block Group 3, Census Tract 303.18, Cobb County, Georgia",2677,2568,109,4.07172207695
1186,1500000US130670303191,130670303191,"Block Group 1, Census Tract 303.19, Cobb County, Georgia",1896,1864,32,1.68776371308
1187,1500000US130670303192,130670303192,"Block Group 2, Census Tract 303.19, Cobb County, Georgia",2369,2306,63,2.65934993668
1188,1500000US130670303201,130670303201,"Block Group 1, Census Tract 303.20, Cobb County, Georgia",2908,2731,177,6.08665749656
1189,1500000US130670303202,130670303202,"Block Group 2, Census Tract 303.20, Cobb County, Georgia",2757,2563,194,7.03663402249
1190,1500000US130670303203,130670303203,"Block Group 3, Census Tract 303.20, Cobb County, Georgia",2206,2132,74,3.35448776065
1191,1500000US130670303221,130670303221,"Block Group 1, Census Tract 303.22, Cobb County, Georgia",1312,1250,62,4.7256097561
1192,1500000US130670303222,130670303222,"Block Group 2, Census Tract 303.22, Cobb County, Georgia",2101,1997,104,4.95002379819
1193,1500000US130670303241,130670303241,"Block Group 1, Census Tract 303.24, Cobb County, Georgia",1801,1664,137,7.60688506385
1194,1500000US130670303242,130670303242,"Block Group 2, Census Tract 303.24, Cobb County, Georgia",1723,1693,30,1.74114915844
1195,1500000US130670303261,130670303261,"Block Group 1, Census Tract 303.26, Cobb County, Georgia",1566,1556,10,0.638569604087
1196,1500000US130670303262,130670303262,"Block Group 2, Census Tract 303.26, Cobb County, Georgia",1978,1896,82,4.1456016178
1197,1500000US130670303263,130670303263,"Block Group 3, Census Tract 303.26, Cobb County, Georgia",1102,651,451,40.9255898367
1198,1500000US130670303271,130670303271,"Block Group 1, Census Tract 303.27, Cobb County, Georgia",3082,2991,91,2.95262816353
1199,1500000US130670303272,130670303272,"Block Group 2, Census Tract 303.27, Cobb County, Georgia",1333,1322,11,0.825206301575
1200,1500000US130670303281,130670303281,"Block Group 1, Census Tract 303.28, Cobb County, Georgia",1873,1797,76,4.05766150561
1201,1500000US130670303282,130670303282,"Block Group 2, Census Tract 303.28, Cobb County, Georgia",2539,2111,428,16.8570303269
1202,1500000US130670303283,130670303283,"Block Group 3, Census Tract 303.28, Cobb County, Georgia",2001,2001,0,0.0
1203,1500000US130670303291,130670303291,"Block Group 1, Census Tract 303.29, Cobb County, Georgia",2809,2738,71,2.52758988964
1204,1500000US130670303292,130670303292,"Block Group 2, Census Tract 303.29, Cobb County, Georgia",1498,1498,0,0.0
1205,1500000US130670303301,130670303301,"Block Group 1, Census Tract 303.30, Cobb County, Georgia",1767,1722,45,2.5466893039
1206,1500000US130670303302,130670303302,"Block Group 2, Census Tract 303.30, Cobb County, Georgia",2447,2390,57,2.32938291786
1207,1500000US130670303303,130670303303,"Block Group 3, Census Tract 303.30, Cobb County, Georgia",1654,1616,38,2.29746070133
1208,1500000US130670303311,130670303311,"Block Group 1, Census Tract 303.31, Cobb County, Georgia",2412,2283,129,5.34825870647
1209,1500000US130670303312,130670303312,"Block Group 2, Census Tract 303.31, Cobb County, Georgia",2256,2199,57,2.52659574468
1210,1500000US130670303313,130670303313,"Block Group 3, Census Tract 303.31, Cobb County, Georgia",1031,1027,4,0.387972841901
1211,1500000US130670303321,130670303321,"Block Group 1, Census Tract 303.32, Cobb County, Georgia",1527,1527,0,0.0
1212,1500000US130670303322,130670303322,"Block Group 2, Census Tract 303.32, Cobb County, Georgia",1892,1781,111,5.86680761099
1213,1500000US130670303331,130670303331,"Block Group 1, Census Tract 303.33, Cobb County, Georgia",2787,2647,140,5.02332256907
1214,1500000US130670303332,130670303332,"Block Group 2, Census Tract 303.33, Cobb County, Georgia",1857,1776,81,4.36187399031
1215,1500000US130670303333,130670303333,"Block Group 3, Census Tract 303.33, Cobb County, Georgia",1273,1273,0,0.0
1216,1500000US130670303341,130670303341,"Block Group 1, Census Tract 303.34, Cobb County, Georgia",1385,1347,38,2.74368231047
1217,1500000US130670303342,130670303342,"Block Group 2, Census Tract 303.34, Cobb County, Georgia",1894,1887,7,0.369588173178
1218,1500000US130670303351,130670303351,"Block Group 1, Census Tract 303.35, Cobb County, Georgia",2471,2396,75,3.03520841764
1219,1500000US130670303352,130670303352,"Block Group 2, Census Tract 303.35, Cobb County, Georgia",2101,2003,98,4.66444550214
1220,1500000US130670303361,130670303361,"Block Group 1, Census Tract 303.36, Cobb County, Georgia",1946,1791,155,7.96505652621
1221,1500000US130670303362,130670303362,"Block Group 2, Census Tract 303.36, Cobb County, Georgia",1556,1463,93,5.97686375321
1222,1500000US130670303363,130670303363,"Block Group 3, Census Tract 303.36, Cobb County, Georgia",2336,2261,75,3.21061643836
1223,1500000US130670303364,130670303364,"Block Group 4, Census Tract 303.36, Cobb County, Georgia",1468,1420,48,3.26975476839
1224,1500000US130670303371,130670303371,"Block Group 1, Census Tract 303.37, Cobb County, Georgia",1521,1437,84,5.52268244576
1225,1500000US130670303372,130670303372,"Block Group 2, Census Tract 303.37, Cobb County, Georgia",1902,1845,57,2.99684542587
1226,1500000US130670303373,130670303373,"Block Group 3, Census Tract 303.37, Cobb County, Georgia",994,987,7,0.704225352113
1227,1500000US130670303391,130670303391,"Block Group 1, Census Tract 303.39, Cobb County, Georgia",1439,1272,167,11.6052814454
1228,1500000US130670303392,130670303392,"Block Group 2, Census Tract 303.39, Cobb County, Georgia",4423,4094,329,7.43839023287
1229,1500000US130670303401,130670303401,"Block Group 1, Census Tract 303.40, Cobb County, Georgia",1802,1657,145,8.04661487236
1230,1500000US130670303402,130670303402,"Block Group 2, Census Tract 303.40, Cobb County, Georgia",2141,1834,307,14.3390938814
1231,1500000US130670303411,130670303411,"Block Group 1, Census Tract 303.41, Cobb County, Georgia",2154,2013,141,6.54596100279
1232,1500000US130670303412,130670303412,"Block Group 2, Census Tract 303.41, Cobb County, Georgia",2283,2128,155,6.78931230837
1233,1500000US130670303421,130670303421,"Block Group 1, Census Tract 303.42, Cobb County, Georgia",1806,1730,76,4.20819490587
1234,1500000US130670303422,130670303422,"Block Group 2, Census Tract 303.42, Cobb County, Georgia",2935,2880,55,1.87393526405
1235,1500000US130670303431,130670303431,"Block Group 1, Census Tract 303.43, Cobb County, Georgia",1734,1702,32,1.84544405998
1236,1500000US130670303432,130670303432,"Block Group 2, Census Tract 303.43, Cobb County, Georgia",1722,1708,14,0.813008130081
1237,1500000US130670303433,130670303433,"Block Group 3, Census Tract 303.43, Cobb County, Georgia",1137,1126,11,0.967458223395
1238,1500000US130670303441,130670303441,"Block Group 1, Census Tract 303.44, Cobb County, Georgia",2402,2196,206,8.57618651124
1239,1500000US130670303442,130670303442,"Block Group 2, Census Tract 303.44, Cobb County, Georgia",732,611,121,16.5300546448
1240,1500000US130670303443,130670303443,"Block Group 3, Census Tract 303.44, Cobb County, Georgia",474,394,80,16.8776371308
1241,1500000US130670303451,130670303451,"Block Group 1, Census Tract 303.45, Cobb County, Georgia",2730,1582,1148,42.0512820513
1242,1500000US130670303452,130670303452,"Block Group 2, Census Tract 303.45, Cobb County, Georgia",347,347,0,0.0
1243,1500000US130670303453,130670303453,"Block Group 3, Census Tract 303.45, Cobb County, Georgia",1912,1782,130,6.79916317992
1244,1500000US130670304051,130670304051,"Block Group 1, Census Tract 304.05, Cobb County, Georgia",2611,2611,0,0.0
1245,1500000US130670304052,130670304052,"Block Group 2, Census Tract 304.05, Cobb County, Georgia",1169,1019,150,12.8314798973
1246,1500000US130670304053,130670304053,"Block Group 3, Census Tract 304.05, Cobb County, Georgia",1829,1768,61,3.33515582285
1247,1500000US130670304054,130670304054,"Block Group 4, Census Tract 304.05, Cobb County, Georgia",575,575,0,0.0
1248,1500000US130670304071,130670304071,"Block Group 1, Census Tract 304.07, Cobb County, Georgia",1900,1788,112,5.89473684211
1249,1500000US130670304072,130670304072,"Block Group 2, Census Tract 304.07, Cobb County, Georgia",1451,1354,97,6.68504479669
1250,1500000US130670304073,130670304073,"Block Group 3, Census Tract 304.07, Cobb County, Georgia",1491,1358,133,8.92018779343
1251,1500000US130670304081,130670304081,"Block Group 1, Census Tract 304.08, Cobb County, Georgia",1557,1351,206,13.2305716121
1252,1500000US130670304082,130670304082,"Block Group 2, Census Tract 304.08, Cobb County, Georgia",1577,1478,99,6.27774254914
1253,1500000US130670304091,130670304091,"Block Group 1, Census Tract 304.09, Cobb County, Georgia",2000,2000,0,0.0
1254,1500000US130670304092,130670304092,"Block Group 2, Census Tract 304.09, Cobb County, Georgia",1576,1463,113,7.17005076142
1255,1500000US130670304101,130670304101,"Block Group 1, Census Tract 304.10, Cobb County, Georgia",2587,1971,616,23.8113645149
1256,1500000US130670304102,130670304102,"Block Group 2, Census Tract 304.10, Cobb County, Georgia",2266,1933,333,14.6954986761
1257,1500000US130670304111,130670304111,"Block Group 1, Census Tract 304.11, Cobb County, Georgia",1014,811,203,20.0197238659
1258,1500000US130670304112,130670304112,"Block Group 2, Census Tract 304.11, Cobb County, Georgia",1009,518,491,48.6620416254
1259,1500000US130670304113,130670304113,"Block Group 3, Census Tract 304.11, Cobb County, Georgia",1566,1339,227,14.4955300128
1260,1500000US130670304121,130670304121,"Block Group 1, Census Tract 304.12, Cobb County, Georgia",527,476,51,9.67741935484
1261,1500000US130670304122,130670304122,"Block Group 2, Census Tract 304.12, Cobb County, Georgia",3313,2482,831,25.0830063387
1262,1500000US130670304123,130670304123,"Block Group 3, Census Tract 304.12, Cobb County, Georgia",398,362,36,9.04522613065
1263,1500000US130670304124,130670304124,"Block Group 4, Census Tract 304.12, Cobb County, Georgia",356,356,0,0.0
1264,1500000US130670304131,130670304131,"Block Group 1, Census Tract 304.13, Cobb County, Georgia",1861,1349,512,27.512090274
1265,1500000US130670304132,130670304132,"Block Group 2, Census Tract 304.13, Cobb County, Georgia",2109,1895,214,10.1469890944
1266,1500000US130670304133,130670304133,"Block Group 3, Census Tract 304.13, Cobb County, Georgia",2073,1776,297,14.3270622287
1267,1500000US130670304141,130670304141,"Block Group 1, Census Tract 304.14, Cobb County, Georgia",2038,1777,261,12.806673209
1268,1500000US130670304142,130670304142,"Block Group 2, Census Tract 304.14, Cobb County, Georgia",912,857,55,6.03070175439
1269,1500000US130670305021,130670305021,"Block Group 1, Census Tract 305.02, Cobb County, Georgia",3077,2596,481,15.6321091973
1270,1500000US130670305022,130670305022,"Block Group 2, Census Tract 305.02, Cobb County, Georgia",2449,2414,35,1.42915475704
1271,1500000US130670305023,130670305023,"Block Group 3, Census Tract 305.02, Cobb County, Georgia",1184,1043,141,11.9087837838
1272,1500000US130670305041,130670305041,"Block Group 1, Census Tract 305.04, Cobb County, Georgia",3454,3191,263,7.61436016213
1273,1500000US130670305042,130670305042,"Block Group 2, Census Tract 305.04, Cobb County, Georgia",1141,1084,57,4.99561787905
1274,1500000US130670305043,130670305043,"Block Group 3, Census Tract 305.04, Cobb County, Georgia",1769,1285,484,27.3600904466
1275,1500000US130670305044,130670305044,"Block Group 4, Census Tract 305.04, Cobb County, Georgia",457,457,0,0.0
1276,1500000US130670305051,130670305051,"Block Group 1, Census Tract 305.05, Cobb County, Georgia",1707,1461,246,14.4112478032
1277,1500000US130670305052,130670305052,"Block Group 2, Census Tract 305.05, Cobb County, Georgia",1801,1486,315,17.490283176
1278,1500000US130670305053,130670305053,"Block Group 3, Census Tract 305.05, Cobb County, Georgia",1514,1387,127,8.38837516513
1279,1500000US130670305054,130670305054,"Block Group 4, Census Tract 305.05, Cobb County, Georgia",2037,982,1055,51.7918507609
1280,1500000US130670305061,130670305061,"Block Group 1, Census Tract 305.06, Cobb County, Georgia",2367,2074,293,12.3785382341
1281,1500000US130670305062,130670305062,"Block Group 2, Census Tract 305.06, Cobb County, Georgia",1822,1578,244,13.3918770582
1282,1500000US130670305071,130670305071,"Block Group 1, Census Tract 305.07, Cobb County, Georgia",3123,2879,244,7.8130003202
1283,1500000US130670305072,130670305072,"Block Group 2, Census Tract 305.07, Cobb County, Georgia",1910,1761,149,7.80104712042
1284,1500000US130670306011,130670306011,"Block Group 1, Census Tract 306.01, Cobb County, Georgia",3225,2923,302,9.36434108527
1285,1500000US130670306012,130670306012,"Block Group 2, Census Tract 306.01, Cobb County, Georgia",1345,1295,50,3.71747211896
1286,1500000US130670306013,130670306013,"Block Group 3, Census Tract 306.01, Cobb County, Georgia",4539,4180,359,7.90923110817
1287,1500000US130670306021,130670306021,"Block Group 1, Census Tract 306.02, Cobb County, Georgia",2886,2839,47,1.62855162855
1288,1500000US130670306022,130670306022,"Block Group 2, Census Tract 306.02, Cobb County, Georgia",343,326,17,4.95626822157
1289,1500000US130670306023,130670306023,"Block Group 3, Census Tract 306.02, Cobb County, Georgia",2442,2203,239,9.78705978706
1290,1500000US130670306024,130670306024,"Block Group 4, Census Tract 306.02, Cobb County, Georgia",975,937,38,3.89743589744
1291,1500000US130670307001,130670307001,"Block Group 1, Census Tract 307, Cobb County, Georgia",1388,1005,383,27.5936599424
1292,1500000US130670307002,130670307002,"Block Group 2, Census Tract 307, Cobb County, Georgia",1004,914,90,8.96414342629
1293,1500000US130670307003,130670307003,"Block Group 3, Census Tract 307, Cobb County, Georgia",818,682,136,16.6259168704
1294,1500000US130670307004,130670307004,"Block Group 4, Census Tract 307, Cobb County, Georgia",654,528,126,19.2660550459
1295,1500000US130670308001,130670308001,"Block Group 1, Census Tract 308, Cobb County, Georgia",1187,577,610,51.3900589722
1296,1500000US130670308002,130670308002,"Block Group 2, Census Tract 308, Cobb County, Georgia",3013,1922,1091,36.2097577166
1297,1500000US130670308003,130670308003,"Block Group 3, Census Tract 308, Cobb County, Georgia",1113,989,124,11.1410601977
1298,1500000US130670309011,130670309011,"Block Group 1, Census Tract 309.01, Cobb County, Georgia",589,530,59,10.0169779287
1299,1500000US130670309012,130670309012,"Block Group 2, Census Tract 309.01, Cobb County, Georgia",1134,1134,0,0.0
1300,1500000US130670309013,130670309013,"Block Group 3, Census Tract 309.01, Cobb County, Georgia",1759,1759,0,0.0
1301,1500000US130670309014,130670309014,"Block Group 4, Census Tract 309.01, Cobb County, Georgia",1229,1229,0,0.0
1302,1500000US130670309015,130670309015,"Block Group 5, Census Tract 309.01, Cobb County, Georgia",2747,2423,324,11.794685111
1303,1500000US130670309021,130670309021,"Block Group 1, Census Tract 309.02, Cobb County, Georgia",1304,799,505,38.726993865
1304,1500000US130670309022,130670309022,"Block Group 2, Census Tract 309.02, Cobb County, Georgia",2287,1198,1089,47.6169654569
1305,1500000US130670309023,130670309023,"Block Group 3, Census Tract 309.02, Cobb County, Georgia",1354,1354,0,0.0
1306,1500000US130670309024,130670309024,"Block Group 4, Census Tract 309.02, Cobb County, Georgia",840,578,262,31.1904761905
1307,1500000US130670309041,130670309041,"Block Group 1, Census Tract 309.04, Cobb County, Georgia",1529,586,943,61.6742969261
1308,1500000US130670309042,130670309042,"Block Group 2, Census Tract 309.04, Cobb County, Georgia",1723,1572,151,8.7637840975
1309,1500000US130670309043,130670309043,"Block Group 3, Census Tract 309.04, Cobb County, Georgia",1679,1283,396,23.5854675402
1310,1500000US130670309044,130670309044,"Block Group 4, Census Tract 309.04, Cobb County, Georgia",1615,1122,493,30.5263157895
1311,1500000US130670309051,130670309051,"Block Group 1, Census Tract 309.05, Cobb County, Georgia",2934,2623,311,10.5998636673
1312,1500000US130670309052,130670309052,"Block Group 2, Census Tract 309.05, Cobb County, Georgia",833,668,165,19.8079231693
1313,1500000US130670309053,130670309053,"Block Group 3, Census Tract 309.05, Cobb County, Georgia",3511,2086,1425,40.5867274281
1314,1500000US130670309054,130670309054,"Block Group 4, Census Tract 309.05, Cobb County, Georgia",930,597,333,35.8064516129
1315,1500000US130670310011,130670310011,"Block Group 1, Census Tract 310.01, Cobb County, Georgia",1634,637,997,61.0159118727
1316,1500000US130670310012,130670310012,"Block Group 2, Census Tract 310.01, Cobb County, Georgia",946,577,369,39.0063424947
1317,1500000US130670310013,130670310013,"Block Group 3, Census Tract 310.01, Cobb County, Georgia",2987,1572,1415,47.3719450954
1318,1500000US130670310021,130670310021,"Block Group 1, Census Tract 310.02, Cobb County, Georgia",3679,1634,2045,55.5857569992
1319,1500000US130670310022,130670310022,"Block Group 2, Census Tract 310.02, Cobb County, Georgia",1848,954,894,48.3766233766
1320,1500000US130670310023,130670310023,"Block Group 3, Census Tract 310.02, Cobb County, Georgia",1960,1231,729,37.193877551
1321,1500000US130670310024,130670310024,"Block Group 4, Census Tract 310.02, Cobb County, Georgia",2227,1709,518,23.2599910193
1322,1500000US130670310041,130670310041,"Block Group 1, Census Tract 310.04, Cobb County, Georgia",2770,1358,1412,50.9747292419
1323,1500000US130670310042,130670310042,"Block Group 2, Census Tract 310.04, Cobb County, Georgia",1088,877,211,19.3933823529
1324,1500000US130670310043,130670310043,"Block Group 3, Census Tract 310.04, Cobb County, Georgia",2414,1464,950,39.3537696769
1325,1500000US130670310044,130670310044,"Block Group 4, Census Tract 310.04, Cobb County, Georgia",1269,1229,40,3.15208825847
1326,1500000US130670310051,130670310051,"Block Group 1, Census Tract 310.05, Cobb County, Georgia",2988,2115,873,29.2168674699
1327,1500000US130670310052,130670310052,"Block Group 2, Census Tract 310.05, Cobb County, Georgia",2558,1735,823,32.173573104
1328,1500000US130670311011,130670311011,"Block Group 1, Census Tract 311.01, Cobb County, Georgia",2153,1257,896,41.6163492801
1329,1500000US130670311012,130670311012,"Block Group 2, Census Tract 311.01, Cobb County, Georgia",1322,807,515,38.9561270802
1330,1500000US130670311013,130670311013,"Block Group 3, Census Tract 311.01, Cobb County, Georgia",1236,847,389,31.4724919094
1331,1500000US130670311061,130670311061,"Block Group 1, Census Tract 311.06, Cobb County, Georgia",1400,1400,0,0.0
1332,1500000US130670311062,130670311062,"Block Group 2, Census Tract 311.06, Cobb County, Georgia",2744,2340,404,14.72303207
1333,1500000US130670311063,130670311063,"Block Group 3, Census Tract 311.06, Cobb County, Georgia",1841,1624,217,11.7870722433
1334,1500000US130670311064,130670311064,"Block Group 4, Census Tract 311.06, Cobb County, Georgia",2923,2013,910,31.132398221
1335,1500000US130670311081,130670311081,"Block Group 1, Census Tract 311.08, Cobb County, Georgia",591,591,0,0.0
1336,1500000US130670311082,130670311082,"Block Group 2, Census Tract 311.08, Cobb County, Georgia",539,493,46,8.53432282004
1337,1500000US130670311083,130670311083,"Block Group 3, Census Tract 311.08, Cobb County, Georgia",2725,2403,322,11.8165137615
1338,1500000US130670311084,130670311084,"Block Group 4, Census Tract 311.08, Cobb County, Georgia",1452,1235,217,14.9449035813
1339,1500000US130670311101,130670311101,"Block Group 1, Census Tract 311.10, Cobb County, Georgia",2521,1742,779,30.9004363348
1340,1500000US130670311102,130670311102,"Block Group 2, Census Tract 311.10, Cobb County, Georgia",1017,921,96,9.4395280236
1341,1500000US130670311111,130670311111,"Block Group 1, Census Tract 311.11, Cobb County, Georgia",1976,1911,65,3.28947368421
1342,1500000US130670311112,130670311112,"Block Group 2, Census Tract 311.11, Cobb County, Georgia",1462,1333,129,8.82352941176
1343,1500000US130670311121,130670311121,"Block Group 1, Census Tract 311.12, Cobb County, Georgia",711,679,32,4.50070323488
1344,1500000US130670311122,130670311122,"Block Group 2, Census Tract 311.12, Cobb County, Georgia",1952,1673,279,14.2930327869
1345,1500000US130670311123,130670311123,"Block Group 3, Census Tract 311.12, Cobb County, Georgia",2662,2581,81,3.04282494365
1346,1500000US130670311131,130670311131,"Block Group 1, Census Tract 311.13, Cobb County, Georgia",942,741,201,21.3375796178
1347,1500000US130670311141,130670311141,"Block Group 1, Census Tract 311.14, Cobb County, Georgia",3471,2357,1114,32.094497263
1348,1500000US130670311142,130670311142,"Block Group 2, Census Tract 311.14, Cobb County, Georgia",1893,1796,97,5.12414157422
1349,1500000US130670311143,130670311143,"Block Group 3, Census Tract 311.14, Cobb County, Georgia",1560,1250,310,19.8717948718
1350,1500000US130670311144,130670311144,"Block Group 4, Census Tract 311.14, Cobb County, Georgia",529,133,396,74.8582230624
1351,1500000US130670311151,130670311151,"Block Group 1, Census Tract 311.15, Cobb County, Georgia",2238,1303,935,41.7783735478
1352,1500000US130670311152,130670311152,"Block Group 2, Census Tract 311.15, Cobb County, Georgia",2721,2155,566,20.8011760382
1353,1500000US130670311161,130670311161,"Block Group 1, Census Tract 311.16, Cobb County, Georgia",2319,1590,729,31.4359637775
1354,1500000US130670311162,130670311162,"Block Group 2, Census Tract 311.16, Cobb County, Georgia",1681,756,925,55.0267697799
1355,1500000US130670311163,130670311163,"Block Group 3, Census Tract 311.16, Cobb County, Georgia",169,79,90,53.2544378698
1356,1500000US130670311171,130670311171,"Block Group 1, Census Tract 311.17, Cobb County, Georgia",2685,2068,617,22.9795158287
1357,1500000US130670311172,130670311172,"Block Group 2, Census Tract 311.17, Cobb County, Georgia",1768,1756,12,0.678733031674
1358,1500000US130670311173,130670311173,"Block Group 3, Census Tract 311.17, Cobb County, Georgia",844,766,78,9.24170616114
1359,1500000US130670311181,130670311181,"Block Group 1, Census Tract 311.18, Cobb County, Georgia",1471,1429,42,2.85520054385
1360,1500000US130670311182,130670311182,"Block Group 2, Census Tract 311.18, Cobb County, Georgia",2204,2076,128,5.80762250454
1361,1500000US130670311183,130670311183,"Block Group 3, Census Tract 311.18, Cobb County, Georgia",2040,1905,135,6.61764705882
1362,1500000US130670312051,130670312051,"Block Group 1, Census Tract 312.05, Cobb County, Georgia",1450,1350,100,6.89655172414
1363,1500000US130670312052,130670312052,"Block Group 2, Census Tract 312.05, Cobb County, Georgia",2256,1955,301,13.3421985816
1364,1500000US130670312053,130670312053,"Block Group 3, Census Tract 312.05, Cobb County, Georgia",2103,1619,484,23.0147408464
1365,1500000US130670312061,130670312061,"Block Group 1, Census Tract 312.06, Cobb County, Georgia",5457,5120,337,6.17555433388
1366,1500000US130670312062,130670312062,"Block Group 2, Census Tract 312.06, Cobb County, Georgia",602,581,21,3.48837209302
1367,1500000US130670312063,130670312063,"Block Group 3, Census Tract 312.06, Cobb County, Georgia",3971,3913,58,1.46058927222
1368,1500000US130670312071,130670312071,"Block Group 1, Census Tract 312.07, Cobb County, Georgia",1033,1033,0,0.0
1369,1500000US130670312072,130670312072,"Block Group 2, Census Tract 312.07, Cobb County, Georgia",2058,2009,49,2.38095238095
1370,1500000US130670312073,130670312073,"Block Group 3, Census Tract 312.07, Cobb County, Georgia",877,851,26,2.96465222349
1371,1500000US130670312081,130670312081,"Block Group 1, Census Tract 312.08, Cobb County, Georgia",556,513,43,7.73381294964
1372,1500000US130670312082,130670312082,"Block Group 2, Census Tract 312.08, Cobb County, Georgia",1953,1953,0,0.0
1373,1500000US130670312083,130670312083,"Block Group 3, Census Tract 312.08, Cobb County, Georgia",3833,3416,417,10.8792068876
1374,1500000US130670312091,130670312091,"Block Group 1, Census Tract 312.09, Cobb County, Georgia",2794,2602,192,6.87186828919
1375,1500000US130670312092,130670312092,"Block Group 2, Census Tract 312.09, Cobb County, Georgia",1378,1252,126,9.14368650218
1376,1500000US130670312111,130670312111,"Block Group 1, Census Tract 312.11, Cobb County, Georgia",360,360,0,0.0
1377,1500000US130670312112,130670312112,"Block Group 2, Census Tract 312.11, Cobb County, Georgia",3087,2810,277,8.97311305475
1378,1500000US130670312113,130670312113,"Block Group 3, Census Tract 312.11, Cobb County, Georgia",525,393,132,25.1428571429
1379,1500000US130670312121,130670312121,"Block Group 1, Census Tract 312.12, Cobb County, Georgia",2476,2408,68,2.74636510501
1380,1500000US130670313061,130670313061,"Block Group 1, Census Tract 313.06, Cobb County, Georgia",2480,2266,214,8.62903225806
1381,1500000US130670313062,130670313062,"Block Group 2, Census Tract 313.06, Cobb County, Georgia",1504,1366,138,9.17553191489
1382,1500000US130670313071,130670313071,"Block Group 1, Census Tract 313.07, Cobb County, Georgia",925,925,0,0.0
1383,1500000US130670313072,130670313072,"Block Group 2, Census Tract 313.07, Cobb County, Georgia",2368,1939,429,18.1165540541
1384,1500000US130670313073,130670313073,"Block Group 3, Census Tract 313.07, Cobb County, Georgia",2311,2311,0,0.0
1385,1500000US130670313081,130670313081,"Block Group 1, Census Tract 313.08, Cobb County, Georgia",924,634,290,31.3852813853
1386,1500000US130670313082,130670313082,"Block Group 2, Census Tract 313.08, Cobb County, Georgia",2190,1333,857,39.1324200913
1387,1500000US130670313083,130670313083,"Block Group 3, Census Tract 313.08, Cobb County, Georgia",2403,1772,631,26.2588431128
1388,1500000US130670313091,130670313091,"Block Group 1, Census Tract 313.09, Cobb County, Georgia",1516,722,794,52.3746701847
1389,1500000US130670313092,130670313092,"Block Group 2, Census Tract 313.09, Cobb County, Georgia",1869,1777,92,4.92241840556
1390,1500000US130670313093,130670313093,"Block Group 3, Census Tract 313.09, Cobb County, Georgia",2941,1933,1008,34.2740564434
1391,1500000US130670313094,130670313094,"Block Group 4, Census Tract 313.09, Cobb County, Georgia",2030,1991,39,1.92118226601
1392,1500000US130670313101,130670313101,"Block Group 1, Census Tract 313.10, Cobb County, Georgia",1698,1603,95,5.59481743227
1393,1500000US130670313102,130670313102,"Block Group 2, Census Tract 313.10, Cobb County, Georgia",3504,1751,1753,50.0285388128
1394,1500000US130670313103,130670313103,"Block Group 3, Census Tract 313.10, Cobb County, Georgia",2440,1862,578,23.6885245902
1395,1500000US130670313111,130670313111,"Block Group 1, Census Tract 313.11, Cobb County, Georgia",3783,2869,914,24.1607190061
1396,1500000US130670313112,130670313112,"Block Group 2, Census Tract 313.11, Cobb County, Georgia",2733,2645,88,3.21990486645
1397,1500000US130670313113,130670313113,"Block Group 3, Census Tract 313.11, Cobb County, Georgia",2887,2419,468,16.210599238
1398,1500000US130670313121,130670313121,"Block Group 1, Census Tract 313.12, Cobb County, Georgia",1343,1135,208,15.487714073
1399,1500000US130670313122,130670313122,"Block Group 2, Census Tract 313.12, Cobb County, Georgia",563,558,5,0.88809946714
1400,1500000US130670313123,130670313123,"Block Group 3, Census Tract 313.12, Cobb County, Georgia",4775,4102,673,14.0942408377
1401,1500000US130670313124,130670313124,"Block Group 4, Census Tract 313.12, Cobb County, Georgia",2872,2165,707,24.6169916435
1402,1500000US130670313131,130670313131,"Block Group 1, Census Tract 313.13, Cobb County, Georgia",7154,6239,915,12.7900475259
1403,1500000US130670313132,130670313132,"Block Group 2, Census Tract 313.13, Cobb County, Georgia",3176,2920,256,8.0604534005
1404,1500000US130670314041,130670314041,"Block Group 1, Census Tract 314.04, Cobb County, Georgia",1019,893,126,12.365063788
1405,1500000US130670314042,130670314042,"Block Group 2, Census Tract 314.04, Cobb County, Georgia",2996,2670,326,10.8811748999
1406,1500000US130670314043,130670314043,"Block Group 3, Census Tract 314.04, Cobb County, Georgia",1284,1117,167,13.0062305296
1407,1500000US130670314044,130670314044,"Block Group 4, Census Tract 314.04, Cobb County, Georgia",458,458,0,0.0
1408,1500000US130670314051,130670314051,"Block Group 1, Census Tract 314.05, Cobb County, Georgia",1690,1232,458,27.100591716
1409,1500000US130670314052,130670314052,"Block Group 2, Census Tract 314.05, Cobb County, Georgia",2892,2760,132,4.5643153527
1410,1500000US130670314053,130670314053,"Block Group 3, Census Tract 314.05, Cobb County, Georgia",1181,496,685,58.0016934801
1411,1500000US130670314054,130670314054,"Block Group 4, Census Tract 314.05, Cobb County, Georgia",1517,1149,368,24.2584047462
1412,1500000US130670314055,130670314055,"Block Group 5, Census Tract 314.05, Cobb County, Georgia",1123,1038,85,7.56901157614
1413,1500000US130670314061,130670314061,"Block Group 1, Census Tract 314.06, Cobb County, Georgia",1025,900,125,12.1951219512
1414,1500000US130670314062,130670314062,"Block Group 2, Census Tract 314.06, Cobb County, Georgia",3000,2487,513,17.1
1415,1500000US130670314063,130670314063,"Block Group 3, Census Tract 314.06, Cobb County, Georgia",3561,3248,313,8.78966582421
1416,1500000US130670314081,130670314081,"Block Group 1, Census Tract 314.08, Cobb County, Georgia",838,664,174,20.7637231504
1417,1500000US130670314082,130670314082,"Block Group 2, Census Tract 314.08, Cobb County, Georgia",3646,3514,132,3.6204059243
1418,1500000US130670314083,130670314083,"Block Group 3, Census Tract 314.08, Cobb County, Georgia",1156,1156,0,0.0
1419,1500000US130670314091,130670314091,"Block Group 1, Census Tract 314.09, Cobb County, Georgia",2805,2269,536,19.1087344029
1420,1500000US130670314092,130670314092,"Block Group 2, Census Tract 314.09, Cobb County, Georgia",2175,1947,228,10.4827586207
1421,1500000US130670315031,130670315031,"Block Group 1, Census Tract 315.03, Cobb County, Georgia",1408,1364,44,3.125
1422,1500000US130670315032,130670315032,"Block Group 2, Census Tract 315.03, Cobb County, Georgia",3054,2739,315,10.3143418468
1423,1500000US130670315033,130670315033,"Block Group 3, Census Tract 315.03, Cobb County, Georgia",3451,2545,906,26.2532599247
1424,1500000US130670315034,130670315034,"Block Group 4, Census Tract 315.03, Cobb County, Georgia",2159,1937,222,10.2825382121
1425,1500000US130670315051,130670315051,"Block Group 1, Census Tract 315.05, Cobb County, Georgia",2454,2220,234,9.53545232274
1426,1500000US130670315052,130670315052,"Block Group 2, Census Tract 315.05, Cobb County, Georgia",1652,1447,205,12.4092009685
1427,1500000US130670315053,130670315053,"Block Group 3, Census Tract 315.05, Cobb County, Georgia",1853,1820,33,1.78089584458
1428,1500000US130670315061,130670315061,"Block Group 1, Census Tract 315.06, Cobb County, Georgia",2092,1855,237,11.3288718929
1429,1500000US130670315062,130670315062,"Block Group 2, Census Tract 315.06, Cobb County, Georgia",1885,1363,522,27.6923076923
1430,1500000US130670315063,130670315063,"Block Group 3, Census Tract 315.06, Cobb County, Georgia",627,559,68,10.8452950558
1431,1500000US130670315071,130670315071,"Block Group 1, Census Tract 315.07, Cobb County, Georgia",2256,1911,345,15.2925531915
1432,1500000US130670315072,130670315072,"Block Group 2, Census Tract 315.07, Cobb County, Georgia",1474,1459,15,1.01763907734
1433,1500000US130670315081,130670315081,"Block Group 1, Census Tract 315.08, Cobb County, Georgia",1651,1559,92,5.57238037553
1434,1500000US130670315082,130670315082,"Block Group 2, Census Tract 315.08, Cobb County, Georgia",3422,2782,640,18.7025131502
1435,1500000US130670315091,130670315091,"Block Group 1, Census Tract 315.09, Cobb County, Georgia",2363,2247,116,4.9090139653
1436,1500000US130670315092,130670315092,"Block Group 2, Census Tract 315.09, Cobb County, Georgia",1958,1495,463,23.646578141
1437,1500000US130670315093,130670315093,"Block Group 3, Census Tract 315.09, Cobb County, Georgia",1703,1637,66,3.87551379918
1438,1500000US130670315094,130670315094,"Block Group 4, Census Tract 315.09, Cobb County, Georgia",2097,1956,141,6.72389127325
1439,1500000US130670315095,130670315095,"Block Group 5, Census Tract 315.09, Cobb County, Georgia",2018,1984,34,1.68483647175
1440,1500000US130690101001,130690101001,"Block Group 1, Census Tract 101, Coffee County, Georgia",811,801,10,1.23304562269
1441,1500000US130690101002,130690101002,"Block Group 2, Census Tract 101, Coffee County, Georgia",708,608,100,14.1242937853
1442,1500000US130690101003,130690101003,"Block Group 3, Census Tract 101, Coffee County, Georgia",1917,1687,230,11.9979134064
1443,1500000US130690102001,130690102001,"Block Group 1, Census Tract 102, Coffee County, Georgia",1884,1589,295,15.6581740977
1444,1500000US130690102002,130690102002,"Block Group 2, Census Tract 102, Coffee County, Georgia",1033,855,178,17.2313649564
1445,1500000US130690103001,130690103001,"Block Group 1, Census Tract 103, Coffee County, Georgia",1624,1367,257,15.8251231527
1446,1500000US130690103002,130690103002,"Block Group 2, Census Tract 103, Coffee County, Georgia",4501,4167,334,7.42057320595
1447,1500000US130690104001,130690104001,"Block Group 1, Census Tract 104, Coffee County, Georgia",2172,2070,102,4.69613259669
1448,1500000US130690104002,130690104002,"Block Group 2, Census Tract 104, Coffee County, Georgia",386,386,0,0.0
1449,1500000US130690104003,130690104003,"Block Group 3, Census Tract 104, Coffee County, Georgia",706,679,27,3.82436260623
1450,1500000US130690104004,130690104004,"Block Group 4, Census Tract 104, Coffee County, Georgia",1134,1134,0,0.0
1451,1500000US130690105001,130690105001,"Block Group 1, Census Tract 105, Coffee County, Georgia",731,523,208,28.4541723666
1452,1500000US130690105002,130690105002,"Block Group 2, Census Tract 105, Coffee County, Georgia",691,605,86,12.4457308249
1453,1500000US130690105003,130690105003,"Block Group 3, Census Tract 105, Coffee County, Georgia",2063,1871,192,9.30683470674
1454,1500000US130690106001,130690106001,"Block Group 1, Census Tract 106, Coffee County, Georgia",2806,2708,98,3.49251603706
1455,1500000US130690106002,130690106002,"Block Group 2, Census Tract 106, Coffee County, Georgia",1371,1208,163,11.8891320204
1456,1500000US130690106003,130690106003,"Block Group 3, Census Tract 106, Coffee County, Georgia",1474,1469,5,0.33921302578
1457,1500000US130690107001,130690107001,"Block Group 1, Census Tract 107, Coffee County, Georgia",1431,1267,164,11.4605171209
1458,1500000US130690107002,130690107002,"Block Group 2, Census Tract 107, Coffee County, Georgia",1456,1312,144,9.89010989011
1459,1500000US130690107003,130690107003,"Block Group 3, Census Tract 107, Coffee County, Georgia",756,717,39,5.15873015873
1460,1500000US130690107004,130690107004,"Block Group 4, Census Tract 107, Coffee County, Georgia",3138,1870,1268,40.407903123
1461,1500000US130690108011,130690108011,"Block Group 1, Census Tract 108.01, Coffee County, Georgia",2158,2019,139,6.44114921223
1462,1500000US130690108012,130690108012,"Block Group 2, Census Tract 108.01, Coffee County, Georgia",2695,2385,310,11.5027829314
1463,1500000US130690108013,130690108013,"Block Group 3, Census Tract 108.01, Coffee County, Georgia",827,827,0,0.0
1464,1500000US130690108021,130690108021,"Block Group 1, Census Tract 108.02, Coffee County, Georgia",1004,970,34,3.38645418327
1465,1500000US130690108022,130690108022,"Block Group 2, Census Tract 108.02, Coffee County, Georgia",1992,1751,241,12.0983935743
1466,1500000US130690108023,130690108023,"Block Group 3, Census Tract 108.02, Coffee County, Georgia",1534,1486,48,3.12907431551
1467,1500000US130719701001,130719701001,"Block Group 1, Census Tract 9701, Colquitt County, Georgia",2414,1865,549,22.7423363712
1468,1500000US130719701002,130719701002,"Block Group 2, Census Tract 9701, Colquitt County, Georgia",2955,2509,446,15.0930626058
1469,1500000US130719702001,130719702001,"Block Group 1, Census Tract 9702, Colquitt County, Georgia",1554,1480,74,4.7619047619
1470,1500000US130719702002,130719702002,"Block Group 2, Census Tract 9702, Colquitt County, Georgia",1366,1355,11,0.805270863836
1471,1500000US130719703001,130719703001,"Block Group 1, Census Tract 9703, Colquitt County, Georgia",1294,1237,57,4.40494590417
1472,1500000US130719703002,130719703002,"Block Group 2, Census Tract 9703, Colquitt County, Georgia",1406,990,416,29.5874822191
1473,1500000US130719703003,130719703003,"Block Group 3, Census Tract 9703, Colquitt County, Georgia",819,819,0,0.0
1474,1500000US130719703004,130719703004,"Block Group 4, Census Tract 9703, Colquitt County, Georgia",521,521,0,0.0
1475,1500000US130719703005,130719703005,"Block Group 5, Census Tract 9703, Colquitt County, Georgia",1095,1095,0,0.0
1476,1500000US130719704001,130719704001,"Block Group 1, Census Tract 9704, Colquitt County, Georgia",1313,1138,175,13.3282559025
1477,1500000US130719704002,130719704002,"Block Group 2, Census Tract 9704, Colquitt County, Georgia",1059,932,127,11.9924457035
1478,1500000US130719704003,130719704003,"Block Group 3, Census Tract 9704, Colquitt County, Georgia",1111,741,370,33.303330333
1479,1500000US130719705001,130719705001,"Block Group 1, Census Tract 9705, Colquitt County, Georgia",1716,1382,334,19.4638694639
1480,1500000US130719705002,130719705002,"Block Group 2, Census Tract 9705, Colquitt County, Georgia",1651,1498,153,9.26711084191
1481,1500000US130719706001,130719706001,"Block Group 1, Census Tract 9706, Colquitt County, Georgia",2253,1524,729,32.3568575233
1482,1500000US130719706002,130719706002,"Block Group 2, Census Tract 9706, Colquitt County, Georgia",2082,1161,921,44.2363112392
1483,1500000US130719706003,130719706003,"Block Group 3, Census Tract 9706, Colquitt County, Georgia",2252,2119,133,5.90586145648
1484,1500000US130719707011,130719707011,"Block Group 1, Census Tract 9707.01, Colquitt County, Georgia",1386,1349,37,2.66955266955
1485,1500000US130719707012,130719707012,"Block Group 2, Census Tract 9707.01, Colquitt County, Georgia",1338,1338,0,0.0
1486,1500000US130719707013,130719707013,"Block Group 3, Census Tract 9707.01, Colquitt County, Georgia",3103,2473,630,20.3029326458
1487,1500000US130719707014,130719707014,"Block Group 4, Census Tract 9707.01, Colquitt County, Georgia",1121,840,281,25.0669045495
1488,1500000US130719707021,130719707021,"Block Group 1, Census Tract 9707.02, Colquitt County, Georgia",2287,1562,725,31.7009182335
1489,1500000US130719708001,130719708001,"Block Group 1, Census Tract 9708, Colquitt County, Georgia",1650,1115,535,32.4242424242
1490,1500000US130719708002,130719708002,"Block Group 2, Census Tract 9708, Colquitt County, Georgia",763,594,169,22.1494102228
1491,1500000US130719708003,130719708003,"Block Group 3, Census Tract 9708, Colquitt County, Georgia",475,308,167,35.1578947368
1492,1500000US130719708004,130719708004,"Block Group 4, Census Tract 9708, Colquitt County, Georgia",368,343,25,6.79347826087
1493,1500000US130719709001,130719709001,"Block Group 1, Census Tract 9709, Colquitt County, Georgia",1962,1655,307,15.6472986748
1494,1500000US130719709002,130719709002,"Block Group 2, Census Tract 9709, Colquitt County, Georgia",1177,1177,0,0.0
1495,1500000US130719709003,130719709003,"Block Group 3, Census Tract 9709, Colquitt County, Georgia",2146,1306,840,39.1425908667
1496,1500000US130719709004,130719709004,"Block Group 4, Census Tract 9709, Colquitt County, Georgia",1387,1282,105,7.57029560202
1497,1500000US130730301021,130730301021,"Block Group 1, Census Tract 301.02, Columbia County, Georgia",965,965,0,0.0
1498,1500000US130730301022,130730301022,"Block Group 2, Census Tract 301.02, Columbia County, Georgia",2139,2089,50,2.33754090697
1499,1500000US130730301023,130730301023,"Block Group 3, Census Tract 301.02, Columbia County, Georgia",2195,2086,109,4.96583143508
1500,1500000US130730301024,130730301024,"Block Group 4, Census Tract 301.02, Columbia County, Georgia",2591,2576,15,0.578927055191
1501,1500000US130730301025,130730301025,"Block Group 5, Census Tract 301.02, Columbia County, Georgia",2036,1914,122,5.99214145383
1502,1500000US130730301031,130730301031,"Block Group 1, Census Tract 301.03, Columbia County, Georgia",3362,3218,144,4.28316478287
1503,1500000US130730301051,130730301051,"Block Group 1, Census Tract 301.05, Columbia County, Georgia",1554,1536,18,1.1583011583
1504,1500000US130730301052,130730301052,"Block Group 2, Census Tract 301.05, Columbia County, Georgia",3243,3076,167,5.14955288313
1505,1500000US130730301053,130730301053,"Block Group 3, Census Tract 301.05, Columbia County, Georgia",727,727,0,0.0
1506,1500000US130730301061,130730301061,"Block Group 1, Census Tract 301.06, Columbia County, Georgia",2573,2466,107,4.15856976292
1507,1500000US130730301062,130730301062,"Block Group 2, Census Tract 301.06, Columbia County, Georgia",1270,1251,19,1.49606299213
1508,1500000US130730302011,130730302011,"Block Group 1, Census Tract 302.01, Columbia County, Georgia",2229,2174,55,2.46747420368
1509,1500000US130730302012,130730302012,"Block Group 2, Census Tract 302.01, Columbia County, Georgia",3312,3293,19,0.573671497585
1510,1500000US130730302013,130730302013,"Block Group 3, Census Tract 302.01, Columbia County, Georgia",820,739,81,9.87804878049
1511,1500000US130730302021,130730302021,"Block Group 1, Census Tract 302.02, Columbia County, Georgia",3261,2966,295,9.04630481447
1512,1500000US130730302031,130730302031,"Block Group 1, Census Tract 302.03, Columbia County, Georgia",1456,1456,0,0.0
1513,1500000US130730302032,130730302032,"Block Group 2, Census Tract 302.03, Columbia County, Georgia",1417,1329,88,6.21030345801
1514,1500000US130730302033,130730302033,"Block Group 3, Census Tract 302.03, Columbia County, Georgia",792,792,0,0.0
1515,1500000US130730302034,130730302034,"Block Group 4, Census Tract 302.03, Columbia County, Georgia",2665,2665,0,0.0
1516,1500000US130730303021,130730303021,"Block Group 1, Census Tract 303.02, Columbia County, Georgia",1299,1281,18,1.3856812933
1517,1500000US130730303022,130730303022,"Block Group 2, Census Tract 303.02, Columbia County, Georgia",3518,3342,176,5.00284252416
1518,1500000US130730303023,130730303023,"Block Group 3, Census Tract 303.02, Columbia County, Georgia",941,941,0,0.0
1519,1500000US130730303024,130730303024,"Block Group 4, Census Tract 303.02, Columbia County, Georgia",1758,1719,39,2.21843003413
1520,1500000US130730303025,130730303025,"Block Group 5, Census Tract 303.02, Columbia County, Georgia",3012,2610,402,13.3466135458
1521,1500000US130730303041,130730303041,"Block Group 1, Census Tract 303.04, Columbia County, Georgia",1724,1707,17,0.986078886311
1522,1500000US130730303042,130730303042,"Block Group 2, Census Tract 303.04, Columbia County, Georgia",5469,5252,217,3.96781861401
1523,1500000US130730303061,130730303061,"Block Group 1, Census Tract 303.06, Columbia County, Georgia",3610,3467,143,3.96121883657
1524,1500000US130730303062,130730303062,"Block Group 2, Census Tract 303.06, Columbia County, Georgia",1977,1653,324,16.3884673748
1525,1500000US130730303071,130730303071,"Block Group 1, Census Tract 303.07, Columbia County, Georgia",1432,1369,63,4.39944134078
1526,1500000US130730303072,130730303072,"Block Group 2, Census Tract 303.07, Columbia County, Georgia",1556,1543,13,0.835475578406
1527,1500000US130730303073,130730303073,"Block Group 3, Census Tract 303.07, Columbia County, Georgia",2619,2619,0,0.0
1528,1500000US130730303074,130730303074,"Block Group 4, Census Tract 303.07, Columbia County, Georgia",1366,1163,203,14.8609077599
1529,1500000US130730303081,130730303081,"Block Group 1, Census Tract 303.08, Columbia County, Georgia",3320,3292,28,0.843373493976
1530,1500000US130730303082,130730303082,"Block Group 2, Census Tract 303.08, Columbia County, Georgia",6402,5623,779,12.1680724774
1531,1500000US130730303091,130730303091,"Block Group 1, Census Tract 303.09, Columbia County, Georgia",4409,4336,73,1.65570424132
1532,1500000US130730303092,130730303092,"Block Group 2, Census Tract 303.09, Columbia County, Georgia",1740,1740,0,0.0
1533,1500000US130730303093,130730303093,"Block Group 3, Census Tract 303.09, Columbia County, Georgia",2071,2029,42,2.0280057943
1534,1500000US130730303094,130730303094,"Block Group 4, Census Tract 303.09, Columbia County, Georgia",2780,2764,16,0.575539568345
1535,1500000US130730304011,130730304011,"Block Group 1, Census Tract 304.01, Columbia County, Georgia",1267,1224,43,3.39384372534
1536,1500000US130730304012,130730304012,"Block Group 2, Census Tract 304.01, Columbia County, Georgia",1028,1028,0,0.0
1537,1500000US130730304021,130730304021,"Block Group 1, Census Tract 304.02, Columbia County, Georgia",2013,1732,281,13.9592647789
1538,1500000US130730304022,130730304022,"Block Group 2, Census Tract 304.02, Columbia County, Georgia",5668,4938,730,12.8793225124
1539,1500000US130730304023,130730304023,"Block Group 3, Census Tract 304.02, Columbia County, Georgia",2060,2006,54,2.6213592233
1540,1500000US130730305031,130730305031,"Block Group 1, Census Tract 305.03, Columbia County, Georgia",2541,2307,234,9.20897284534
1541,1500000US130730305032,130730305032,"Block Group 2, Census Tract 305.03, Columbia County, Georgia",2419,2340,79,3.26581231914
1542,1500000US130730305033,130730305033,"Block Group 3, Census Tract 305.03, Columbia County, Georgia",2805,2760,45,1.60427807487
1543,1500000US130730305041,130730305041,"Block Group 1, Census Tract 305.04, Columbia County, Georgia",2151,1934,217,10.0883310088
1544,1500000US130730305042,130730305042,"Block Group 2, Census Tract 305.04, Columbia County, Georgia",1184,1184,0,0.0
1545,1500000US130730305051,130730305051,"Block Group 1, Census Tract 305.05, Columbia County, Georgia",6922,5540,1382,19.9653279399
1546,1500000US130730305061,130730305061,"Block Group 1, Census Tract 305.06, Columbia County, Georgia",4869,4490,379,7.78393920723
1547,1500000US130730305062,130730305062,"Block Group 2, Census Tract 305.06, Columbia County, Georgia",975,792,183,18.7692307692
1548,1500000US130730305063,130730305063,"Block Group 3, Census Tract 305.06, Columbia County, Georgia",2516,2015,501,19.9125596184
1549,1500000US130730305064,130730305064,"Block Group 4, Census Tract 305.06, Columbia County, Georgia",3166,3041,125,3.94819962097
1550,1500000US130730306031,130730306031,"Block Group 1, Census Tract 306.03, Columbia County, Georgia",2791,2755,36,1.28986026514
1551,1500000US130730306032,130730306032,"Block Group 2, Census Tract 306.03, Columbia County, Georgia",2219,2219,0,0.0
1552,1500000US130759601001,130759601001,"Block Group 1, Census Tract 9601, Cook County, Georgia",1359,1282,77,5.66593083149
1553,1500000US130759601002,130759601002,"Block Group 2, Census Tract 9601, Cook County, Georgia",776,714,62,7.98969072165
1554,1500000US130759602001,130759602001,"Block Group 1, Census Tract 9602, Cook County, Georgia",538,517,21,3.90334572491
1555,1500000US130759602002,130759602002,"Block Group 2, Census Tract 9602, Cook County, Georgia",1137,1130,7,0.615655233069
1556,1500000US130759602003,130759602003,"Block Group 3, Census Tract 9602, Cook County, Georgia",895,883,12,1.34078212291
1557,1500000US130759602004,130759602004,"Block Group 4, Census Tract 9602, Cook County, Georgia",730,523,207,28.3561643836
1558,1500000US130759602005,130759602005,"Block Group 5, Census Tract 9602, Cook County, Georgia",601,601,0,0.0
1559,1500000US130759603001,130759603001,"Block Group 1, Census Tract 9603, Cook County, Georgia",1633,1589,44,2.69442743417
1560,1500000US130759603002,130759603002,"Block Group 2, Census Tract 9603, Cook County, Georgia",1317,1210,107,8.1245254366
1561,1500000US130759603003,130759603003,"Block Group 3, Census Tract 9603, Cook County, Georgia",1435,1263,172,11.9860627178
1562,1500000US130759603004,130759603004,"Block Group 4, Census Tract 9603, Cook County, Georgia",764,750,14,1.83246073298
1563,1500000US130759603005,130759603005,"Block Group 5, Census Tract 9603, Cook County, Georgia",885,832,53,5.98870056497
1564,1500000US130759604001,130759604001,"Block Group 1, Census Tract 9604, Cook County, Georgia",2415,2366,49,2.02898550725
1565,1500000US130759604002,130759604002,"Block Group 2, Census Tract 9604, Cook County, Georgia",1748,1654,94,5.37757437071
1566,1500000US130759604003,130759604003,"Block Group 3, Census Tract 9604, Cook County, Georgia",800,719,81,10.125
1567,1500000US130771701001,130771701001,"Block Group 1, Census Tract 1701, Coweta County, Georgia",2156,2127,29,1.34508348794
1568,1500000US130771701002,130771701002,"Block Group 2, Census Tract 1701, Coweta County, Georgia",3769,3596,173,4.59007694349
1569,1500000US130771701003,130771701003,"Block Group 3, Census Tract 1701, Coweta County, Georgia",1695,1646,49,2.89085545723
1570,1500000US130771702001,130771702001,"Block Group 1, Census Tract 1702, Coweta County, Georgia",3404,3345,59,1.73325499412
1571,1500000US130771702002,130771702002,"Block Group 2, Census Tract 1702, Coweta County, Georgia",1389,1389,0,0.0
1572,1500000US130771702003,130771702003,"Block Group 3, Census Tract 1702, Coweta County, Georgia",685,685,0,0.0
1573,1500000US130771702004,130771702004,"Block Group 4, Census Tract 1702, Coweta County, Georgia",1483,1290,193,13.0141604855
1574,1500000US130771703031,130771703031,"Block Group 1, Census Tract 1703.03, Coweta County, Georgia",5214,5082,132,2.53164556962
1575,1500000US130771703041,130771703041,"Block Group 1, Census Tract 1703.04, Coweta County, Georgia",1248,1248,0,0.0
1576,1500000US130771703042,130771703042,"Block Group 2, Census Tract 1703.04, Coweta County, Georgia",3378,3119,259,7.66725873298
1577,1500000US130771703043,130771703043,"Block Group 3, Census Tract 1703.04, Coweta County, Georgia",2118,2118,0,0.0
1578,1500000US130771703051,130771703051,"Block Group 1, Census Tract 1703.05, Coweta County, Georgia",2920,2202,718,24.5890410959
1579,1500000US130771703052,130771703052,"Block Group 2, Census Tract 1703.05, Coweta County, Georgia",5780,4357,1423,24.6193771626
1580,1500000US130771703053,130771703053,"Block Group 3, Census Tract 1703.05, Coweta County, Georgia",1883,1883,0,0.0
1581,1500000US130771703061,130771703061,"Block Group 1, Census Tract 1703.06, Coweta County, Georgia",578,578,0,0.0
1582,1500000US130771703062,130771703062,"Block Group 2, Census Tract 1703.06, Coweta County, Georgia",3631,3525,106,2.91930597632
1583,1500000US130771703063,130771703063,"Block Group 3, Census Tract 1703.06, Coweta County, Georgia",3968,3368,600,15.1209677419
1584,1500000US130771704021,130771704021,"Block Group 1, Census Tract 1704.02, Coweta County, Georgia",1623,941,682,42.0209488601
1585,1500000US130771704022,130771704022,"Block Group 2, Census Tract 1704.02, Coweta County, Georgia",4600,4447,153,3.32608695652
1586,1500000US130771704023,130771704023,"Block Group 3, Census Tract 1704.02, Coweta County, Georgia",3554,3402,152,4.27687113112
1587,1500000US130771704031,130771704031,"Block Group 1, Census Tract 1704.03, Coweta County, Georgia",1065,1065,0,0.0
1588,1500000US130771704032,130771704032,"Block Group 2, Census Tract 1704.03, Coweta County, Georgia",3407,3222,185,5.42999706487
1589,1500000US130771704041,130771704041,"Block Group 1, Census Tract 1704.04, Coweta County, Georgia",2130,2075,55,2.58215962441
1590,1500000US130771704042,130771704042,"Block Group 2, Census Tract 1704.04, Coweta County, Georgia",2216,2216,0,0.0
1591,1500000US130771704043,130771704043,"Block Group 3, Census Tract 1704.04, Coweta County, Georgia",1485,1360,125,8.41750841751
1592,1500000US130771704051,130771704051,"Block Group 1, Census Tract 1704.05, Coweta County, Georgia",2765,2423,342,12.3688969259
1593,1500000US130771704052,130771704052,"Block Group 2, Census Tract 1704.05, Coweta County, Georgia",2384,2213,171,7.17281879195
1594,1500000US130771704053,130771704053,"Block Group 3, Census Tract 1704.05, Coweta County, Georgia",2219,2037,182,8.20189274448
1595,1500000US130771704061,130771704061,"Block Group 1, Census Tract 1704.06, Coweta County, Georgia",3634,3571,63,1.73362685746
1596,1500000US130771705011,130771705011,"Block Group 1, Census Tract 1705.01, Coweta County, Georgia",2426,2078,348,14.3446001649
1597,1500000US130771705012,130771705012,"Block Group 2, Census Tract 1705.01, Coweta County, Georgia",2025,1771,254,12.5432098765
1598,1500000US130771705013,130771705013,"Block Group 3, Census Tract 1705.01, Coweta County, Georgia",2462,2304,158,6.41754670999
1599,1500000US130771705021,130771705021,"Block Group 1, Census Tract 1705.02, Coweta County, Georgia",2313,2275,38,1.64288802421
1600,1500000US130771705022,130771705022,"Block Group 2, Census Tract 1705.02, Coweta County, Georgia",2286,2190,96,4.19947506562
1601,1500000US130771705023,130771705023,"Block Group 3, Census Tract 1705.02, Coweta County, Georgia",1407,1401,6,0.426439232409
1602,1500000US130771705031,130771705031,"Block Group 1, Census Tract 1705.03, Coweta County, Georgia",1994,1584,410,20.5616850552
1603,1500000US130771705032,130771705032,"Block Group 2, Census Tract 1705.03, Coweta County, Georgia",2212,2171,41,1.85352622061
1604,1500000US130771705033,130771705033,"Block Group 3, Census Tract 1705.03, Coweta County, Georgia",1609,1539,70,4.35052827843
1605,1500000US130771706011,130771706011,"Block Group 1, Census Tract 1706.01, Coweta County, Georgia",2644,2329,315,11.9137670197
1606,1500000US130771706012,130771706012,"Block Group 2, Census Tract 1706.01, Coweta County, Georgia",1453,1453,0,0.0
1607,1500000US130771706013,130771706013,"Block Group 3, Census Tract 1706.01, Coweta County, Georgia",1981,1856,125,6.30994447249
1608,1500000US130771706014,130771706014,"Block Group 4, Census Tract 1706.01, Coweta County, Georgia",1420,1224,196,13.8028169014
1609,1500000US130771706021,130771706021,"Block Group 1, Census Tract 1706.02, Coweta County, Georgia",2349,2275,74,3.1502767135
1610,1500000US130771706022,130771706022,"Block Group 2, Census Tract 1706.02, Coweta County, Georgia",2006,1994,12,0.598205383848
1611,1500000US130771706023,130771706023,"Block Group 3, Census Tract 1706.02, Coweta County, Georgia",2936,2836,100,3.40599455041
1612,1500000US130771706024,130771706024,"Block Group 4, Census Tract 1706.02, Coweta County, Georgia",1442,1323,119,8.25242718447
1613,1500000US130771706031,130771706031,"Block Group 1, Census Tract 1706.03, Coweta County, Georgia",1235,1224,11,0.890688259109
1614,1500000US130771706032,130771706032,"Block Group 2, Census Tract 1706.03, Coweta County, Georgia",3889,3625,264,6.78837747493
1615,1500000US130771707001,130771707001,"Block Group 1, Census Tract 1707, Coweta County, Georgia",1315,1255,60,4.56273764259
1616,1500000US130771707002,130771707002,"Block Group 2, Census Tract 1707, Coweta County, Georgia",2078,2034,44,2.11742059673
1617,1500000US130771707003,130771707003,"Block Group 3, Census Tract 1707, Coweta County, Georgia",2032,2032,0,0.0
1618,1500000US130771707004,130771707004,"Block Group 4, Census Tract 1707, Coweta County, Georgia",843,843,0,0.0
1619,1500000US130771707005,130771707005,"Block Group 5, Census Tract 1707, Coweta County, Georgia",657,657,0,0.0
1620,1500000US130771708011,130771708011,"Block Group 1, Census Tract 1708.01, Coweta County, Georgia",2524,2396,128,5.07131537242
1621,1500000US130771708012,130771708012,"Block Group 2, Census Tract 1708.01, Coweta County, Georgia",3074,2881,193,6.27846454131
1622,1500000US130771708021,130771708021,"Block Group 1, Census Tract 1708.02, Coweta County, Georgia",1798,1795,3,0.166852057842
1623,1500000US130771708022,130771708022,"Block Group 2, Census Tract 1708.02, Coweta County, Georgia",2625,2586,39,1.48571428571
1624,1500000US130790701001,130790701001,"Block Group 1, Census Tract 701, Crawford County, Georgia",1582,1582,0,0.0
1625,1500000US130790701002,130790701002,"Block Group 2, Census Tract 701, Crawford County, Georgia",1336,1333,3,0.224550898204
1626,1500000US130790701003,130790701003,"Block Group 3, Census Tract 701, Crawford County, Georgia",1116,1116,0,0.0
1627,1500000US130790702011,130790702011,"Block Group 1, Census Tract 702.01, Crawford County, Georgia",1423,1412,11,0.773014757554
1628,1500000US130790702012,130790702012,"Block Group 2, Census Tract 702.01, Crawford County, Georgia",1276,1276,0,0.0
1629,1500000US130790702013,130790702013,"Block Group 3, Census Tract 702.01, Crawford County, Georgia",2501,2462,39,1.5593762495
1630,1500000US130790702021,130790702021,"Block Group 1, Census Tract 702.02, Crawford County, Georgia",1613,1601,12,0.743955362678
1631,1500000US130790702022,130790702022,"Block Group 2, Census Tract 702.02, Crawford County, Georgia",1692,1692,0,0.0
1632,1500000US130810101001,130810101001,"Block Group 1, Census Tract 101, Crisp County, Georgia",1765,1620,145,8.21529745042
1633,1500000US130810101002,130810101002,"Block Group 2, Census Tract 101, Crisp County, Georgia",1801,1801,0,0.0
1634,1500000US130810101003,130810101003,"Block Group 3, Census Tract 101, Crisp County, Georgia",1040,1040,0,0.0
1635,1500000US130810102011,130810102011,"Block Group 1, Census Tract 102.01, Crisp County, Georgia",1820,1724,96,5.27472527473
1636,1500000US130810102012,130810102012,"Block Group 2, Census Tract 102.01, Crisp County, Georgia",1095,1077,18,1.64383561644
1637,1500000US130810102013,130810102013,"Block Group 3, Census Tract 102.01, Crisp County, Georgia",913,913,0,0.0
1638,1500000US130810102014,130810102014,"Block Group 4, Census Tract 102.01, Crisp County, Georgia",1126,1126,0,0.0
1639,1500000US130810102021,130810102021,"Block Group 1, Census Tract 102.02, Crisp County, Georgia",1238,1238,0,0.0
1640,1500000US130810102022,130810102022,"Block Group 2, Census Tract 102.02, Crisp County, Georgia",967,967,0,0.0
1641,1500000US130810102023,130810102023,"Block Group 3, Census Tract 102.02, Crisp County, Georgia",596,596,0,0.0
1642,1500000US130810103001,130810103001,"Block Group 1, Census Tract 103, Crisp County, Georgia",1049,1032,17,1.62059103908
1643,1500000US130810103002,130810103002,"Block Group 2, Census Tract 103, Crisp County, Georgia",2056,2056,0,0.0
1644,1500000US130810103003,130810103003,"Block Group 3, Census Tract 103, Crisp County, Georgia",827,749,78,9.43168077388
1645,1500000US130810104001,130810104001,"Block Group 1, Census Tract 104, Crisp County, Georgia",1453,1453,0,0.0
1646,1500000US130810104002,130810104002,"Block Group 2, Census Tract 104, Crisp County, Georgia",995,665,330,33.1658291457
1647,1500000US130810104003,130810104003,"Block Group 3, Census Tract 104, Crisp County, Georgia",712,712,0,0.0
1648,1500000US130810104004,130810104004,"Block Group 4, Census Tract 104, Crisp County, Georgia",1726,1726,0,0.0
1649,1500000US130810104005,130810104005,"Block Group 5, Census Tract 104, Crisp County, Georgia",592,516,76,12.8378378378
1650,1500000US130810105001,130810105001,"Block Group 1, Census Tract 105, Crisp County, Georgia",874,874,0,0.0
1651,1500000US130810105002,130810105002,"Block Group 2, Census Tract 105, Crisp County, Georgia",669,669,0,0.0
1652,1500000US130830401011,130830401011,"Block Group 1, Census Tract 401.01, Dade County, Georgia",2490,2472,18,0.722891566265
1653,1500000US130830401012,130830401012,"Block Group 2, Census Tract 401.01, Dade County, Georgia",2072,2003,69,3.33011583012
1654,1500000US130830401021,130830401021,"Block Group 1, Census Tract 401.02, Dade County, Georgia",1046,1046,0,0.0
1655,1500000US130830401022,130830401022,"Block Group 2, Census Tract 401.02, Dade County, Georgia",2511,2383,128,5.09757068897
1656,1500000US130830402001,130830402001,"Block Group 1, Census Tract 402, Dade County, Georgia",1984,1977,7,0.352822580645
1657,1500000US130830402002,130830402002,"Block Group 2, Census Tract 402, Dade County, Georgia",2209,2209,0,0.0
1658,1500000US130830403001,130830403001,"Block Group 1, Census Tract 403, Dade County, Georgia",1293,1272,21,1.62412993039
1659,1500000US130830403002,130830403002,"Block Group 2, Census Tract 403, Dade County, Georgia",2840,2733,107,3.7676056338
1660,1500000US130859701001,130859701001,"Block Group 1, Census Tract 9701, Dawson County, Georgia",2698,2613,85,3.1504818384
1661,1500000US130859701002,130859701002,"Block Group 2, Census Tract 9701, Dawson County, Georgia",3428,3376,52,1.51691948658
1662,1500000US130859701003,130859701003,"Block Group 3, Census Tract 9701, Dawson County, Georgia",1846,1846,0,0.0
1663,1500000US130859702011,130859702011,"Block Group 1, Census Tract 9702.01, Dawson County, Georgia",1571,1405,166,10.5665181413
1664,1500000US130859702012,130859702012,"Block Group 2, Census Tract 9702.01, Dawson County, Georgia",2246,2156,90,4.0071237756
1665,1500000US130859702013,130859702013,"Block Group 3, Census Tract 9702.01, Dawson County, Georgia",1124,872,252,22.4199288256
1666,1500000US130859702014,130859702014,"Block Group 4, Census Tract 9702.01, Dawson County, Georgia",2241,2191,50,2.23114680946
1667,1500000US130859702021,130859702021,"Block Group 1, Census Tract 9702.02, Dawson County, Georgia",2750,2741,9,0.327272727273
1668,1500000US130859702022,130859702022,"Block Group 2, Census Tract 9702.02, Dawson County, Georgia",1277,1265,12,0.939702427565
1669,1500000US130859702023,130859702023,"Block Group 3, Census Tract 9702.02, Dawson County, Georgia",3492,3317,175,5.01145475372
1670,1500000US130879701001,130879701001,"Block Group 1, Census Tract 9701, Decatur County, Georgia",588,561,27,4.59183673469
1671,1500000US130879701002,130879701002,"Block Group 2, Census Tract 9701, Decatur County, Georgia",1429,1312,117,8.18754373688
1672,1500000US130879701003,130879701003,"Block Group 3, Census Tract 9701, Decatur County, Georgia",1398,1398,0,0.0
1673,1500000US130879702001,130879702001,"Block Group 1, Census Tract 9702, Decatur County, Georgia",1239,1239,0,0.0
1674,1500000US130879702002,130879702002,"Block Group 2, Census Tract 9702, Decatur County, Georgia",1648,1363,285,17.2936893204
1675,1500000US130879703001,130879703001,"Block Group 1, Census Tract 9703, Decatur County, Georgia",1777,1721,56,3.15137872819
1676,1500000US130879703002,130879703002,"Block Group 2, Census Tract 9703, Decatur County, Georgia",2332,2270,62,2.65866209262
1677,1500000US130879703003,130879703003,"Block Group 3, Census Tract 9703, Decatur County, Georgia",1454,1454,0,0.0
1678,1500000US130879703004,130879703004,"Block Group 4, Census Tract 9703, Decatur County, Georgia",1207,1207,0,0.0
1679,1500000US130879704001,130879704001,"Block Group 1, Census Tract 9704, Decatur County, Georgia",1203,1203,0,0.0
1680,1500000US130879704002,130879704002,"Block Group 2, Census Tract 9704, Decatur County, Georgia",937,937,0,0.0
1681,1500000US130879704003,130879704003,"Block Group 3, Census Tract 9704, Decatur County, Georgia",1481,1481,0,0.0
1682,1500000US130879704004,130879704004,"Block Group 4, Census Tract 9704, Decatur County, Georgia",1063,960,103,9.68955785513
1683,1500000US130879706001,130879706001,"Block Group 1, Census Tract 9706, Decatur County, Georgia",458,458,0,0.0
1684,1500000US130879706002,130879706002,"Block Group 2, Census Tract 9706, Decatur County, Georgia",757,757,0,0.0
1685,1500000US130879706003,130879706003,"Block Group 3, Census Tract 9706, Decatur County, Georgia",1867,1804,63,3.37439742903
1686,1500000US130879706004,130879706004,"Block Group 4, Census Tract 9706, Decatur County, Georgia",1969,1910,59,2.99644489589
1687,1500000US130879707001,130879707001,"Block Group 1, Census Tract 9707, Decatur County, Georgia",1154,712,442,38.301559792
1688,1500000US130879707002,130879707002,"Block Group 2, Census Tract 9707, Decatur County, Georgia",651,648,3,0.460829493088
1689,1500000US130879708001,130879708001,"Block Group 1, Census Tract 9708, Decatur County, Georgia",1522,1324,198,13.0091984231
1690,1500000US130879708002,130879708002,"Block Group 2, Census Tract 9708, Decatur County, Georgia",1244,1151,93,7.47588424437
1691,1500000US130890201001,130890201001,"Block Group 1, Census Tract 201, DeKalb County, Georgia",1908,1831,77,4.035639413
1692,1500000US130890202001,130890202001,"Block Group 1, Census Tract 202, DeKalb County, Georgia",901,861,40,4.43951165372
1693,1500000US130890202002,130890202002,"Block Group 2, Census Tract 202, DeKalb County, Georgia",1188,1104,84,7.07070707071
1694,1500000US130890203001,130890203001,"Block Group 1, Census Tract 203, DeKalb County, Georgia",840,818,22,2.61904761905
1695,1500000US130890203002,130890203002,"Block Group 2, Census Tract 203, DeKalb County, Georgia",1049,1003,46,4.38512869399
1696,1500000US130890203003,130890203003,"Block Group 3, Census Tract 203, DeKalb County, Georgia",1930,1825,105,5.44041450777
1697,1500000US130890204001,130890204001,"Block Group 1, Census Tract 204, DeKalb County, Georgia",1684,1604,80,4.75059382423
1698,1500000US130890204002,130890204002,"Block Group 2, Census Tract 204, DeKalb County, Georgia",901,876,25,2.77469478357
1699,1500000US130890205001,130890205001,"Block Group 1, Census Tract 205, DeKalb County, Georgia",1193,1086,107,8.96898575021
1700,1500000US130890205002,130890205002,"Block Group 2, Census Tract 205, DeKalb County, Georgia",1722,1652,70,4.06504065041
1701,1500000US130890206001,130890206001,"Block Group 1, Census Tract 206, DeKalb County, Georgia",616,597,19,3.08441558442
1702,1500000US130890206002,130890206002,"Block Group 2, Census Tract 206, DeKalb County, Georgia",1433,1387,46,3.21004884857
1703,1500000US130890207001,130890207001,"Block Group 1, Census Tract 207, DeKalb County, Georgia",1717,1687,30,1.74723354688
1704,1500000US130890207002,130890207002,"Block Group 2, Census Tract 207, DeKalb County, Georgia",528,528,0,0.0
1705,1500000US130890208011,130890208011,"Block Group 1, Census Tract 208.01, DeKalb County, Georgia",1041,1031,10,0.960614793468
1706,1500000US130890208012,130890208012,"Block Group 2, Census Tract 208.01, DeKalb County, Georgia",1559,1520,39,2.50160359205
1707,1500000US130890208021,130890208021,"Block Group 1, Census Tract 208.02, DeKalb County, Georgia",713,706,7,0.981767180926
1708,1500000US130890208022,130890208022,"Block Group 2, Census Tract 208.02, DeKalb County, Georgia",1720,1629,91,5.29069767442
1709,1500000US130890208023,130890208023,"Block Group 3, Census Tract 208.02, DeKalb County, Georgia",951,824,127,13.3543638275
1710,1500000US130890208024,130890208024,"Block Group 4, Census Tract 208.02, DeKalb County, Georgia",873,873,0,0.0
1711,1500000US130890209001,130890209001,"Block Group 1, Census Tract 209, DeKalb County, Georgia",1525,1447,78,5.11475409836
1712,1500000US130890209002,130890209002,"Block Group 2, Census Tract 209, DeKalb County, Georgia",1235,1208,27,2.18623481781
1713,1500000US130890209003,130890209003,"Block Group 3, Census Tract 209, DeKalb County, Georgia",1776,1714,62,3.49099099099
1714,1500000US130890209004,130890209004,"Block Group 4, Census Tract 209, DeKalb County, Georgia",1164,1137,27,2.31958762887
1715,1500000US130890211011,130890211011,"Block Group 1, Census Tract 211.01, DeKalb County, Georgia",3784,3682,102,2.6955602537
1716,1500000US130890211021,130890211021,"Block Group 1, Census Tract 211.02, DeKalb County, Georgia",209,209,0,0.0
1717,1500000US130890211022,130890211022,"Block Group 2, Census Tract 211.02, DeKalb County, Georgia",1757,1690,67,3.81331815595
1718,1500000US130890211023,130890211023,"Block Group 3, Census Tract 211.02, DeKalb County, Georgia",1142,1031,111,9.71978984238
1719,1500000US130890211024,130890211024,"Block Group 4, Census Tract 211.02, DeKalb County, Georgia",2203,2153,50,2.26963231956
1720,1500000US130890212021,130890212021,"Block Group 1, Census Tract 212.02, DeKalb County, Georgia",3004,2980,24,0.798934753662
1721,1500000US130890212022,130890212022,"Block Group 2, Census Tract 212.02, DeKalb County, Georgia",1914,1856,58,3.0303030303
1722,1500000US130890212023,130890212023,"Block Group 3, Census Tract 212.02, DeKalb County, Georgia",2386,2169,217,9.09471919531
1723,1500000US130890212041,130890212041,"Block Group 1, Census Tract 212.04, DeKalb County, Georgia",1253,304,949,75.7382282522
1724,1500000US130890212042,130890212042,"Block Group 2, Census Tract 212.04, DeKalb County, Georgia",1763,76,1687,95.689166194
1725,1500000US130890212043,130890212043,"Block Group 3, Census Tract 212.04, DeKalb County, Georgia",989,109,880,88.9787664307
1726,1500000US130890212081,130890212081,"Block Group 1, Census Tract 212.08, DeKalb County, Georgia",2432,2033,399,16.40625
1727,1500000US130890212082,130890212082,"Block Group 2, Census Tract 212.08, DeKalb County, Georgia",1600,1589,11,0.6875
1728,1500000US130890212091,130890212091,"Block Group 1, Census Tract 212.09, DeKalb County, Georgia",1167,1093,74,6.3410454156
1729,1500000US130890212092,130890212092,"Block Group 2, Census Tract 212.09, DeKalb County, Georgia",1516,1489,27,1.78100263852
1730,1500000US130890212093,130890212093,"Block Group 3, Census Tract 212.09, DeKalb County, Georgia",2041,1985,56,2.74375306222
1731,1500000US130890212094,130890212094,"Block Group 4, Census Tract 212.09, DeKalb County, Georgia",1173,1038,135,11.5089514066
1732,1500000US130890212101,130890212101,"Block Group 1, Census Tract 212.10, DeKalb County, Georgia",1813,1750,63,3.4749034749
1733,1500000US130890212102,130890212102,"Block Group 2, Census Tract 212.10, DeKalb County, Georgia",1207,1179,28,2.3198011599
1734,1500000US130890212103,130890212103,"Block Group 3, Census Tract 212.10, DeKalb County, Georgia",2498,2492,6,0.240192153723
1735,1500000US130890212111,130890212111,"Block Group 1, Census Tract 212.11, DeKalb County, Georgia",1323,1323,0,0.0
1736,1500000US130890212112,130890212112,"Block Group 2, Census Tract 212.11, DeKalb County, Georgia",2110,1981,129,6.11374407583
1737,1500000US130890212113,130890212113,"Block Group 3, Census Tract 212.11, DeKalb County, Georgia",1349,1336,13,0.963676797628
1738,1500000US130890212131,130890212131,"Block Group 1, Census Tract 212.13, DeKalb County, Georgia",1076,987,89,8.27137546468
1739,1500000US130890212132,130890212132,"Block Group 2, Census Tract 212.13, DeKalb County, Georgia",2379,2372,7,0.294241277848
1740,1500000US130890212141,130890212141,"Block Group 1, Census Tract 212.14, DeKalb County, Georgia",1801,1753,48,2.66518600777
1741,1500000US130890212142,130890212142,"Block Group 2, Census Tract 212.14, DeKalb County, Georgia",3002,2867,135,4.49700199867
1742,1500000US130890212143,130890212143,"Block Group 3, Census Tract 212.14, DeKalb County, Georgia",1529,1438,91,5.95160235448
1743,1500000US130890212151,130890212151,"Block Group 1, Census Tract 212.15, DeKalb County, Georgia",3401,3154,247,7.2625698324
1744,1500000US130890212152,130890212152,"Block Group 2, Census Tract 212.15, DeKalb County, Georgia",2544,2331,213,8.37264150943
1745,1500000US130890212161,130890212161,"Block Group 1, Census Tract 212.16, DeKalb County, Georgia",1876,1722,154,8.20895522388
1746,1500000US130890212162,130890212162,"Block Group 2, Census Tract 212.16, DeKalb County, Georgia",3807,3303,504,13.2387706856
1747,1500000US130890212163,130890212163,"Block Group 3, Census Tract 212.16, DeKalb County, Georgia",2857,2733,124,4.34021701085
1748,1500000US130890212171,130890212171,"Block Group 1, Census Tract 212.17, DeKalb County, Georgia",2466,2346,120,4.86618004866
1749,1500000US130890212181,130890212181,"Block Group 1, Census Tract 212.18, DeKalb County, Georgia",1266,1229,37,2.92259083728
1750,1500000US130890212182,130890212182,"Block Group 2, Census Tract 212.18, DeKalb County, Georgia",2239,2038,201,8.9772219741
1751,1500000US130890212183,130890212183,"Block Group 3, Census Tract 212.18, DeKalb County, Georgia",1319,1282,37,2.80515542077
1752,1500000US130890213011,130890213011,"Block Group 1, Census Tract 213.01, DeKalb County, Georgia",1107,216,891,80.487804878
1753,1500000US130890213012,130890213012,"Block Group 2, Census Tract 213.01, DeKalb County, Georgia",2898,2531,367,12.6639061422
1754,1500000US130890213031,130890213031,"Block Group 1, Census Tract 213.03, DeKalb County, Georgia",3051,1471,1580,51.7862995739
1755,1500000US130890213032,130890213032,"Block Group 2, Census Tract 213.03, DeKalb County, Georgia",1314,914,400,30.4414003044
1756,1500000US130890213033,130890213033,"Block Group 3, Census Tract 213.03, DeKalb County, Georgia",2131,352,1779,83.4819333646
1757,1500000US130890213051,130890213051,"Block Group 1, Census Tract 213.05, DeKalb County, Georgia",928,770,158,17.025862069
1758,1500000US130890213052,130890213052,"Block Group 2, Census Tract 213.05, DeKalb County, Georgia",4256,2051,2205,51.8092105263
1759,1500000US130890213061,130890213061,"Block Group 1, Census Tract 213.06, DeKalb County, Georgia",2570,1479,1091,42.4513618677
1760,1500000US130890213062,130890213062,"Block Group 2, Census Tract 213.06, DeKalb County, Georgia",667,421,246,36.8815592204
1761,1500000US130890213063,130890213063,"Block Group 3, Census Tract 213.06, DeKalb County, Georgia",1885,702,1183,62.7586206897
1762,1500000US130890213071,130890213071,"Block Group 1, Census Tract 213.07, DeKalb County, Georgia",1430,787,643,44.965034965
1763,1500000US130890213072,130890213072,"Block Group 2, Census Tract 213.07, DeKalb County, Georgia",2946,1817,1129,38.3231500339
1764,1500000US130890213081,130890213081,"Block Group 1, Census Tract 213.08, DeKalb County, Georgia",1648,989,659,39.9878640777
1765,1500000US130890213082,130890213082,"Block Group 2, Census Tract 213.08, DeKalb County, Georgia",525,505,20,3.80952380952
1766,1500000US130890213083,130890213083,"Block Group 3, Census Tract 213.08, DeKalb County, Georgia",1926,720,1206,62.6168224299
1767,1500000US130890214051,130890214051,"Block Group 1, Census Tract 214.05, DeKalb County, Georgia",1042,912,130,12.4760076775
1768,1500000US130890214052,130890214052,"Block Group 2, Census Tract 214.05, DeKalb County, Georgia",1850,1423,427,23.0810810811
1769,1500000US130890214053,130890214053,"Block Group 3, Census Tract 214.05, DeKalb County, Georgia",1367,1283,84,6.14484272129
1770,1500000US130890214091,130890214091,"Block Group 1, Census Tract 214.09, DeKalb County, Georgia",2735,1892,843,30.8226691042
1771,1500000US130890214092,130890214092,"Block Group 2, Census Tract 214.09, DeKalb County, Georgia",975,199,776,79.5897435897
1772,1500000US130890214101,130890214101,"Block Group 1, Census Tract 214.10, DeKalb County, Georgia",1964,752,1212,61.7107942974
1773,1500000US130890214102,130890214102,"Block Group 2, Census Tract 214.10, DeKalb County, Georgia",1757,290,1467,83.4945930563
1774,1500000US130890214103,130890214103,"Block Group 3, Census Tract 214.10, DeKalb County, Georgia",1651,1442,209,12.6589945488
1775,1500000US130890214111,130890214111,"Block Group 1, Census Tract 214.11, DeKalb County, Georgia",1832,1722,110,6.00436681223
1776,1500000US130890214112,130890214112,"Block Group 2, Census Tract 214.11, DeKalb County, Georgia",1718,1541,177,10.302677532
1777,1500000US130890214121,130890214121,"Block Group 1, Census Tract 214.12, DeKalb County, Georgia",1167,1167,0,0.0
1778,1500000US130890214122,130890214122,"Block Group 2, Census Tract 214.12, DeKalb County, Georgia",1480,1046,434,29.3243243243
1779,1500000US130890214123,130890214123,"Block Group 3, Census Tract 214.12, DeKalb County, Georgia",1227,1213,14,1.14099429503
1780,1500000US130890214131,130890214131,"Block Group 1, Census Tract 214.13, DeKalb County, Georgia",3030,917,2113,69.7359735974
1781,1500000US130890214132,130890214132,"Block Group 2, Census Tract 214.13, DeKalb County, Georgia",1451,294,1157,79.7381116471
1782,1500000US130890214141,130890214141,"Block Group 1, Census Tract 214.14, DeKalb County, Georgia",3022,1330,1692,55.9894109861
1783,1500000US130890214142,130890214142,"Block Group 2, Census Tract 214.14, DeKalb County, Georgia",947,714,233,24.6040126716
1784,1500000US130890214151,130890214151,"Block Group 1, Census Tract 214.15, DeKalb County, Georgia",1103,1073,30,2.71985494107
1785,1500000US130890214152,130890214152,"Block Group 2, Census Tract 214.15, DeKalb County, Georgia",1229,1115,114,9.27583401139
1786,1500000US130890214153,130890214153,"Block Group 3, Census Tract 214.15, DeKalb County, Georgia",1846,1224,622,33.6944745395
1787,1500000US130890214161,130890214161,"Block Group 1, Census Tract 214.16, DeKalb County, Georgia",1978,654,1324,66.9362992922
1788,1500000US130890214162,130890214162,"Block Group 2, Census Tract 214.16, DeKalb County, Georgia",614,555,59,9.60912052117
1789,1500000US130890214171,130890214171,"Block Group 1, Census Tract 214.17, DeKalb County, Georgia",1117,1076,41,3.67054610564
1790,1500000US130890214172,130890214172,"Block Group 2, Census Tract 214.17, DeKalb County, Georgia",1231,684,547,44.4354183591
1791,1500000US130890214173,130890214173,"Block Group 3, Census Tract 214.17, DeKalb County, Georgia",2793,313,2480,88.7934121017
1792,1500000US130890215021,130890215021,"Block Group 1, Census Tract 215.02, DeKalb County, Georgia",1298,1109,189,14.5608628659
1793,1500000US130890215022,130890215022,"Block Group 2, Census Tract 215.02, DeKalb County, Georgia",1445,1390,55,3.8062283737
1794,1500000US130890215023,130890215023,"Block Group 3, Census Tract 215.02, DeKalb County, Georgia",1839,1780,59,3.20826536161
1795,1500000US130890215031,130890215031,"Block Group 1, Census Tract 215.03, DeKalb County, Georgia",1478,1328,150,10.148849797
1796,1500000US130890215032,130890215032,"Block Group 2, Census Tract 215.03, DeKalb County, Georgia",1023,1023,0,0.0
1797,1500000US130890215033,130890215033,"Block Group 3, Census Tract 215.03, DeKalb County, Georgia",1741,958,783,44.9741527858
1798,1500000US130890215041,130890215041,"Block Group 1, Census Tract 215.04, DeKalb County, Georgia",1619,1588,31,1.91476219889
1799,1500000US130890215042,130890215042,"Block Group 2, Census Tract 215.04, DeKalb County, Georgia",2104,2053,51,2.42395437262
1800,1500000US130890215043,130890215043,"Block Group 3, Census Tract 215.04, DeKalb County, Georgia",1333,1220,113,8.47711927982
1801,1500000US130890216021,130890216021,"Block Group 1, Census Tract 216.02, DeKalb County, Georgia",1605,1511,94,5.85669781931
1802,1500000US130890216022,130890216022,"Block Group 2, Census Tract 216.02, DeKalb County, Georgia",2399,2374,25,1.04210087536
1803,1500000US130890216031,130890216031,"Block Group 1, Census Tract 216.03, DeKalb County, Georgia",1665,1581,84,5.04504504505
1804,1500000US130890216032,130890216032,"Block Group 2, Census Tract 216.03, DeKalb County, Georgia",1653,1581,72,4.3557168784
1805,1500000US130890216033,130890216033,"Block Group 3, Census Tract 216.03, DeKalb County, Georgia",1203,1138,65,5.40315876974
1806,1500000US130890216041,130890216041,"Block Group 1, Census Tract 216.04, DeKalb County, Georgia",2046,2000,46,2.24828934506
1807,1500000US130890216042,130890216042,"Block Group 2, Census Tract 216.04, DeKalb County, Georgia",1091,1054,37,3.39138405133
1808,1500000US130890216051,130890216051,"Block Group 1, Census Tract 216.05, DeKalb County, Georgia",1662,1605,57,3.42960288809
1809,1500000US130890216052,130890216052,"Block Group 2, Census Tract 216.05, DeKalb County, Georgia",1035,1021,14,1.35265700483
1810,1500000US130890216053,130890216053,"Block Group 3, Census Tract 216.05, DeKalb County, Georgia",2827,2013,814,28.7937743191
1811,1500000US130890217031,130890217031,"Block Group 1, Census Tract 217.03, DeKalb County, Georgia",2409,2278,131,5.43794105438
1812,1500000US130890217032,130890217032,"Block Group 2, Census Tract 217.03, DeKalb County, Georgia",2479,2294,185,7.46268656716
1813,1500000US130890217041,130890217041,"Block Group 1, Census Tract 217.04, DeKalb County, Georgia",1577,1547,30,1.90234622701
1814,1500000US130890217042,130890217042,"Block Group 2, Census Tract 217.04, DeKalb County, Georgia",1123,1074,49,4.36331255565
1815,1500000US130890217043,130890217043,"Block Group 3, Census Tract 217.04, DeKalb County, Georgia",2877,2838,39,1.35557872784
1816,1500000US130890217051,130890217051,"Block Group 1, Census Tract 217.05, DeKalb County, Georgia",2152,1649,503,23.373605948
1817,1500000US130890217052,130890217052,"Block Group 2, Census Tract 217.05, DeKalb County, Georgia",1262,889,373,29.5562599049
1818,1500000US130890217053,130890217053,"Block Group 3, Census Tract 217.05, DeKalb County, Georgia",1317,1285,32,2.42976461655
1819,1500000US130890217061,130890217061,"Block Group 1, Census Tract 217.06, DeKalb County, Georgia",787,760,27,3.43074968234
1820,1500000US130890217062,130890217062,"Block Group 2, Census Tract 217.06, DeKalb County, Georgia",2192,1975,217,9.8996350365
1821,1500000US130890217063,130890217063,"Block Group 3, Census Tract 217.06, DeKalb County, Georgia",1072,1072,0,0.0
1822,1500000US130890217064,130890217064,"Block Group 4, Census Tract 217.06, DeKalb County, Georgia",1530,1448,82,5.35947712418
1823,1500000US130890218051,130890218051,"Block Group 1, Census Tract 218.05, DeKalb County, Georgia",1864,1709,155,8.31545064378
1824,1500000US130890218052,130890218052,"Block Group 2, Census Tract 218.05, DeKalb County, Georgia",1883,1764,119,6.31970260223
1825,1500000US130890218053,130890218053,"Block Group 3, Census Tract 218.05, DeKalb County, Georgia",2665,2174,491,18.4240150094
1826,1500000US130890218061,130890218061,"Block Group 1, Census Tract 218.06, DeKalb County, Georgia",2491,1855,636,25.5319148936
1827,1500000US130890218062,130890218062,"Block Group 2, Census Tract 218.06, DeKalb County, Georgia",1074,1022,52,4.8417132216
1828,1500000US130890218063,130890218063,"Block Group 3, Census Tract 218.06, DeKalb County, Georgia",2228,1871,357,16.0233393178
1829,1500000US130890218081,130890218081,"Block Group 1, Census Tract 218.08, DeKalb County, Georgia",1706,1657,49,2.87221570926
1830,1500000US130890218082,130890218082,"Block Group 2, Census Tract 218.08, DeKalb County, Georgia",3293,2702,591,17.9471606438
1831,1500000US130890218091,130890218091,"Block Group 1, Census Tract 218.09, DeKalb County, Georgia",535,499,36,6.72897196262
1832,1500000US130890218092,130890218092,"Block Group 2, Census Tract 218.09, DeKalb County, Georgia",1678,1670,8,0.476758045292
1833,1500000US130890218093,130890218093,"Block Group 3, Census Tract 218.09, DeKalb County, Georgia",1888,1824,64,3.38983050847
1834,1500000US130890218094,130890218094,"Block Group 4, Census Tract 218.09, DeKalb County, Georgia",1367,1193,174,12.7286027798
1835,1500000US130890218095,130890218095,"Block Group 5, Census Tract 218.09, DeKalb County, Georgia",1210,1154,56,4.62809917355
1836,1500000US130890218101,130890218101,"Block Group 1, Census Tract 218.10, DeKalb County, Georgia",2190,2130,60,2.7397260274
1837,1500000US130890218102,130890218102,"Block Group 2, Census Tract 218.10, DeKalb County, Georgia",1319,1319,0,0.0
1838,1500000US130890218103,130890218103,"Block Group 3, Census Tract 218.10, DeKalb County, Georgia",1639,1482,157,9.57901159243
1839,1500000US130890218121,130890218121,"Block Group 1, Census Tract 218.12, DeKalb County, Georgia",983,797,186,18.9216683622
1840,1500000US130890218122,130890218122,"Block Group 2, Census Tract 218.12, DeKalb County, Georgia",1291,847,444,34.3919442293
1841,1500000US130890218131,130890218131,"Block Group 1, Census Tract 218.13, DeKalb County, Georgia",2859,1753,1106,38.6848548444
1842,1500000US130890218141,130890218141,"Block Group 1, Census Tract 218.14, DeKalb County, Georgia",1045,727,318,30.4306220096
1843,1500000US130890218142,130890218142,"Block Group 2, Census Tract 218.14, DeKalb County, Georgia",1397,603,794,56.8360773085
1844,1500000US130890218143,130890218143,"Block Group 3, Census Tract 218.14, DeKalb County, Georgia",1339,624,715,53.3980582524
1845,1500000US130890218144,130890218144,"Block Group 4, Census Tract 218.14, DeKalb County, Georgia",1870,940,930,49.7326203209
1846,1500000US130890219061,130890219061,"Block Group 1, Census Tract 219.06, DeKalb County, Georgia",1659,1536,123,7.41410488246
1847,1500000US130890219062,130890219062,"Block Group 2, Census Tract 219.06, DeKalb County, Georgia",758,721,37,4.88126649077
1848,1500000US130890219063,130890219063,"Block Group 3, Census Tract 219.06, DeKalb County, Georgia",2824,2757,67,2.37252124646
1849,1500000US130890219071,130890219071,"Block Group 1, Census Tract 219.07, DeKalb County, Georgia",4875,4412,463,9.49743589744
1850,1500000US130890219072,130890219072,"Block Group 2, Census Tract 219.07, DeKalb County, Georgia",2217,2169,48,2.1650879567
1851,1500000US130890219073,130890219073,"Block Group 3, Census Tract 219.07, DeKalb County, Georgia",1883,1790,93,4.93892724376
1852,1500000US130890219081,130890219081,"Block Group 1, Census Tract 219.08, DeKalb County, Georgia",1943,1902,41,2.11013896037
1853,1500000US130890219082,130890219082,"Block Group 2, Census Tract 219.08, DeKalb County, Georgia",4193,4077,116,2.76651562127
1854,1500000US130890219091,130890219091,"Block Group 1, Census Tract 219.09, DeKalb County, Georgia",2234,2071,163,7.29632945389
1855,1500000US130890219092,130890219092,"Block Group 2, Census Tract 219.09, DeKalb County, Georgia",1609,1571,38,2.36171535115
1856,1500000US130890219093,130890219093,"Block Group 3, Census Tract 219.09, DeKalb County, Georgia",1013,978,35,3.45508390918
1857,1500000US130890219094,130890219094,"Block Group 4, Census Tract 219.09, DeKalb County, Georgia",1755,1726,29,1.65242165242
1858,1500000US130890219101,130890219101,"Block Group 1, Census Tract 219.10, DeKalb County, Georgia",1341,1248,93,6.93512304251
1859,1500000US130890219102,130890219102,"Block Group 2, Census Tract 219.10, DeKalb County, Georgia",1796,1668,128,7.12694877506
1860,1500000US130890219103,130890219103,"Block Group 3, Census Tract 219.10, DeKalb County, Georgia",1683,1636,47,2.7926322044
1861,1500000US130890219111,130890219111,"Block Group 1, Census Tract 219.11, DeKalb County, Georgia",816,816,0,0.0
1862,1500000US130890219112,130890219112,"Block Group 2, Census Tract 219.11, DeKalb County, Georgia",1373,1329,44,3.20466132556
1863,1500000US130890219121,130890219121,"Block Group 1, Census Tract 219.12, DeKalb County, Georgia",1451,1410,41,2.82563749139
1864,1500000US130890219122,130890219122,"Block Group 2, Census Tract 219.12, DeKalb County, Georgia",1364,1344,20,1.46627565982
1865,1500000US130890219123,130890219123,"Block Group 3, Census Tract 219.12, DeKalb County, Georgia",644,620,24,3.72670807453
1866,1500000US130890219131,130890219131,"Block Group 1, Census Tract 219.13, DeKalb County, Georgia",2554,2449,105,4.1111981206
1867,1500000US130890219132,130890219132,"Block Group 2, Census Tract 219.13, DeKalb County, Georgia",848,743,105,12.3820754717
1868,1500000US130890219133,130890219133,"Block Group 3, Census Tract 219.13, DeKalb County, Georgia",1243,872,371,29.8471440064
1869,1500000US130890220011,130890220011,"Block Group 1, Census Tract 220.01, DeKalb County, Georgia",2018,1959,59,2.92368681863
1870,1500000US130890220012,130890220012,"Block Group 2, Census Tract 220.01, DeKalb County, Georgia",2321,2182,139,5.98879793193
1871,1500000US130890220041,130890220041,"Block Group 1, Census Tract 220.04, DeKalb County, Georgia",2668,2668,0,0.0
1872,1500000US130890220042,130890220042,"Block Group 2, Census Tract 220.04, DeKalb County, Georgia",1381,1338,43,3.11368573497
1873,1500000US130890220043,130890220043,"Block Group 3, Census Tract 220.04, DeKalb County, Georgia",1977,1977,0,0.0
1874,1500000US130890220051,130890220051,"Block Group 1, Census Tract 220.05, DeKalb County, Georgia",1727,1727,0,0.0
1875,1500000US130890220052,130890220052,"Block Group 2, Census Tract 220.05, DeKalb County, Georgia",1128,1014,114,10.1063829787
1876,1500000US130890220053,130890220053,"Block Group 3, Census Tract 220.05, DeKalb County, Georgia",1736,1725,11,0.633640552995
1877,1500000US130890220071,130890220071,"Block Group 1, Census Tract 220.07, DeKalb County, Georgia",2254,2116,138,6.12244897959
1878,1500000US130890220072,130890220072,"Block Group 2, Census Tract 220.07, DeKalb County, Georgia",1850,1806,44,2.37837837838
1879,1500000US130890220081,130890220081,"Block Group 1, Census Tract 220.08, DeKalb County, Georgia",1057,953,104,9.83916745506
1880,1500000US130890220082,130890220082,"Block Group 2, Census Tract 220.08, DeKalb County, Georgia",2580,2580,0,0.0
1881,1500000US130890220083,130890220083,"Block Group 3, Census Tract 220.08, DeKalb County, Georgia",3693,3670,23,0.622799891687
1882,1500000US130890220084,130890220084,"Block Group 4, Census Tract 220.08, DeKalb County, Georgia",1037,1037,0,0.0
1883,1500000US130890220091,130890220091,"Block Group 1, Census Tract 220.09, DeKalb County, Georgia",1844,1844,0,0.0
1884,1500000US130890220092,130890220092,"Block Group 2, Census Tract 220.09, DeKalb County, Georgia",1905,1905,0,0.0
1885,1500000US130890220093,130890220093,"Block Group 3, Census Tract 220.09, DeKalb County, Georgia",1341,1341,0,0.0
1886,1500000US130890220101,130890220101,"Block Group 1, Census Tract 220.10, DeKalb County, Georgia",2669,2560,109,4.08392656426
1887,1500000US130890221001,130890221001,"Block Group 1, Census Tract 221, DeKalb County, Georgia",2090,2058,32,1.53110047847
1888,1500000US130890221002,130890221002,"Block Group 2, Census Tract 221, DeKalb County, Georgia",1511,1357,154,10.1919258769
1889,1500000US130890222031,130890222031,"Block Group 1, Census Tract 222.03, DeKalb County, Georgia",2090,1984,106,5.07177033493
1890,1500000US130890222041,130890222041,"Block Group 1, Census Tract 222.04, DeKalb County, Georgia",3732,2623,1109,29.7159699893
1891,1500000US130890222042,130890222042,"Block Group 2, Census Tract 222.04, DeKalb County, Georgia",765,752,13,1.69934640523
1892,1500000US130890222043,130890222043,"Block Group 3, Census Tract 222.04, DeKalb County, Georgia",1628,1628,0,0.0
1893,1500000US130890222044,130890222044,"Block Group 4, Census Tract 222.04, DeKalb County, Georgia",898,857,41,4.56570155902
1894,1500000US130890223011,130890223011,"Block Group 1, Census Tract 223.01, DeKalb County, Georgia",1306,1257,49,3.75191424196
1895,1500000US130890223012,130890223012,"Block Group 2, Census Tract 223.01, DeKalb County, Georgia",498,498,0,0.0
1896,1500000US130890223013,130890223013,"Block Group 3, Census Tract 223.01, DeKalb County, Georgia",909,880,29,3.1903190319
1897,1500000US130890223014,130890223014,"Block Group 4, Census Tract 223.01, DeKalb County, Georgia",1376,1321,55,3.99709302326
1898,1500000US130890223015,130890223015,"Block Group 5, Census Tract 223.01, DeKalb County, Georgia",1801,1682,119,6.60744031094
1899,1500000US130890223021,130890223021,"Block Group 1, Census Tract 223.02, DeKalb County, Georgia",1572,1526,46,2.9262086514
1900,1500000US130890223022,130890223022,"Block Group 2, Census Tract 223.02, DeKalb County, Georgia",1274,856,418,32.8100470958
1901,1500000US130890223023,130890223023,"Block Group 3, Census Tract 223.02, DeKalb County, Georgia",1728,1682,46,2.66203703704
1902,1500000US130890224011,130890224011,"Block Group 1, Census Tract 224.01, DeKalb County, Georgia",1862,1821,41,2.20193340494
1903,1500000US130890224012,130890224012,"Block Group 2, Census Tract 224.01, DeKalb County, Georgia",1109,1104,5,0.450856627592
1904,1500000US130890224013,130890224013,"Block Group 3, Census Tract 224.01, DeKalb County, Georgia",973,965,8,0.82219938335
1905,1500000US130890224021,130890224021,"Block Group 1, Census Tract 224.02, DeKalb County, Georgia",2394,2278,116,4.84544695071
1906,1500000US130890224022,130890224022,"Block Group 2, Census Tract 224.02, DeKalb County, Georgia",3326,3143,183,5.50210463019
1907,1500000US130890224031,130890224031,"Block Group 1, Census Tract 224.03, DeKalb County, Georgia",1304,1255,49,3.75766871166
1908,1500000US130890224032,130890224032,"Block Group 2, Census Tract 224.03, DeKalb County, Georgia",1619,1586,33,2.03829524398
1909,1500000US130890224033,130890224033,"Block Group 3, Census Tract 224.03, DeKalb County, Georgia",1065,1065,0,0.0
1910,1500000US130890225001,130890225001,"Block Group 1, Census Tract 225, DeKalb County, Georgia",1992,1980,12,0.602409638554
1911,1500000US130890225002,130890225002,"Block Group 2, Census Tract 225, DeKalb County, Georgia",1052,1001,51,4.84790874525
1912,1500000US130890225003,130890225003,"Block Group 3, Census Tract 225, DeKalb County, Georgia",1425,1300,125,8.77192982456
1913,1500000US130890225004,130890225004,"Block Group 4, Census Tract 225, DeKalb County, Georgia",1784,1784,0,0.0
1914,1500000US130890226001,130890226001,"Block Group 1, Census Tract 226, DeKalb County, Georgia",1756,1698,58,3.30296127563
1915,1500000US130890226002,130890226002,"Block Group 2, Census Tract 226, DeKalb County, Georgia",1985,1891,94,4.7355163728
1916,1500000US130890226003,130890226003,"Block Group 3, Census Tract 226, DeKalb County, Georgia",1883,1842,41,2.17737652682
1917,1500000US130890227001,130890227001,"Block Group 1, Census Tract 227, DeKalb County, Georgia",1963,1919,44,2.24146714213
1918,1500000US130890227002,130890227002,"Block Group 2, Census Tract 227, DeKalb County, Georgia",972,909,63,6.48148148148
1919,1500000US130890227003,130890227003,"Block Group 3, Census Tract 227, DeKalb County, Georgia",1511,1475,36,2.38252812707
1920,1500000US130890228001,130890228001,"Block Group 1, Census Tract 228, DeKalb County, Georgia",1111,1046,65,5.85058505851
1921,1500000US130890228002,130890228002,"Block Group 2, Census Tract 228, DeKalb County, Georgia",1689,1652,37,2.19064535228
1922,1500000US130890228003,130890228003,"Block Group 3, Census Tract 228, DeKalb County, Georgia",1041,1041,0,0.0
1923,1500000US130890229001,130890229001,"Block Group 1, Census Tract 229, DeKalb County, Georgia",1547,1443,104,6.72268907563
1924,1500000US130890229002,130890229002,"Block Group 2, Census Tract 229, DeKalb County, Georgia",151,151,0,0.0
1925,1500000US130890229003,130890229003,"Block Group 3, Census Tract 229, DeKalb County, Georgia",1980,1900,80,4.0404040404
1926,1500000US130890230001,130890230001,"Block Group 1, Census Tract 230, DeKalb County, Georgia",2096,2048,48,2.29007633588
1927,1500000US130890231011,130890231011,"Block Group 1, Census Tract 231.01, DeKalb County, Georgia",647,647,0,0.0
1928,1500000US130890231012,130890231012,"Block Group 2, Census Tract 231.01, DeKalb County, Georgia",1664,1521,143,8.59375
1929,1500000US130890231013,130890231013,"Block Group 3, Census Tract 231.01, DeKalb County, Georgia",833,833,0,0.0
1930,1500000US130890231014,130890231014,"Block Group 4, Census Tract 231.01, DeKalb County, Georgia",1455,1358,97,6.66666666667
1931,1500000US130890231021,130890231021,"Block Group 1, Census Tract 231.02, DeKalb County, Georgia",1449,1387,62,4.27881297447
1932,1500000US130890231022,130890231022,"Block Group 2, Census Tract 231.02, DeKalb County, Georgia",1781,1708,73,4.09882088714
1933,1500000US130890231071,130890231071,"Block Group 1, Census Tract 231.07, DeKalb County, Georgia",1788,1658,130,7.2706935123
1934,1500000US130890231072,130890231072,"Block Group 2, Census Tract 231.07, DeKalb County, Georgia",1320,1154,166,12.5757575758
1935,1500000US130890231073,130890231073,"Block Group 3, Census Tract 231.07, DeKalb County, Georgia",1401,1392,9,0.642398286938
1936,1500000US130890231081,130890231081,"Block Group 1, Census Tract 231.08, DeKalb County, Georgia",1648,1627,21,1.27427184466
1937,1500000US130890231082,130890231082,"Block Group 2, Census Tract 231.08, DeKalb County, Georgia",1238,1232,6,0.48465266559
1938,1500000US130890231083,130890231083,"Block Group 3, Census Tract 231.08, DeKalb County, Georgia",1854,1841,13,0.701186623517
1939,1500000US130890231111,130890231111,"Block Group 1, Census Tract 231.11, DeKalb County, Georgia",2054,1967,87,4.23563777994
1940,1500000US130890231121,130890231121,"Block Group 1, Census Tract 231.12, DeKalb County, Georgia",1390,1330,60,4.31654676259
1941,1500000US130890231122,130890231122,"Block Group 2, Census Tract 231.12, DeKalb County, Georgia",2334,2138,196,8.39760068552
1942,1500000US130890231123,130890231123,"Block Group 3, Census Tract 231.12, DeKalb County, Georgia",541,459,82,15.157116451
1943,1500000US130890231131,130890231131,"Block Group 1, Census Tract 231.13, DeKalb County, Georgia",2059,1907,152,7.38222438077
1944,1500000US130890231132,130890231132,"Block Group 2, Census Tract 231.13, DeKalb County, Georgia",1338,1306,32,2.39162929746
1945,1500000US130890231141,130890231141,"Block Group 1, Census Tract 231.14, DeKalb County, Georgia",1094,1075,19,1.73674588665
1946,1500000US130890231142,130890231142,"Block Group 2, Census Tract 231.14, DeKalb County, Georgia",1346,1287,59,4.38335809807
1947,1500000US130890231151,130890231151,"Block Group 1, Census Tract 231.15, DeKalb County, Georgia",3083,2884,199,6.45475186507
1948,1500000US130890232041,130890232041,"Block Group 1, Census Tract 232.04, DeKalb County, Georgia",2661,2635,26,0.97707628711
1949,1500000US130890232042,130890232042,"Block Group 2, Census Tract 232.04, DeKalb County, Georgia",2575,2456,119,4.6213592233
1950,1500000US130890232043,130890232043,"Block Group 3, Census Tract 232.04, DeKalb County, Georgia",1934,1850,84,4.34332988625
1951,1500000US130890232061,130890232061,"Block Group 1, Census Tract 232.06, DeKalb County, Georgia",2967,2819,148,4.98820357263
1952,1500000US130890232062,130890232062,"Block Group 2, Census Tract 232.06, DeKalb County, Georgia",3187,3132,55,1.72576090367
1953,1500000US130890232063,130890232063,"Block Group 3, Census Tract 232.06, DeKalb County, Georgia",1510,1509,1,0.0662251655629
1954,1500000US130890232081,130890232081,"Block Group 1, Census Tract 232.08, DeKalb County, Georgia",2566,2499,67,2.61106780982
1955,1500000US130890232082,130890232082,"Block Group 2, Census Tract 232.08, DeKalb County, Georgia",1318,1232,86,6.52503793627
1956,1500000US130890232083,130890232083,"Block Group 3, Census Tract 232.08, DeKalb County, Georgia",3174,3174,0,0.0
1957,1500000US130890232091,130890232091,"Block Group 1, Census Tract 232.09, DeKalb County, Georgia",1490,1179,311,20.8724832215
1958,1500000US130890232092,130890232092,"Block Group 2, Census Tract 232.09, DeKalb County, Georgia",2533,2533,0,0.0
1959,1500000US130890232093,130890232093,"Block Group 3, Census Tract 232.09, DeKalb County, Georgia",1607,1575,32,1.9912881145
1960,1500000US130890232101,130890232101,"Block Group 1, Census Tract 232.10, DeKalb County, Georgia",1274,1274,0,0.0
1961,1500000US130890232102,130890232102,"Block Group 2, Census Tract 232.10, DeKalb County, Georgia",753,753,0,0.0
1962,1500000US130890232103,130890232103,"Block Group 3, Census Tract 232.10, DeKalb County, Georgia",1792,1792,0,0.0
1963,1500000US130890232104,130890232104,"Block Group 4, Census Tract 232.10, DeKalb County, Georgia",653,653,0,0.0
1964,1500000US130890232105,130890232105,"Block Group 5, Census Tract 232.10, DeKalb County, Georgia",2042,1981,61,2.98726738492
1965,1500000US130890232111,130890232111,"Block Group 1, Census Tract 232.11, DeKalb County, Georgia",1489,1451,38,2.5520483546
1966,1500000US130890232112,130890232112,"Block Group 2, Census Tract 232.11, DeKalb County, Georgia",1528,1517,11,0.719895287958
1967,1500000US130890232121,130890232121,"Block Group 1, Census Tract 232.12, DeKalb County, Georgia",1514,1497,17,1.12285336856
1968,1500000US130890232122,130890232122,"Block Group 2, Census Tract 232.12, DeKalb County, Georgia",2100,2021,79,3.7619047619
1969,1500000US130890232131,130890232131,"Block Group 1, Census Tract 232.13, DeKalb County, Georgia",1247,1247,0,0.0
1970,1500000US130890232132,130890232132,"Block Group 2, Census Tract 232.13, DeKalb County, Georgia",1514,1514,0,0.0
1971,1500000US130890232133,130890232133,"Block Group 3, Census Tract 232.13, DeKalb County, Georgia",3222,3158,64,1.98634388579
1972,1500000US130890232141,130890232141,"Block Group 1, Census Tract 232.14, DeKalb County, Georgia",3199,3052,147,4.59518599562
1973,1500000US130890232142,130890232142,"Block Group 2, Census Tract 232.14, DeKalb County, Georgia",2887,2877,10,0.346380325598
1974,1500000US130890233031,130890233031,"Block Group 1, Census Tract 233.03, DeKalb County, Georgia",3480,3086,394,11.3218390805
1975,1500000US130890233032,130890233032,"Block Group 2, Census Tract 233.03, DeKalb County, Georgia",809,772,37,4.57354758962
1976,1500000US130890233033,130890233033,"Block Group 3, Census Tract 233.03, DeKalb County, Georgia",960,693,267,27.8125
1977,1500000US130890233034,130890233034,"Block Group 4, Census Tract 233.03, DeKalb County, Georgia",1566,1538,28,1.78799489144
1978,1500000US130890233061,130890233061,"Block Group 1, Census Tract 233.06, DeKalb County, Georgia",2635,2466,169,6.41366223909
1979,1500000US130890233062,130890233062,"Block Group 2, Census Tract 233.06, DeKalb County, Georgia",2012,2012,0,0.0
1980,1500000US130890233063,130890233063,"Block Group 3, Census Tract 233.06, DeKalb County, Georgia",2323,1930,393,16.9177787344
1981,1500000US130890233091,130890233091,"Block Group 1, Census Tract 233.09, DeKalb County, Georgia",1216,1160,56,4.60526315789
1982,1500000US130890233092,130890233092,"Block Group 2, Census Tract 233.09, DeKalb County, Georgia",1896,1896,0,0.0
1983,1500000US130890233093,130890233093,"Block Group 3, Census Tract 233.09, DeKalb County, Georgia",4417,4246,171,3.87140593163
1984,1500000US130890233094,130890233094,"Block Group 4, Census Tract 233.09, DeKalb County, Georgia",1914,1905,9,0.470219435737
1985,1500000US130890233101,130890233101,"Block Group 1, Census Tract 233.10, DeKalb County, Georgia",2321,2290,31,1.33563119345
1986,1500000US130890233102,130890233102,"Block Group 2, Census Tract 233.10, DeKalb County, Georgia",3920,3881,39,0.994897959184
1987,1500000US130890233103,130890233103,"Block Group 3, Census Tract 233.10, DeKalb County, Georgia",1958,1953,5,0.255362614913
1988,1500000US130890233104,130890233104,"Block Group 4, Census Tract 233.10, DeKalb County, Georgia",1339,1330,9,0.67214339059
1989,1500000US130890233111,130890233111,"Block Group 1, Census Tract 233.11, DeKalb County, Georgia",3090,3065,25,0.809061488673
1990,1500000US130890233112,130890233112,"Block Group 2, Census Tract 233.11, DeKalb County, Georgia",1909,1873,36,1.88580408591
1991,1500000US130890233121,130890233121,"Block Group 1, Census Tract 233.12, DeKalb County, Georgia",3898,3742,156,4.00205233453
1992,1500000US130890233122,130890233122,"Block Group 2, Census Tract 233.12, DeKalb County, Georgia",2905,2905,0,0.0
1993,1500000US130890233123,130890233123,"Block Group 3, Census Tract 233.12, DeKalb County, Georgia",2399,2132,267,11.1296373489
1994,1500000US130890233131,130890233131,"Block Group 1, Census Tract 233.13, DeKalb County, Georgia",1926,1926,0,0.0
1995,1500000US130890233132,130890233132,"Block Group 2, Census Tract 233.13, DeKalb County, Georgia",3006,2913,93,3.09381237525
1996,1500000US130890233141,130890233141,"Block Group 1, Census Tract 233.14, DeKalb County, Georgia",1639,1518,121,7.38255033557
1997,1500000US130890233142,130890233142,"Block Group 2, Census Tract 233.14, DeKalb County, Georgia",2022,2022,0,0.0
1998,1500000US130890233143,130890233143,"Block Group 3, Census Tract 233.14, DeKalb County, Georgia",1433,1433,0,0.0
1999,1500000US130890233151,130890233151,"Block Group 1, Census Tract 233.15, DeKalb County, Georgia",3211,3201,10,0.311429461227
2000,1500000US130890233152,130890233152,"Block Group 2, Census Tract 233.15, DeKalb County, Georgia",1543,1532,11,0.712896953986
2001,1500000US130890233161,130890233161,"Block Group 1, Census Tract 233.16, DeKalb County, Georgia",2913,2653,260,8.92550635084
2002,1500000US130890233162,130890233162,"Block Group 2, Census Tract 233.16, DeKalb County, Georgia",3487,3380,107,3.06854029252
2003,1500000US130890233163,130890233163,"Block Group 3, Census Tract 233.16, DeKalb County, Georgia",1652,1623,29,1.75544794189
2004,1500000US130890234101,130890234101,"Block Group 1, Census Tract 234.10, DeKalb County, Georgia",1417,1417,0,0.0
2005,1500000US130890234102,130890234102,"Block Group 2, Census Tract 234.10, DeKalb County, Georgia",1715,1684,31,1.80758017493
2006,1500000US130890234111,130890234111,"Block Group 1, Census Tract 234.11, DeKalb County, Georgia",1921,1892,29,1.50963040083
2007,1500000US130890234112,130890234112,"Block Group 2, Census Tract 234.11, DeKalb County, Georgia",2031,1987,44,2.16642048252
2008,1500000US130890234121,130890234121,"Block Group 1, Census Tract 234.12, DeKalb County, Georgia",2020,2020,0,0.0
2009,1500000US130890234122,130890234122,"Block Group 2, Census Tract 234.12, DeKalb County, Georgia",1810,1810,0,0.0
2010,1500000US130890234123,130890234123,"Block Group 3, Census Tract 234.12, DeKalb County, Georgia",2661,2661,0,0.0
2011,1500000US130890234131,130890234131,"Block Group 1, Census Tract 234.13, DeKalb County, Georgia",1703,1703,0,0.0
2012,1500000US130890234132,130890234132,"Block Group 2, Census Tract 234.13, DeKalb County, Georgia",1707,1604,103,6.03397773872
2013,1500000US130890234141,130890234141,"Block Group 1, Census Tract 234.14, DeKalb County, Georgia",2144,2144,0,0.0
2014,1500000US130890234142,130890234142,"Block Group 2, Census Tract 234.14, DeKalb County, Georgia",1237,1237,0,0.0
2015,1500000US130890234143,130890234143,"Block Group 3, Census Tract 234.14, DeKalb County, Georgia",3100,3089,11,0.354838709677
2016,1500000US130890234161,130890234161,"Block Group 1, Census Tract 234.16, DeKalb County, Georgia",1979,1948,31,1.56644770086
2017,1500000US130890234162,130890234162,"Block Group 2, Census Tract 234.16, DeKalb County, Georgia",2807,2807,0,0.0
2018,1500000US130890234163,130890234163,"Block Group 3, Census Tract 234.16, DeKalb County, Georgia",1577,1545,32,2.02916930881
2019,1500000US130890234164,130890234164,"Block Group 4, Census Tract 234.16, DeKalb County, Georgia",1561,1561,0,0.0
2020,1500000US130890234181,130890234181,"Block Group 1, Census Tract 234.18, DeKalb County, Georgia",6278,6278,0,0.0
2021,1500000US130890234182,130890234182,"Block Group 2, Census Tract 234.18, DeKalb County, Georgia",3327,3327,0,0.0
2022,1500000US130890234183,130890234183,"Block Group 3, Census Tract 234.18, DeKalb County, Georgia",3750,3750,0,0.0
2023,1500000US130890234184,130890234184,"Block Group 4, Census Tract 234.18, DeKalb County, Georgia",5968,5695,273,4.57439678284
2024,1500000US130890234191,130890234191,"Block Group 1, Census Tract 234.19, DeKalb County, Georgia",6097,6005,92,1.50893882237
2025,1500000US130890234192,130890234192,"Block Group 2, Census Tract 234.19, DeKalb County, Georgia",1448,1448,0,0.0
2026,1500000US130890234193,130890234193,"Block Group 3, Census Tract 234.19, DeKalb County, Georgia",1960,1960,0,0.0
2027,1500000US130890234211,130890234211,"Block Group 1, Census Tract 234.21, DeKalb County, Georgia",3190,3190,0,0.0
2028,1500000US130890234212,130890234212,"Block Group 2, Census Tract 234.21, DeKalb County, Georgia",1167,1155,12,1.02827763496
2029,1500000US130890234213,130890234213,"Block Group 3, Census Tract 234.21, DeKalb County, Georgia",3572,3540,32,0.895856662934
2030,1500000US130890234221,130890234221,"Block Group 1, Census Tract 234.22, DeKalb County, Georgia",1762,1618,144,8.17253121453
2031,1500000US130890234222,130890234222,"Block Group 2, Census Tract 234.22, DeKalb County, Georgia",3177,3148,29,0.912810827825
2032,1500000US130890234231,130890234231,"Block Group 1, Census Tract 234.23, DeKalb County, Georgia",2802,2730,72,2.56959314775
2033,1500000US130890234232,130890234232,"Block Group 2, Census Tract 234.23, DeKalb County, Georgia",1368,1293,75,5.48245614035
2034,1500000US130890234233,130890234233,"Block Group 3, Census Tract 234.23, DeKalb County, Georgia",3337,3289,48,1.43841774049
2035,1500000US130890234241,130890234241,"Block Group 1, Census Tract 234.24, DeKalb County, Georgia",4005,3844,161,4.01997503121
2036,1500000US130890234242,130890234242,"Block Group 2, Census Tract 234.24, DeKalb County, Georgia",1889,1889,0,0.0
2037,1500000US130890234251,130890234251,"Block Group 1, Census Tract 234.25, DeKalb County, Georgia",2355,2334,21,0.891719745223
2038,1500000US130890234252,130890234252,"Block Group 2, Census Tract 234.25, DeKalb County, Georgia",3424,3413,11,0.321261682243
2039,1500000US130890234261,130890234261,"Block Group 1, Census Tract 234.26, DeKalb County, Georgia",2614,2570,44,1.68324407039
2040,1500000US130890234262,130890234262,"Block Group 2, Census Tract 234.26, DeKalb County, Georgia",2211,2211,0,0.0
2041,1500000US130890234271,130890234271,"Block Group 1, Census Tract 234.27, DeKalb County, Georgia",2099,2099,0,0.0
2042,1500000US130890234272,130890234272,"Block Group 2, Census Tract 234.27, DeKalb County, Georgia",739,739,0,0.0
2043,1500000US130890234281,130890234281,"Block Group 1, Census Tract 234.28, DeKalb County, Georgia",831,831,0,0.0
2044,1500000US130890234282,130890234282,"Block Group 2, Census Tract 234.28, DeKalb County, Georgia",2665,2665,0,0.0
2045,1500000US130890234283,130890234283,"Block Group 3, Census Tract 234.28, DeKalb County, Georgia",4534,4407,127,2.80105866784
2046,1500000US130890234284,130890234284,"Block Group 4, Census Tract 234.28, DeKalb County, Georgia",1688,1688,0,0.0
2047,1500000US130890235011,130890235011,"Block Group 1, Census Tract 235.01, DeKalb County, Georgia",1472,1463,9,0.611413043478
2048,1500000US130890235012,130890235012,"Block Group 2, Census Tract 235.01, DeKalb County, Georgia",1828,1811,17,0.929978118162
2049,1500000US130890235041,130890235041,"Block Group 1, Census Tract 235.04, DeKalb County, Georgia",787,703,84,10.6734434562
2050,1500000US130890235042,130890235042,"Block Group 2, Census Tract 235.04, DeKalb County, Georgia",687,687,0,0.0
2051,1500000US130890235043,130890235043,"Block Group 3, Census Tract 235.04, DeKalb County, Georgia",1555,1511,44,2.82958199357
2052,1500000US130890235051,130890235051,"Block Group 1, Census Tract 235.05, DeKalb County, Georgia",1283,1246,37,2.8838659392
2053,1500000US130890235052,130890235052,"Block Group 2, Census Tract 235.05, DeKalb County, Georgia",1188,1188,0,0.0
2054,1500000US130890235061,130890235061,"Block Group 1, Census Tract 235.06, DeKalb County, Georgia",2139,2131,8,0.374006545115
2055,1500000US130890235062,130890235062,"Block Group 2, Census Tract 235.06, DeKalb County, Georgia",2033,2033,0,0.0
2056,1500000US130890235063,130890235063,"Block Group 3, Census Tract 235.06, DeKalb County, Georgia",1795,1795,0,0.0
2057,1500000US130890235071,130890235071,"Block Group 1, Census Tract 235.07, DeKalb County, Georgia",1109,1101,8,0.721370604148
2058,1500000US130890235072,130890235072,"Block Group 2, Census Tract 235.07, DeKalb County, Georgia",1018,1010,8,0.785854616896
2059,1500000US130890235073,130890235073,"Block Group 3, Census Tract 235.07, DeKalb County, Georgia",1743,1724,19,1.09007458405
2060,1500000US130890236011,130890236011,"Block Group 1, Census Tract 236.01, DeKalb County, Georgia",1018,1014,4,0.392927308448
2061,1500000US130890236012,130890236012,"Block Group 2, Census Tract 236.01, DeKalb County, Georgia",1208,1208,0,0.0
2062,1500000US130890236013,130890236013,"Block Group 3, Census Tract 236.01, DeKalb County, Georgia",878,835,43,4.89749430524
2063,1500000US130890236021,130890236021,"Block Group 1, Census Tract 236.02, DeKalb County, Georgia",1000,1000,0,0.0
2064,1500000US130890236022,130890236022,"Block Group 2, Census Tract 236.02, DeKalb County, Georgia",1591,1571,20,1.25707102451
2065,1500000US130890236031,130890236031,"Block Group 1, Census Tract 236.03, DeKalb County, Georgia",1688,1672,16,0.947867298578
2066,1500000US130890236032,130890236032,"Block Group 2, Census Tract 236.03, DeKalb County, Georgia",1747,1747,0,0.0
2067,1500000US130890237001,130890237001,"Block Group 1, Census Tract 237, DeKalb County, Georgia",1747,1632,115,6.58271322267
2068,1500000US130890237002,130890237002,"Block Group 2, Census Tract 237, DeKalb County, Georgia",1343,1314,29,2.15934475056
2069,1500000US130890237003,130890237003,"Block Group 3, Census Tract 237, DeKalb County, Georgia",1469,1430,39,2.65486725664
2070,1500000US130890237004,130890237004,"Block Group 4, Census Tract 237, DeKalb County, Georgia",1147,1147,0,0.0
2071,1500000US130890238011,130890238011,"Block Group 1, Census Tract 238.01, DeKalb County, Georgia",675,654,21,3.11111111111
2072,1500000US130890238012,130890238012,"Block Group 2, Census Tract 238.01, DeKalb County, Georgia",1642,1549,93,5.66382460414
2073,1500000US130890238013,130890238013,"Block Group 3, Census Tract 238.01, DeKalb County, Georgia",1268,1234,34,2.68138801262
2074,1500000US130890238021,130890238021,"Block Group 1, Census Tract 238.02, DeKalb County, Georgia",1314,1277,37,2.81582952816
2075,1500000US130890238022,130890238022,"Block Group 2, Census Tract 238.02, DeKalb County, Georgia",3683,3406,277,7.52104262829
2076,1500000US130890238031,130890238031,"Block Group 1, Census Tract 238.03, DeKalb County, Georgia",1131,1081,50,4.42086648983
2077,1500000US130890238032,130890238032,"Block Group 2, Census Tract 238.03, DeKalb County, Georgia",804,687,117,14.552238806
2078,1500000US130890238033,130890238033,"Block Group 3, Census Tract 238.03, DeKalb County, Georgia",1672,1634,38,2.27272727273
2079,1500000US130890238034,130890238034,"Block Group 4, Census Tract 238.03, DeKalb County, Georgia",1713,1613,100,5.83771161705
2080,1500000US130899800001,130899800001,"Block Group 1, Census Tract 9800, DeKalb County, Georgia",0,0,0,
2081,1500000US130919601001,130919601001,"Block Group 1, Census Tract 9601, Dodge County, Georgia",2704,2657,47,1.73816568047
2082,1500000US130919601002,130919601002,"Block Group 2, Census Tract 9601, Dodge County, Georgia",874,821,53,6.06407322654
2083,1500000US130919602001,130919602001,"Block Group 1, Census Tract 9602, Dodge County, Georgia",1736,1724,12,0.691244239631
2084,1500000US130919602002,130919602002,"Block Group 2, Census Tract 9602, Dodge County, Georgia",971,909,62,6.38516992791
2085,1500000US130919602003,130919602003,"Block Group 3, Census Tract 9602, Dodge County, Georgia",577,560,17,2.94627383016
2086,1500000US130919603001,130919603001,"Block Group 1, Census Tract 9603, Dodge County, Georgia",1583,1471,112,7.07517372078
2087,1500000US130919603002,130919603002,"Block Group 2, Census Tract 9603, Dodge County, Georgia",1463,1163,300,20.5058099795
2088,1500000US130919603003,130919603003,"Block Group 3, Census Tract 9603, Dodge County, Georgia",894,894,0,0.0
2089,1500000US130919603004,130919603004,"Block Group 4, Census Tract 9603, Dodge County, Georgia",1059,1059,0,0.0
2090,1500000US130919603005,130919603005,"Block Group 5, Census Tract 9603, Dodge County, Georgia",1371,1371,0,0.0
2091,1500000US130919604001,130919604001,"Block Group 1, Census Tract 9604, Dodge County, Georgia",1007,1007,0,0.0
2092,1500000US130919604002,130919604002,"Block Group 2, Census Tract 9604, Dodge County, Georgia",1365,1308,57,4.17582417582
2093,1500000US130919604003,130919604003,"Block Group 3, Census Tract 9604, Dodge County, Georgia",1448,1444,4,0.276243093923
2094,1500000US130919605001,130919605001,"Block Group 1, Census Tract 9605, Dodge County, Georgia",1046,1018,28,2.67686424474
2095,1500000US130919605002,130919605002,"Block Group 2, Census Tract 9605, Dodge County, Georgia",1128,1128,0,0.0
2096,1500000US130919606001,130919606001,"Block Group 1, Census Tract 9606, Dodge County, Georgia",1031,1031,0,0.0
2097,1500000US130919606002,130919606002,"Block Group 2, Census Tract 9606, Dodge County, Georgia",923,870,53,5.74214517876
2098,1500000US130939701001,130939701001,"Block Group 1, Census Tract 9701, Dooly County, Georgia",3179,2800,379,11.9219880466
2099,1500000US130939701002,130939701002,"Block Group 2, Census Tract 9701, Dooly County, Georgia",1732,1726,6,0.346420323326
2100,1500000US130939701003,130939701003,"Block Group 3, Census Tract 9701, Dooly County, Georgia",760,754,6,0.789473684211
2101,1500000US130939702001,130939702001,"Block Group 1, Census Tract 9702, Dooly County, Georgia",790,783,7,0.886075949367
2102,1500000US130939702002,130939702002,"Block Group 2, Census Tract 9702, Dooly County, Georgia",1305,1146,159,12.183908046
2103,1500000US130939703001,130939703001,"Block Group 1, Census Tract 9703, Dooly County, Georgia",2016,1890,126,6.25
2104,1500000US130939703002,130939703002,"Block Group 2, Census Tract 9703, Dooly County, Georgia",1611,1267,344,21.3531967722
2105,1500000US130939703003,130939703003,"Block Group 3, Census Tract 9703, Dooly County, Georgia",2021,2021,0,0.0
2106,1500000US130939703004,130939703004,"Block Group 4, Census Tract 9703, Dooly County, Georgia",879,879,0,0.0
2107,1500000US130950001001,130950001001,"Block Group 1, Census Tract 1, Dougherty County, Georgia",878,878,0,0.0
2108,1500000US130950001002,130950001002,"Block Group 2, Census Tract 1, Dougherty County, Georgia",386,386,0,0.0
2109,1500000US130950001003,130950001003,"Block Group 3, Census Tract 1, Dougherty County, Georgia",971,971,0,0.0
2110,1500000US130950001004,130950001004,"Block Group 4, Census Tract 1, Dougherty County, Georgia",1439,1383,56,3.8915913829
2111,1500000US130950001005,130950001005,"Block Group 5, Census Tract 1, Dougherty County, Georgia",895,849,46,5.13966480447
2112,1500000US130950002001,130950002001,"Block Group 1, Census Tract 2, Dougherty County, Georgia",785,773,12,1.52866242038
2113,1500000US130950002002,130950002002,"Block Group 2, Census Tract 2, Dougherty County, Georgia",291,250,41,14.089347079
2114,1500000US130950002003,130950002003,"Block Group 3, Census Tract 2, Dougherty County, Georgia",1328,1328,0,0.0
2115,1500000US130950002004,130950002004,"Block Group 4, Census Tract 2, Dougherty County, Georgia",556,555,1,0.179856115108
2116,1500000US130950004001,130950004001,"Block Group 1, Census Tract 4, Dougherty County, Georgia",1354,1312,42,3.10192023634
2117,1500000US130950004002,130950004002,"Block Group 2, Census Tract 4, Dougherty County, Georgia",2320,2277,43,1.85344827586
2118,1500000US130950004003,130950004003,"Block Group 3, Census Tract 4, Dougherty County, Georgia",2324,2288,36,1.54905335628
2119,1500000US130950005011,130950005011,"Block Group 1, Census Tract 5.01, Dougherty County, Georgia",3564,3525,39,1.09427609428
2120,1500000US130950005012,130950005012,"Block Group 2, Census Tract 5.01, Dougherty County, Georgia",1511,1462,49,3.24288550629
2121,1500000US130950005021,130950005021,"Block Group 1, Census Tract 5.02, Dougherty County, Georgia",1752,1752,0,0.0
2122,1500000US130950005022,130950005022,"Block Group 2, Census Tract 5.02, Dougherty County, Georgia",1500,1218,282,18.8
2123,1500000US130950005023,130950005023,"Block Group 3, Census Tract 5.02, Dougherty County, Georgia",686,686,0,0.0
2124,1500000US130950005024,130950005024,"Block Group 4, Census Tract 5.02, Dougherty County, Georgia",969,969,0,0.0
2125,1500000US130950006001,130950006001,"Block Group 1, Census Tract 6, Dougherty County, Georgia",1284,1261,23,1.79127725857
2126,1500000US130950006002,130950006002,"Block Group 2, Census Tract 6, Dougherty County, Georgia",1661,1620,41,2.46839253462
2127,1500000US130950007001,130950007001,"Block Group 1, Census Tract 7, Dougherty County, Georgia",1903,1845,58,3.04781923279
2128,1500000US130950008001,130950008001,"Block Group 1, Census Tract 8, Dougherty County, Georgia",889,889,0,0.0
2129,1500000US130950008002,130950008002,"Block Group 2, Census Tract 8, Dougherty County, Georgia",662,621,41,6.19335347432
2130,1500000US130950009001,130950009001,"Block Group 1, Census Tract 9, Dougherty County, Georgia",1049,1031,18,1.71591992374
2131,1500000US130950009002,130950009002,"Block Group 2, Census Tract 9, Dougherty County, Georgia",1020,1006,14,1.37254901961
2132,1500000US130950010001,130950010001,"Block Group 1, Census Tract 10, Dougherty County, Georgia",517,517,0,0.0
2133,1500000US130950010002,130950010002,"Block Group 2, Census Tract 10, Dougherty County, Georgia",1808,1773,35,1.93584070796
2134,1500000US130950011001,130950011001,"Block Group 1, Census Tract 11, Dougherty County, Georgia",1517,1503,14,0.922874093606
2135,1500000US130950011002,130950011002,"Block Group 2, Census Tract 11, Dougherty County, Georgia",1110,1110,0,0.0
2136,1500000US130950011003,130950011003,"Block Group 3, Census Tract 11, Dougherty County, Georgia",916,902,14,1.52838427948
2137,1500000US130950011004,130950011004,"Block Group 4, Census Tract 11, Dougherty County, Georgia",1086,1086,0,0.0
2138,1500000US130950011005,130950011005,"Block Group 5, Census Tract 11, Dougherty County, Georgia",1508,1508,0,0.0
2139,1500000US130950014031,130950014031,"Block Group 1, Census Tract 14.03, Dougherty County, Georgia",1081,1081,0,0.0
2140,1500000US130950014032,130950014032,"Block Group 2, Census Tract 14.03, Dougherty County, Georgia",1399,1399,0,0.0
2141,1500000US130950015001,130950015001,"Block Group 1, Census Tract 15, Dougherty County, Georgia",711,707,4,0.56258790436
2142,1500000US130950015002,130950015002,"Block Group 2, Census Tract 15, Dougherty County, Georgia",1164,1164,0,0.0
2143,1500000US130950015003,130950015003,"Block Group 3, Census Tract 15, Dougherty County, Georgia",920,809,111,12.0652173913
2144,1500000US130950103021,130950103021,"Block Group 1, Census Tract 103.02, Dougherty County, Georgia",805,805,0,0.0
2145,1500000US130950103022,130950103022,"Block Group 2, Census Tract 103.02, Dougherty County, Georgia",1092,1092,0,0.0
2146,1500000US130950103023,130950103023,"Block Group 3, Census Tract 103.02, Dougherty County, Georgia",1654,1654,0,0.0
2147,1500000US130950103024,130950103024,"Block Group 4, Census Tract 103.02, Dougherty County, Georgia",712,699,13,1.82584269663
2148,1500000US130950103025,130950103025,"Block Group 5, Census Tract 103.02, Dougherty County, Georgia",1579,1545,34,2.15326155795
2149,1500000US130950104011,130950104011,"Block Group 1, Census Tract 104.01, Dougherty County, Georgia",2220,2220,0,0.0
2150,1500000US130950104012,130950104012,"Block Group 2, Census Tract 104.01, Dougherty County, Georgia",3110,2953,157,5.04823151125
2151,1500000US130950104013,130950104013,"Block Group 3, Census Tract 104.01, Dougherty County, Georgia",2076,2059,17,0.818882466281
2152,1500000US130950104021,130950104021,"Block Group 1, Census Tract 104.02, Dougherty County, Georgia",3026,2970,56,1.85062789161
2153,1500000US130950104031,130950104031,"Block Group 1, Census Tract 104.03, Dougherty County, Georgia",1581,1566,15,0.948766603416
2154,1500000US130950105001,130950105001,"Block Group 1, Census Tract 105, Dougherty County, Georgia",1579,1433,146,9.24635845472
2155,1500000US130950105002,130950105002,"Block Group 2, Census Tract 105, Dougherty County, Georgia",754,754,0,0.0
2156,1500000US130950106011,130950106011,"Block Group 1, Census Tract 106.01, Dougherty County, Georgia",1181,1176,5,0.423370025402
2157,1500000US130950106012,130950106012,"Block Group 2, Census Tract 106.01, Dougherty County, Georgia",1270,1270,0,0.0
2158,1500000US130950106021,130950106021,"Block Group 1, Census Tract 106.02, Dougherty County, Georgia",2054,2054,0,0.0
2159,1500000US130950106022,130950106022,"Block Group 2, Census Tract 106.02, Dougherty County, Georgia",1942,1942,0,0.0
2160,1500000US130950107001,130950107001,"Block Group 1, Census Tract 107, Dougherty County, Georgia",3135,2761,374,11.9298245614
2161,1500000US130950107002,130950107002,"Block Group 2, Census Tract 107, Dougherty County, Georgia",949,949,0,0.0
2162,1500000US130950107003,130950107003,"Block Group 3, Census Tract 107, Dougherty County, Georgia",2288,2270,18,0.786713286713
2163,1500000US130950109001,130950109001,"Block Group 1, Census Tract 109, Dougherty County, Georgia",1079,1079,0,0.0
2164,1500000US130950109002,130950109002,"Block Group 2, Census Tract 109, Dougherty County, Georgia",581,581,0,0.0
2165,1500000US130950109003,130950109003,"Block Group 3, Census Tract 109, Dougherty County, Georgia",21,21,0,0.0
2166,1500000US130950110001,130950110001,"Block Group 1, Census Tract 110, Dougherty County, Georgia",1294,1263,31,2.39567233385
2167,1500000US130950110002,130950110002,"Block Group 2, Census Tract 110, Dougherty County, Georgia",1225,1178,47,3.83673469388
2168,1500000US130950112001,130950112001,"Block Group 1, Census Tract 112, Dougherty County, Georgia",1553,1520,33,2.12491951062
2169,1500000US130950112002,130950112002,"Block Group 2, Census Tract 112, Dougherty County, Georgia",1344,1222,122,9.07738095238
2170,1500000US130950112003,130950112003,"Block Group 3, Census Tract 112, Dougherty County, Georgia",1151,1140,11,0.955690703736
2171,1500000US130950113001,130950113001,"Block Group 1, Census Tract 113, Dougherty County, Georgia",2566,2455,111,4.32579890881
2172,1500000US130950114001,130950114001,"Block Group 1, Census Tract 114, Dougherty County, Georgia",1260,1232,28,2.22222222222
2173,1500000US130950114002,130950114002,"Block Group 2, Census Tract 114, Dougherty County, Georgia",471,467,4,0.849256900212
2174,1500000US130950116001,130950116001,"Block Group 1, Census Tract 116, Dougherty County, Georgia",1547,1494,53,3.42598577893
2175,1500000US130950116002,130950116002,"Block Group 2, Census Tract 116, Dougherty County, Georgia",497,418,79,15.8953722334
2176,1500000US130970801021,130970801021,"Block Group 1, Census Tract 801.02, Douglas County, Georgia",1889,1571,318,16.8343038645
2177,1500000US130970801022,130970801022,"Block Group 2, Census Tract 801.02, Douglas County, Georgia",5492,5139,353,6.42753095412
2178,1500000US130970801031,130970801031,"Block Group 1, Census Tract 801.03, Douglas County, Georgia",1459,1459,0,0.0
2179,1500000US130970801032,130970801032,"Block Group 2, Census Tract 801.03, Douglas County, Georgia",1633,1485,148,9.06307409675
2180,1500000US130970801033,130970801033,"Block Group 3, Census Tract 801.03, Douglas County, Georgia",1094,1019,75,6.85557586837
2181,1500000US130970801034,130970801034,"Block Group 4, Census Tract 801.03, Douglas County, Georgia",2769,2008,761,27.4828457927
2182,1500000US130970802011,130970802011,"Block Group 1, Census Tract 802.01, Douglas County, Georgia",750,737,13,1.73333333333
2183,1500000US130970802012,130970802012,"Block Group 2, Census Tract 802.01, Douglas County, Georgia",3188,2101,1087,34.0966122961
2184,1500000US130970802013,130970802013,"Block Group 3, Census Tract 802.01, Douglas County, Georgia",1873,1627,246,13.1340096103
2185,1500000US130970802021,130970802021,"Block Group 1, Census Tract 802.02, Douglas County, Georgia",851,823,28,3.29024676851
2186,1500000US130970802022,130970802022,"Block Group 2, Census Tract 802.02, Douglas County, Georgia",2602,2204,398,15.2959262106
2187,1500000US130970802023,130970802023,"Block Group 3, Census Tract 802.02, Douglas County, Georgia",3964,3269,695,17.5327951564
2188,1500000US130970802024,130970802024,"Block Group 4, Census Tract 802.02, Douglas County, Georgia",2840,2185,655,23.0633802817
2189,1500000US130970803011,130970803011,"Block Group 1, Census Tract 803.01, Douglas County, Georgia",3349,3098,251,7.49477455957
2190,1500000US130970803012,130970803012,"Block Group 2, Census Tract 803.01, Douglas County, Georgia",3506,3283,223,6.3605248146
2191,1500000US130970803013,130970803013,"Block Group 3, Census Tract 803.01, Douglas County, Georgia",3691,3555,136,3.6846383094
2192,1500000US130970803014,130970803014,"Block Group 4, Census Tract 803.01, Douglas County, Georgia",1798,1775,23,1.27919911012
2193,1500000US130970803031,130970803031,"Block Group 1, Census Tract 803.03, Douglas County, Georgia",2966,2578,388,13.0815913688
2194,1500000US130970803032,130970803032,"Block Group 2, Census Tract 803.03, Douglas County, Georgia",950,746,204,21.4736842105
2195,1500000US130970803041,130970803041,"Block Group 1, Census Tract 803.04, Douglas County, Georgia",1949,1847,102,5.23345305285
2196,1500000US130970803042,130970803042,"Block Group 2, Census Tract 803.04, Douglas County, Georgia",3388,3242,146,4.3093270366
2197,1500000US130970804021,130970804021,"Block Group 1, Census Tract 804.02, Douglas County, Georgia",1678,1572,106,6.31704410012
2198,1500000US130970804022,130970804022,"Block Group 2, Census Tract 804.02, Douglas County, Georgia",3139,3139,0,0.0
2199,1500000US130970804023,130970804023,"Block Group 3, Census Tract 804.02, Douglas County, Georgia",3313,3138,175,5.28222155146
2200,1500000US130970804031,130970804031,"Block Group 1, Census Tract 804.03, Douglas County, Georgia",3515,3493,22,0.625889046942
2201,1500000US130970804032,130970804032,"Block Group 2, Census Tract 804.03, Douglas County, Georgia",1375,1151,224,16.2909090909
2202,1500000US130970804041,130970804041,"Block Group 1, Census Tract 804.04, Douglas County, Georgia",2284,1260,1024,44.8336252189
2203,1500000US130970804042,130970804042,"Block Group 2, Census Tract 804.04, Douglas County, Georgia",977,948,29,2.96827021494
2204,1500000US130970804043,130970804043,"Block Group 3, Census Tract 804.04, Douglas County, Georgia",5356,5100,256,4.77968633308
2205,1500000US130970805051,130970805051,"Block Group 1, Census Tract 805.05, Douglas County, Georgia",3285,3105,180,5.47945205479
2206,1500000US130970805052,130970805052,"Block Group 2, Census Tract 805.05, Douglas County, Georgia",1568,1440,128,8.16326530612
2207,1500000US130970805061,130970805061,"Block Group 1, Census Tract 805.06, Douglas County, Georgia",1259,1195,64,5.08339952343
2208,1500000US130970805062,130970805062,"Block Group 2, Census Tract 805.06, Douglas County, Georgia",2315,2090,225,9.7192224622
2209,1500000US130970805063,130970805063,"Block Group 3, Census Tract 805.06, Douglas County, Georgia",1898,1880,18,0.948366701791
2210,1500000US130970805071,130970805071,"Block Group 1, Census Tract 805.07, Douglas County, Georgia",2699,2379,320,11.856243053
2211,1500000US130970805072,130970805072,"Block Group 2, Census Tract 805.07, Douglas County, Georgia",976,927,49,5.02049180328
2212,1500000US130970805081,130970805081,"Block Group 1, Census Tract 805.08, Douglas County, Georgia",1607,1545,62,3.85812072184
2213,1500000US130970805082,130970805082,"Block Group 2, Census Tract 805.08, Douglas County, Georgia",2117,1833,284,13.4152102031
2214,1500000US130970805083,130970805083,"Block Group 3, Census Tract 805.08, Douglas County, Georgia",1485,1454,31,2.08754208754
2215,1500000US130970805091,130970805091,"Block Group 1, Census Tract 805.09, Douglas County, Georgia",2040,2040,0,0.0
2216,1500000US130970805092,130970805092,"Block Group 2, Census Tract 805.09, Douglas County, Georgia",2569,2455,114,4.43752432853
2217,1500000US130970805093,130970805093,"Block Group 3, Census Tract 805.09, Douglas County, Georgia",1141,1034,107,9.37773882559
2218,1500000US130970805101,130970805101,"Block Group 1, Census Tract 805.10, Douglas County, Georgia",2247,2226,21,0.934579439252
2219,1500000US130970805102,130970805102,"Block Group 2, Census Tract 805.10, Douglas County, Georgia",3193,2596,597,18.6971500157
2220,1500000US130970805103,130970805103,"Block Group 3, Census Tract 805.10, Douglas County, Georgia",2265,2158,107,4.72406181015
2221,1500000US130970805111,130970805111,"Block Group 1, Census Tract 805.11, Douglas County, Georgia",3845,3477,368,9.57087126138
2222,1500000US130970805112,130970805112,"Block Group 2, Census Tract 805.11, Douglas County, Georgia",5071,4783,288,5.67935318478
2223,1500000US130970806021,130970806021,"Block Group 1, Census Tract 806.02, Douglas County, Georgia",3339,3287,52,1.55735250075
2224,1500000US130970806022,130970806022,"Block Group 2, Census Tract 806.02, Douglas County, Georgia",2251,2185,66,2.9320302088
2225,1500000US130970806031,130970806031,"Block Group 1, Census Tract 806.03, Douglas County, Georgia",3190,3112,78,2.44514106583
2226,1500000US130970806032,130970806032,"Block Group 2, Census Tract 806.03, Douglas County, Georgia",2794,2398,396,14.1732283465
2227,1500000US130970806041,130970806041,"Block Group 1, Census Tract 806.04, Douglas County, Georgia",825,825,0,0.0
2228,1500000US130970806042,130970806042,"Block Group 2, Census Tract 806.04, Douglas County, Georgia",5504,5503,1,0.0181686046512
2229,1500000US130970806043,130970806043,"Block Group 3, Census Tract 806.04, Douglas County, Georgia",1955,1580,375,19.1815856777
2230,1500000US130970806044,130970806044,"Block Group 4, Census Tract 806.04, Douglas County, Georgia",1444,1444,0,0.0
2231,1500000US130990901001,130990901001,"Block Group 1, Census Tract 901, Early County, Georgia",578,574,4,0.692041522491
2232,1500000US130990901002,130990901002,"Block Group 2, Census Tract 901, Early County, Georgia",802,788,14,1.74563591022
2233,1500000US130990902001,130990902001,"Block Group 1, Census Tract 902, Early County, Georgia",629,629,0,0.0
2234,1500000US130990902002,130990902002,"Block Group 2, Census Tract 902, Early County, Georgia",614,614,0,0.0
2235,1500000US130990902003,130990902003,"Block Group 3, Census Tract 902, Early County, Georgia",746,746,0,0.0
2236,1500000US130990902004,130990902004,"Block Group 4, Census Tract 902, Early County, Georgia",421,421,0,0.0
2237,1500000US130990903001,130990903001,"Block Group 1, Census Tract 903, Early County, Georgia",905,905,0,0.0
2238,1500000US130990903002,130990903002,"Block Group 2, Census Tract 903, Early County, Georgia",674,588,86,12.7596439169
2239,1500000US130990904001,130990904001,"Block Group 1, Census Tract 904, Early County, Georgia",1240,1240,0,0.0
2240,1500000US130990904002,130990904002,"Block Group 2, Census Tract 904, Early County, Georgia",1003,945,58,5.78265204387
2241,1500000US130990904003,130990904003,"Block Group 3, Census Tract 904, Early County, Georgia",1118,1108,10,0.894454382826
2242,1500000US130990905001,130990905001,"Block Group 1, Census Tract 905, Early County, Georgia",702,702,0,0.0
2243,1500000US130990905002,130990905002,"Block Group 2, Census Tract 905, Early County, Georgia",1147,1105,42,3.66172624237
2244,1500000US131018801001,131018801001,"Block Group 1, Census Tract 8801, Echols County, Georgia",1662,1238,424,25.5114320096
2245,1500000US131018802001,131018802001,"Block Group 1, Census Tract 8802, Echols County, Georgia",820,674,146,17.8048780488
2246,1500000US131018802002,131018802002,"Block Group 2, Census Tract 8802, Echols County, Georgia",1566,1100,466,29.7573435504
2247,1500000US131030301001,131030301001,"Block Group 1, Census Tract 301, Effingham County, Georgia",1927,1927,0,0.0
2248,1500000US131030301002,131030301002,"Block Group 2, Census Tract 301, Effingham County, Georgia",580,580,0,0.0
2249,1500000US131030301003,131030301003,"Block Group 3, Census Tract 301, Effingham County, Georgia",907,888,19,2.09481808159
2250,1500000US131030302021,131030302021,"Block Group 1, Census Tract 302.02, Effingham County, Georgia",1732,1732,0,0.0
2251,1500000US131030302022,131030302022,"Block Group 2, Census Tract 302.02, Effingham County, Georgia",4036,3928,108,2.67591674926
2252,1500000US131030302031,131030302031,"Block Group 1, Census Tract 302.03, Effingham County, Georgia",1021,1013,8,0.783545543585
2253,1500000US131030302032,131030302032,"Block Group 2, Census Tract 302.03, Effingham County, Georgia",4667,4273,394,8.44225412471
2254,1500000US131030302033,131030302033,"Block Group 3, Census Tract 302.03, Effingham County, Georgia",2309,2309,0,0.0
2255,1500000US131030302041,131030302041,"Block Group 1, Census Tract 302.04, Effingham County, Georgia",2014,2014,0,0.0
2256,1500000US131030302042,131030302042,"Block Group 2, Census Tract 302.04, Effingham County, Georgia",1933,1892,41,2.12105535437
2257,1500000US131030303011,131030303011,"Block Group 1, Census Tract 303.01, Effingham County, Georgia",2547,2523,24,0.942285041225
2258,1500000US131030303012,131030303012,"Block Group 2, Census Tract 303.01, Effingham County, Georgia",2086,2068,18,0.862895493768
2259,1500000US131030303031,131030303031,"Block Group 1, Census Tract 303.03, Effingham County, Georgia",2339,2199,140,5.98546387345
2260,1500000US131030303041,131030303041,"Block Group 1, Census Tract 303.04, Effingham County, Georgia",2875,2811,64,2.22608695652
2261,1500000US131030303042,131030303042,"Block Group 2, Census Tract 303.04, Effingham County, Georgia",2782,2458,324,11.6462976276
2262,1500000US131030303043,131030303043,"Block Group 3, Census Tract 303.04, Effingham County, Georgia",1694,1694,0,0.0
2263,1500000US131030303051,131030303051,"Block Group 1, Census Tract 303.05, Effingham County, Georgia",2762,2699,63,2.28095582911
2264,1500000US131030303052,131030303052,"Block Group 2, Census Tract 303.05, Effingham County, Georgia",5303,5017,286,5.39317367528
2265,1500000US131030304011,131030304011,"Block Group 1, Census Tract 304.01, Effingham County, Georgia",2065,2011,54,2.61501210654
2266,1500000US131030304012,131030304012,"Block Group 2, Census Tract 304.01, Effingham County, Georgia",3017,2916,101,3.34769638714
2267,1500000US131030304021,131030304021,"Block Group 1, Census Tract 304.02, Effingham County, Georgia",3275,3118,157,4.79389312977
2268,1500000US131030304022,131030304022,"Block Group 2, Census Tract 304.02, Effingham County, Georgia",2759,2664,95,3.44327654947
2269,1500000US131050001001,131050001001,"Block Group 1, Census Tract 1, Elbert County, Georgia",926,871,55,5.93952483801
2270,1500000US131050001002,131050001002,"Block Group 2, Census Tract 1, Elbert County, Georgia",1216,1197,19,1.5625
2271,1500000US131050001003,131050001003,"Block Group 3, Census Tract 1, Elbert County, Georgia",1387,1335,52,3.74909877433
2272,1500000US131050002001,131050002001,"Block Group 1, Census Tract 2, Elbert County, Georgia",961,961,0,0.0
2273,1500000US131050002002,131050002002,"Block Group 2, Census Tract 2, Elbert County, Georgia",898,845,53,5.90200445434
2274,1500000US131050002003,131050002003,"Block Group 3, Census Tract 2, Elbert County, Georgia",948,861,87,9.17721518987
2275,1500000US131050003001,131050003001,"Block Group 1, Census Tract 3, Elbert County, Georgia",998,998,0,0.0
2276,1500000US131050003002,131050003002,"Block Group 2, Census Tract 3, Elbert County, Georgia",1087,1087,0,0.0
2277,1500000US131050003003,131050003003,"Block Group 3, Census Tract 3, Elbert County, Georgia",1660,1365,295,17.7710843373
2278,1500000US131050004001,131050004001,"Block Group 1, Census Tract 4, Elbert County, Georgia",945,945,0,0.0
2279,1500000US131050004002,131050004002,"Block Group 2, Census Tract 4, Elbert County, Georgia",878,741,137,15.6036446469
2280,1500000US131050004003,131050004003,"Block Group 3, Census Tract 4, Elbert County, Georgia",1048,876,172,16.4122137405
2281,1500000US131050004004,131050004004,"Block Group 4, Census Tract 4, Elbert County, Georgia",597,459,138,23.1155778894
2282,1500000US131050004005,131050004005,"Block Group 5, Census Tract 4, Elbert County, Georgia",682,675,7,1.02639296188
2283,1500000US131050005001,131050005001,"Block Group 1, Census Tract 5, Elbert County, Georgia",863,863,0,0.0
2284,1500000US131050005002,131050005002,"Block Group 2, Census Tract 5, Elbert County, Georgia",1391,1391,0,0.0
2285,1500000US131050005003,131050005003,"Block Group 3, Census Tract 5, Elbert County, Georgia",791,791,0,0.0
2286,1500000US131050005004,131050005004,"Block Group 4, Census Tract 5, Elbert County, Georgia",703,685,18,2.56045519203
2287,1500000US131050005005,131050005005,"Block Group 5, Census Tract 5, Elbert County, Georgia",1092,1092,0,0.0
2288,1500000US131050005006,131050005006,"Block Group 6, Census Tract 5, Elbert County, Georgia",466,466,0,0.0
2289,1500000US131079701001,131079701001,"Block Group 1, Census Tract 9701, Emanuel County, Georgia",1923,1771,152,7.90431617265
2290,1500000US131079701002,131079701002,"Block Group 2, Census Tract 9701, Emanuel County, Georgia",424,424,0,0.0
2291,1500000US131079701003,131079701003,"Block Group 3, Census Tract 9701, Emanuel County, Georgia",2114,2053,61,2.88552507096
2292,1500000US131079701004,131079701004,"Block Group 4, Census Tract 9701, Emanuel County, Georgia",1290,1290,0,0.0
2293,1500000US131079702001,131079702001,"Block Group 1, Census Tract 9702, Emanuel County, Georgia",818,818,0,0.0
2294,1500000US131079702002,131079702002,"Block Group 2, Census Tract 9702, Emanuel County, Georgia",803,803,0,0.0
2295,1500000US131079703001,131079703001,"Block Group 1, Census Tract 9703, Emanuel County, Georgia",1333,1278,55,4.12603150788
2296,1500000US131079703002,131079703002,"Block Group 2, Census Tract 9703, Emanuel County, Georgia",1254,1179,75,5.98086124402
2297,1500000US131079703003,131079703003,"Block Group 3, Census Tract 9703, Emanuel County, Georgia",1333,1256,77,5.77644411103
2298,1500000US131079704001,131079704001,"Block Group 1, Census Tract 9704, Emanuel County, Georgia",2182,2150,32,1.46654445463
2299,1500000US131079704002,131079704002,"Block Group 2, Census Tract 9704, Emanuel County, Georgia",1428,1393,35,2.45098039216
2300,1500000US131079704003,131079704003,"Block Group 3, Census Tract 9704, Emanuel County, Georgia",1179,1179,0,0.0
2301,1500000US131079705001,131079705001,"Block Group 1, Census Tract 9705, Emanuel County, Georgia",510,510,0,0.0
2302,1500000US131079705002,131079705002,"Block Group 2, Census Tract 9705, Emanuel County, Georgia",783,783,0,0.0
2303,1500000US131079706001,131079706001,"Block Group 1, Census Tract 9706, Emanuel County, Georgia",1430,1430,0,0.0
2304,1500000US131079706002,131079706002,"Block Group 2, Census Tract 9706, Emanuel County, Georgia",1475,1348,127,8.61016949153
2305,1500000US131079706003,131079706003,"Block Group 3, Census Tract 9706, Emanuel County, Georgia",1041,1030,11,1.05667627281
2306,1500000US131079706004,131079706004,"Block Group 4, Census Tract 9706, Emanuel County, Georgia",1411,1020,391,27.7108433735
2307,1500000US131099701001,131099701001,"Block Group 1, Census Tract 9701, Evans County, Georgia",1501,1111,390,25.9826782145
2308,1500000US131099701002,131099701002,"Block Group 2, Census Tract 9701, Evans County, Georgia",1479,1245,234,15.8215010142
2309,1500000US131099702001,131099702001,"Block Group 1, Census Tract 9702, Evans County, Georgia",1047,1029,18,1.71919770774
2310,1500000US131099702002,131099702002,"Block Group 2, Census Tract 9702, Evans County, Georgia",1019,1013,6,0.588812561335
2311,1500000US131099702003,131099702003,"Block Group 3, Census Tract 9702, Evans County, Georgia",978,968,10,1.02249488753
2312,1500000US131099702004,131099702004,"Block Group 4, Census Tract 9702, Evans County, Georgia",715,683,32,4.47552447552
2313,1500000US131099703001,131099703001,"Block Group 1, Census Tract 9703, Evans County, Georgia",649,643,6,0.924499229584
2314,1500000US131099703002,131099703002,"Block Group 2, Census Tract 9703, Evans County, Georgia",1507,1096,411,27.2727272727
2315,1500000US131099703003,131099703003,"Block Group 3, Census Tract 9703, Evans County, Georgia",934,755,179,19.164882227
2316,1500000US131099703004,131099703004,"Block Group 4, Census Tract 9703, Evans County, Georgia",985,985,0,0.0
2317,1500000US131110501001,131110501001,"Block Group 1, Census Tract 501, Fannin County, Georgia",2196,2146,50,2.27686703097
2318,1500000US131110501002,131110501002,"Block Group 2, Census Tract 501, Fannin County, Georgia",1386,1369,17,1.22655122655
2319,1500000US131110502001,131110502001,"Block Group 1, Census Tract 502, Fannin County, Georgia",1784,1784,0,0.0
2320,1500000US131110502002,131110502002,"Block Group 2, Census Tract 502, Fannin County, Georgia",614,596,18,2.93159609121
2321,1500000US131110502003,131110502003,"Block Group 3, Census Tract 502, Fannin County, Georgia",810,800,10,1.23456790123
2322,1500000US131110502004,131110502004,"Block Group 4, Census Tract 502, Fannin County, Georgia",1665,1665,0,0.0
2323,1500000US131110502005,131110502005,"Block Group 5, Census Tract 502, Fannin County, Georgia",1255,1255,0,0.0
2324,1500000US131110503001,131110503001,"Block Group 1, Census Tract 503, Fannin County, Georgia",1574,1574,0,0.0
2325,1500000US131110503002,131110503002,"Block Group 2, Census Tract 503, Fannin County, Georgia",1188,1188,0,0.0
2326,1500000US131110504001,131110504001,"Block Group 1, Census Tract 504, Fannin County, Georgia",1005,1005,0,0.0
2327,1500000US131110504002,131110504002,"Block Group 2, Census Tract 504, Fannin County, Georgia",1056,1056,0,0.0
2328,1500000US131110504003,131110504003,"Block Group 3, Census Tract 504, Fannin County, Georgia",1974,1919,55,2.78622087133
2329,1500000US131110504004,131110504004,"Block Group 4, Census Tract 504, Fannin County, Georgia",1359,1249,110,8.09418690213
2330,1500000US131110504005,131110504005,"Block Group 5, Census Tract 504, Fannin County, Georgia",1758,1618,140,7.96359499431
2331,1500000US131110505001,131110505001,"Block Group 1, Census Tract 505, Fannin County, Georgia",444,444,0,0.0
2332,1500000US131110505002,131110505002,"Block Group 2, Census Tract 505, Fannin County, Georgia",1752,1687,65,3.7100456621
2333,1500000US131110505003,131110505003,"Block Group 3, Census Tract 505, Fannin County, Georgia",1374,1374,0,0.0
2334,1500000US131110505004,131110505004,"Block Group 4, Census Tract 505, Fannin County, Georgia",548,548,0,0.0
2335,1500000US131131401011,131131401011,"Block Group 1, Census Tract 1401.01, Fayette County, Georgia",1940,1809,131,6.75257731959
2336,1500000US131131401012,131131401012,"Block Group 2, Census Tract 1401.01, Fayette County, Georgia",1318,1165,153,11.6084977238
2337,1500000US131131401013,131131401013,"Block Group 3, Census Tract 1401.01, Fayette County, Georgia",3535,3203,332,9.39179632249
2338,1500000US131131401021,131131401021,"Block Group 1, Census Tract 1401.02, Fayette County, Georgia",1070,1070,0,0.0
2339,1500000US131131401022,131131401022,"Block Group 2, Census Tract 1401.02, Fayette County, Georgia",2303,2268,35,1.51975683891
2340,1500000US131131401023,131131401023,"Block Group 3, Census Tract 1401.02, Fayette County, Georgia",2252,2111,141,6.26110124334
2341,1500000US131131402031,131131402031,"Block Group 1, Census Tract 1402.03, Fayette County, Georgia",3683,3241,442,12.0010860711
2342,1500000US131131402032,131131402032,"Block Group 2, Census Tract 1402.03, Fayette County, Georgia",2073,1927,146,7.04293294742
2343,1500000US131131402041,131131402041,"Block Group 1, Census Tract 1402.04, Fayette County, Georgia",1127,455,672,59.6273291925
2344,1500000US131131402042,131131402042,"Block Group 2, Census Tract 1402.04, Fayette County, Georgia",2156,2006,150,6.9573283859
2345,1500000US131131402043,131131402043,"Block Group 3, Census Tract 1402.04, Fayette County, Georgia",2267,2068,199,8.77812086458
2346,1500000US131131402061,131131402061,"Block Group 1, Census Tract 1402.06, Fayette County, Georgia",2893,2709,184,6.36017974421
2347,1500000US131131402062,131131402062,"Block Group 2, Census Tract 1402.06, Fayette County, Georgia",1600,1536,64,4.0
2348,1500000US131131402071,131131402071,"Block Group 1, Census Tract 1402.07, Fayette County, Georgia",1760,1608,152,8.63636363636
2349,1500000US131131402072,131131402072,"Block Group 2, Census Tract 1402.07, Fayette County, Georgia",930,859,71,7.63440860215
2350,1500000US131131402073,131131402073,"Block Group 3, Census Tract 1402.07, Fayette County, Georgia",2575,2541,34,1.32038834951
2351,1500000US131131402081,131131402081,"Block Group 1, Census Tract 1402.08, Fayette County, Georgia",4314,3821,493,11.4279091331
2352,1500000US131131402082,131131402082,"Block Group 2, Census Tract 1402.08, Fayette County, Georgia",1195,1130,65,5.43933054393
2353,1500000US131131402083,131131402083,"Block Group 3, Census Tract 1402.08, Fayette County, Georgia",2404,2253,151,6.28119800333
2354,1500000US131131403031,131131403031,"Block Group 1, Census Tract 1403.03, Fayette County, Georgia",1207,1050,157,13.0074565037
2355,1500000US131131403032,131131403032,"Block Group 2, Census Tract 1403.03, Fayette County, Georgia",2041,1967,74,3.62567368937
2356,1500000US131131403033,131131403033,"Block Group 3, Census Tract 1403.03, Fayette County, Georgia",1339,1272,67,5.00373412995
2357,1500000US131131403041,131131403041,"Block Group 1, Census Tract 1403.04, Fayette County, Georgia",2277,2171,106,4.65524813351
2358,1500000US131131403042,131131403042,"Block Group 2, Census Tract 1403.04, Fayette County, Georgia",1208,1141,67,5.54635761589
2359,1500000US131131403043,131131403043,"Block Group 3, Census Tract 1403.04, Fayette County, Georgia",2270,2065,205,9.03083700441
2360,1500000US131131403051,131131403051,"Block Group 1, Census Tract 1403.05, Fayette County, Georgia",5325,4593,732,13.7464788732
2361,1500000US131131403061,131131403061,"Block Group 1, Census Tract 1403.06, Fayette County, Georgia",2753,2507,246,8.935706502
2362,1500000US131131403062,131131403062,"Block Group 2, Census Tract 1403.06, Fayette County, Georgia",3023,2669,354,11.7102216341
2363,1500000US131131403063,131131403063,"Block Group 3, Census Tract 1403.06, Fayette County, Georgia",1863,1667,196,10.5206655931
2364,1500000US131131403071,131131403071,"Block Group 1, Census Tract 1403.07, Fayette County, Georgia",3131,2996,135,4.31172149473
2365,1500000US131131403072,131131403072,"Block Group 2, Census Tract 1403.07, Fayette County, Georgia",1687,1687,0,0.0
2366,1500000US131131404031,131131404031,"Block Group 1, Census Tract 1404.03, Fayette County, Georgia",895,771,124,13.8547486034
2367,1500000US131131404032,131131404032,"Block Group 2, Census Tract 1404.03, Fayette County, Georgia",925,852,73,7.89189189189
2368,1500000US131131404033,131131404033,"Block Group 3, Census Tract 1404.03, Fayette County, Georgia",3548,3350,198,5.58060879369
2369,1500000US131131404041,131131404041,"Block Group 1, Census Tract 1404.04, Fayette County, Georgia",1831,1776,55,3.00382304752
2370,1500000US131131404042,131131404042,"Block Group 2, Census Tract 1404.04, Fayette County, Georgia",3936,3717,219,5.56402439024
2371,1500000US131131404051,131131404051,"Block Group 1, Census Tract 1404.05, Fayette County, Georgia",1394,1394,0,0.0
2372,1500000US131131404052,131131404052,"Block Group 2, Census Tract 1404.05, Fayette County, Georgia",2303,2262,41,1.78028658272
2373,1500000US131131404061,131131404061,"Block Group 1, Census Tract 1404.06, Fayette County, Georgia",2292,2077,215,9.38045375218
2374,1500000US131131404062,131131404062,"Block Group 2, Census Tract 1404.06, Fayette County, Georgia",1462,1403,59,4.03556771546
2375,1500000US131131404071,131131404071,"Block Group 1, Census Tract 1404.07, Fayette County, Georgia",1255,1155,100,7.96812749004
2376,1500000US131131404072,131131404072,"Block Group 2, Census Tract 1404.07, Fayette County, Georgia",3242,3135,107,3.3004318322
2377,1500000US131131404073,131131404073,"Block Group 3, Census Tract 1404.07, Fayette County, Georgia",3475,3380,95,2.73381294964
2378,1500000US131131404081,131131404081,"Block Group 1, Census Tract 1404.08, Fayette County, Georgia",1343,1318,25,1.86150409531
2379,1500000US131131404082,131131404082,"Block Group 2, Census Tract 1404.08, Fayette County, Georgia",1710,1636,74,4.32748538012
2380,1500000US131131405011,131131405011,"Block Group 1, Census Tract 1405.01, Fayette County, Georgia",2950,2896,54,1.83050847458
2381,1500000US131131405012,131131405012,"Block Group 2, Census Tract 1405.01, Fayette County, Georgia",2965,2947,18,0.607082630691
2382,1500000US131131405021,131131405021,"Block Group 1, Census Tract 1405.02, Fayette County, Georgia",2503,2370,133,5.31362365162
2383,1500000US131131405022,131131405022,"Block Group 2, Census Tract 1405.02, Fayette County, Georgia",1107,1088,19,1.71635049684
2384,1500000US131150001001,131150001001,"Block Group 1, Census Tract 1, Floyd County, Georgia",2381,2319,62,2.60394792104
2385,1500000US131150001002,131150001002,"Block Group 2, Census Tract 1, Floyd County, Georgia",857,778,79,9.21820303384
2386,1500000US131150001003,131150001003,"Block Group 3, Census Tract 1, Floyd County, Georgia",1306,1306,0,0.0
2387,1500000US131150002011,131150002011,"Block Group 1, Census Tract 2.01, Floyd County, Georgia",1503,1028,475,31.6034597472
2388,1500000US131150002012,131150002012,"Block Group 2, Census Tract 2.01, Floyd County, Georgia",2549,2056,493,19.3409180071
2389,1500000US131150002013,131150002013,"Block Group 3, Census Tract 2.01, Floyd County, Georgia",2422,2322,100,4.12881915772
2390,1500000US131150002021,131150002021,"Block Group 1, Census Tract 2.02, Floyd County, Georgia",2012,2012,0,0.0
2391,1500000US131150002022,131150002022,"Block Group 2, Census Tract 2.02, Floyd County, Georgia",1888,1888,0,0.0
2392,1500000US131150003001,131150003001,"Block Group 1, Census Tract 3, Floyd County, Georgia",937,876,61,6.51013874066
2393,1500000US131150003002,131150003002,"Block Group 2, Census Tract 3, Floyd County, Georgia",2051,1857,194,9.45880058508
2394,1500000US131150004001,131150004001,"Block Group 1, Census Tract 4, Floyd County, Georgia",1604,1488,116,7.2319201995
2395,1500000US131150004002,131150004002,"Block Group 2, Census Tract 4, Floyd County, Georgia",2423,1658,765,31.5724308708
2396,1500000US131150004003,131150004003,"Block Group 3, Census Tract 4, Floyd County, Georgia",1312,1312,0,0.0
2397,1500000US131150004004,131150004004,"Block Group 4, Census Tract 4, Floyd County, Georgia",2178,1708,470,21.5794306703
2398,1500000US131150005001,131150005001,"Block Group 1, Census Tract 5, Floyd County, Georgia",758,758,0,0.0
2399,1500000US131150005002,131150005002,"Block Group 2, Census Tract 5, Floyd County, Georgia",2007,1351,656,32.6856003986
2400,1500000US131150005003,131150005003,"Block Group 3, Census Tract 5, Floyd County, Georgia",1403,582,821,58.5174625802
2401,1500000US131150006001,131150006001,"Block Group 1, Census Tract 6, Floyd County, Georgia",1347,1237,110,8.16629547142
2402,1500000US131150006002,131150006002,"Block Group 2, Census Tract 6, Floyd County, Georgia",2306,2274,32,1.38768430182
2403,1500000US131150006003,131150006003,"Block Group 3, Census Tract 6, Floyd County, Georgia",1473,1396,77,5.22742701969
2404,1500000US131150007001,131150007001,"Block Group 1, Census Tract 7, Floyd County, Georgia",2111,2078,33,1.56324017054
2405,1500000US131150007002,131150007002,"Block Group 2, Census Tract 7, Floyd County, Georgia",2626,2615,11,0.41888804265
2406,1500000US131150008001,131150008001,"Block Group 1, Census Tract 8, Floyd County, Georgia",2358,2358,0,0.0
2407,1500000US131150008002,131150008002,"Block Group 2, Census Tract 8, Floyd County, Georgia",2482,2473,9,0.362610797744
2408,1500000US131150009001,131150009001,"Block Group 1, Census Tract 9, Floyd County, Georgia",2505,2494,11,0.439121756487
2409,1500000US131150011001,131150011001,"Block Group 1, Census Tract 11, Floyd County, Georgia",1441,862,579,40.1804302568
2410,1500000US131150011002,131150011002,"Block Group 2, Census Tract 11, Floyd County, Georgia",779,779,0,0.0
2411,1500000US131150011003,131150011003,"Block Group 3, Census Tract 11, Floyd County, Georgia",521,514,7,1.34357005758
2412,1500000US131150012001,131150012001,"Block Group 1, Census Tract 12, Floyd County, Georgia",893,448,445,49.8320268757
2413,1500000US131150012002,131150012002,"Block Group 2, Census Tract 12, Floyd County, Georgia",1909,1457,452,23.6773179675
2414,1500000US131150012003,131150012003,"Block Group 3, Census Tract 12, Floyd County, Georgia",1583,990,593,37.4605180038
2415,1500000US131150013001,131150013001,"Block Group 1, Census Tract 13, Floyd County, Georgia",2198,1488,710,32.3020928116
2416,1500000US131150013002,131150013002,"Block Group 2, Census Tract 13, Floyd County, Georgia",1897,1673,224,11.8081180812
2417,1500000US131150013003,131150013003,"Block Group 3, Census Tract 13, Floyd County, Georgia",1970,1599,371,18.8324873096
2418,1500000US131150014001,131150014001,"Block Group 1, Census Tract 14, Floyd County, Georgia",1927,1749,178,9.23715620135
2419,1500000US131150014002,131150014002,"Block Group 2, Census Tract 14, Floyd County, Georgia",2858,2858,0,0.0
2420,1500000US131150014003,131150014003,"Block Group 3, Census Tract 14, Floyd County, Georgia",1871,1759,112,5.98610368787
2421,1500000US131150016001,131150016001,"Block Group 1, Census Tract 16, Floyd County, Georgia",1217,1159,58,4.76581758422
2422,1500000US131150016002,131150016002,"Block Group 2, Census Tract 16, Floyd County, Georgia",936,611,325,34.7222222222
2423,1500000US131150016003,131150016003,"Block Group 3, Census Tract 16, Floyd County, Georgia",1314,1276,38,2.89193302892
2424,1500000US131150017011,131150017011,"Block Group 1, Census Tract 17.01, Floyd County, Georgia",2586,2586,0,0.0
2425,1500000US131150017012,131150017012,"Block Group 2, Census Tract 17.01, Floyd County, Georgia",2457,2352,105,4.2735042735
2426,1500000US131150017013,131150017013,"Block Group 3, Census Tract 17.01, Floyd County, Georgia",1341,1335,6,0.447427293065
2427,1500000US131150017021,131150017021,"Block Group 1, Census Tract 17.02, Floyd County, Georgia",1663,1663,0,0.0
2428,1500000US131150017022,131150017022,"Block Group 2, Census Tract 17.02, Floyd County, Georgia",2440,2385,55,2.25409836066
2429,1500000US131150017023,131150017023,"Block Group 3, Census Tract 17.02, Floyd County, Georgia",1361,1310,51,3.74724467303
2430,1500000US131150017024,131150017024,"Block Group 4, Census Tract 17.02, Floyd County, Georgia",1023,1023,0,0.0
2431,1500000US131150018001,131150018001,"Block Group 1, Census Tract 18, Floyd County, Georgia",1708,1660,48,2.81030444965
2432,1500000US131150018002,131150018002,"Block Group 2, Census Tract 18, Floyd County, Georgia",685,639,46,6.71532846715
2433,1500000US131150018003,131150018003,"Block Group 3, Census Tract 18, Floyd County, Georgia",2115,1976,139,6.57210401891
2434,1500000US131150020001,131150020001,"Block Group 1, Census Tract 20, Floyd County, Georgia",1764,1759,5,0.283446712018
2435,1500000US131150020002,131150020002,"Block Group 2, Census Tract 20, Floyd County, Georgia",1357,1357,0,0.0
2436,1500000US131150020003,131150020003,"Block Group 3, Census Tract 20, Floyd County, Georgia",1003,1003,0,0.0
2437,1500000US131150021001,131150021001,"Block Group 1, Census Tract 21, Floyd County, Georgia",1633,1633,0,0.0
2438,1500000US131150021002,131150021002,"Block Group 2, Census Tract 21, Floyd County, Georgia",1665,1398,267,16.036036036
2439,1500000US131150021003,131150021003,"Block Group 3, Census Tract 21, Floyd County, Georgia",1255,913,342,27.2509960159
2440,1500000US131171301011,131171301011,"Block Group 1, Census Tract 1301.01, Forsyth County, Georgia",2704,2594,110,4.06804733728
2441,1500000US131171301012,131171301012,"Block Group 2, Census Tract 1301.01, Forsyth County, Georgia",1393,1221,172,12.3474515434
2442,1500000US131171301021,131171301021,"Block Group 1, Census Tract 1301.02, Forsyth County, Georgia",2728,2719,9,0.32991202346
2443,1500000US131171301031,131171301031,"Block Group 1, Census Tract 1301.03, Forsyth County, Georgia",1439,1229,210,14.5934676859
2444,1500000US131171301032,131171301032,"Block Group 2, Census Tract 1301.03, Forsyth County, Georgia",1218,1218,0,0.0
2445,1500000US131171301033,131171301033,"Block Group 3, Census Tract 1301.03, Forsyth County, Georgia",918,918,0,0.0
2446,1500000US131171301041,131171301041,"Block Group 1, Census Tract 1301.04, Forsyth County, Georgia",1543,1511,32,2.07388204796
2447,1500000US131171301042,131171301042,"Block Group 2, Census Tract 1301.04, Forsyth County, Georgia",1512,1512,0,0.0
2448,1500000US131171301043,131171301043,"Block Group 3, Census Tract 1301.04, Forsyth County, Georgia",915,880,35,3.82513661202
2449,1500000US131171301051,131171301051,"Block Group 1, Census Tract 1301.05, Forsyth County, Georgia",2571,2096,475,18.4753014391
2450,1500000US131171302011,131171302011,"Block Group 1, Census Tract 1302.01, Forsyth County, Georgia",1602,1596,6,0.374531835206
2451,1500000US131171302012,131171302012,"Block Group 2, Census Tract 1302.01, Forsyth County, Georgia",1642,1590,52,3.16686967113
2452,1500000US131171302013,131171302013,"Block Group 3, Census Tract 1302.01, Forsyth County, Georgia",1565,1449,116,7.41214057508
2453,1500000US131171302021,131171302021,"Block Group 1, Census Tract 1302.02, Forsyth County, Georgia",1380,1322,58,4.20289855072
2454,1500000US131171302022,131171302022,"Block Group 2, Census Tract 1302.02, Forsyth County, Georgia",673,673,0,0.0
2455,1500000US131171302023,131171302023,"Block Group 3, Census Tract 1302.02, Forsyth County, Georgia",1794,1755,39,2.17391304348
2456,1500000US131171302031,131171302031,"Block Group 1, Census Tract 1302.03, Forsyth County, Georgia",2835,2397,438,15.4497354497
2457,1500000US131171302032,131171302032,"Block Group 2, Census Tract 1302.03, Forsyth County, Georgia",2657,2478,179,6.73692133986
2458,1500000US131171302041,131171302041,"Block Group 1, Census Tract 1302.04, Forsyth County, Georgia",2293,2154,139,6.06192760576
2459,1500000US131171302042,131171302042,"Block Group 2, Census Tract 1302.04, Forsyth County, Georgia",1988,1637,351,17.6559356137
2460,1500000US131171302051,131171302051,"Block Group 1, Census Tract 1302.05, Forsyth County, Georgia",1467,1065,402,27.4028629857
2461,1500000US131171302052,131171302052,"Block Group 2, Census Tract 1302.05, Forsyth County, Georgia",509,495,14,2.75049115914
2462,1500000US131171302053,131171302053,"Block Group 3, Census Tract 1302.05, Forsyth County, Georgia",556,395,161,28.9568345324
2463,1500000US131171303011,131171303011,"Block Group 1, Census Tract 1303.01, Forsyth County, Georgia",1993,1899,94,4.71650777722
2464,1500000US131171303012,131171303012,"Block Group 2, Census Tract 1303.01, Forsyth County, Georgia",3721,3237,484,13.0072561139
2465,1500000US131171303021,131171303021,"Block Group 1, Census Tract 1303.02, Forsyth County, Georgia",1101,1047,54,4.90463215259
2466,1500000US131171303022,131171303022,"Block Group 2, Census Tract 1303.02, Forsyth County, Georgia",2179,2088,91,4.17622762735
2467,1500000US131171303023,131171303023,"Block Group 3, Census Tract 1303.02, Forsyth County, Georgia",2270,2197,73,3.21585903084
2468,1500000US131171303031,131171303031,"Block Group 1, Census Tract 1303.03, Forsyth County, Georgia",2773,2092,681,24.5582401731
2469,1500000US131171303032,131171303032,"Block Group 2, Census Tract 1303.03, Forsyth County, Georgia",1413,1413,0,0.0
2470,1500000US131171303041,131171303041,"Block Group 1, Census Tract 1303.04, Forsyth County, Georgia",1864,1852,12,0.643776824034
2471,1500000US131171303042,131171303042,"Block Group 2, Census Tract 1303.04, Forsyth County, Georgia",2657,1990,667,25.1035001882
2472,1500000US131171303051,131171303051,"Block Group 1, Census Tract 1303.05, Forsyth County, Georgia",905,830,75,8.28729281768
2473,1500000US131171303052,131171303052,"Block Group 2, Census Tract 1303.05, Forsyth County, Georgia",3095,2768,327,10.5654281099
2474,1500000US131171303053,131171303053,"Block Group 3, Census Tract 1303.05, Forsyth County, Georgia",1679,1632,47,2.79928528886
2475,1500000US131171303061,131171303061,"Block Group 1, Census Tract 1303.06, Forsyth County, Georgia",2798,2751,47,1.67977126519
2476,1500000US131171303062,131171303062,"Block Group 2, Census Tract 1303.06, Forsyth County, Georgia",1812,1721,91,5.02207505519
2477,1500000US131171303071,131171303071,"Block Group 1, Census Tract 1303.07, Forsyth County, Georgia",2509,2179,330,13.1526504583
2478,1500000US131171303072,131171303072,"Block Group 2, Census Tract 1303.07, Forsyth County, Georgia",1762,1762,0,0.0
2479,1500000US131171304031,131171304031,"Block Group 1, Census Tract 1304.03, Forsyth County, Georgia",783,567,216,27.5862068966
2480,1500000US131171304032,131171304032,"Block Group 2, Census Tract 1304.03, Forsyth County, Georgia",1488,1244,244,16.3978494624
2481,1500000US131171304033,131171304033,"Block Group 3, Census Tract 1304.03, Forsyth County, Georgia",1136,1114,22,1.93661971831
2482,1500000US131171304034,131171304034,"Block Group 4, Census Tract 1304.03, Forsyth County, Georgia",2302,1694,608,26.4118158123
2483,1500000US131171304041,131171304041,"Block Group 1, Census Tract 1304.04, Forsyth County, Georgia",2074,1931,143,6.89488910318
2484,1500000US131171304042,131171304042,"Block Group 2, Census Tract 1304.04, Forsyth County, Georgia",2565,2423,142,5.53606237817
2485,1500000US131171304051,131171304051,"Block Group 1, Census Tract 1304.05, Forsyth County, Georgia",2153,2022,131,6.08453320948
2486,1500000US131171304052,131171304052,"Block Group 2, Census Tract 1304.05, Forsyth County, Georgia",1854,1786,68,3.66774541532
2487,1500000US131171304061,131171304061,"Block Group 1, Census Tract 1304.06, Forsyth County, Georgia",2165,1518,647,29.8845265589
2488,1500000US131171304062,131171304062,"Block Group 2, Census Tract 1304.06, Forsyth County, Georgia",2105,2056,49,2.32779097387
2489,1500000US131171304063,131171304063,"Block Group 3, Census Tract 1304.06, Forsyth County, Georgia",1242,1151,91,7.3268921095
2490,1500000US131171304081,131171304081,"Block Group 1, Census Tract 1304.08, Forsyth County, Georgia",2500,1775,725,29.0
2491,1500000US131171304082,131171304082,"Block Group 2, Census Tract 1304.08, Forsyth County, Georgia",1303,892,411,31.5425940138
2492,1500000US131171304091,131171304091,"Block Group 1, Census Tract 1304.09, Forsyth County, Georgia",654,534,120,18.3486238532
2493,1500000US131171304092,131171304092,"Block Group 2, Census Tract 1304.09, Forsyth County, Georgia",1810,1392,418,23.0939226519
2494,1500000US131171304101,131171304101,"Block Group 1, Census Tract 1304.10, Forsyth County, Georgia",741,585,156,21.0526315789
2495,1500000US131171304102,131171304102,"Block Group 2, Census Tract 1304.10, Forsyth County, Georgia",1830,1094,736,40.218579235
2496,1500000US131171304103,131171304103,"Block Group 3, Census Tract 1304.10, Forsyth County, Georgia",1664,1565,99,5.94951923077
2497,1500000US131171305031,131171305031,"Block Group 1, Census Tract 1305.03, Forsyth County, Georgia",1604,1604,0,0.0
2498,1500000US131171305032,131171305032,"Block Group 2, Census Tract 1305.03, Forsyth County, Georgia",1113,1100,13,1.16801437556
2499,1500000US131171305041,131171305041,"Block Group 1, Census Tract 1305.04, Forsyth County, Georgia",1985,1746,239,12.040302267
2500,1500000US131171305042,131171305042,"Block Group 2, Census Tract 1305.04, Forsyth County, Georgia",1755,1739,16,0.911680911681
2501,1500000US131171305051,131171305051,"Block Group 1, Census Tract 1305.05, Forsyth County, Georgia",1169,1097,72,6.15911035073
2502,1500000US131171305052,131171305052,"Block Group 2, Census Tract 1305.05, Forsyth County, Georgia",1469,1450,19,1.29339686862
2503,1500000US131171305061,131171305061,"Block Group 1, Census Tract 1305.06, Forsyth County, Georgia",1092,1014,78,7.14285714286
2504,1500000US131171305062,131171305062,"Block Group 2, Census Tract 1305.06, Forsyth County, Georgia",2380,2249,131,5.50420168067
2505,1500000US131171305071,131171305071,"Block Group 1, Census Tract 1305.07, Forsyth County, Georgia",873,820,53,6.07101947308
2506,1500000US131171305072,131171305072,"Block Group 2, Census Tract 1305.07, Forsyth County, Georgia",1442,1406,36,2.49653259362
2507,1500000US131171305081,131171305081,"Block Group 1, Census Tract 1305.08, Forsyth County, Georgia",2543,2365,178,6.99960676366
2508,1500000US131171305082,131171305082,"Block Group 2, Census Tract 1305.08, Forsyth County, Georgia",2687,2520,167,6.21510978787
2509,1500000US131171305091,131171305091,"Block Group 1, Census Tract 1305.09, Forsyth County, Georgia",1944,1575,369,18.9814814815
2510,1500000US131171305092,131171305092,"Block Group 2, Census Tract 1305.09, Forsyth County, Georgia",1442,1117,325,22.5381414702
2511,1500000US131171305101,131171305101,"Block Group 1, Census Tract 1305.10, Forsyth County, Georgia",2029,1797,232,11.4342040414
2512,1500000US131171305102,131171305102,"Block Group 2, Census Tract 1305.10, Forsyth County, Georgia",2332,2332,0,0.0
2513,1500000US131171305103,131171305103,"Block Group 3, Census Tract 1305.10, Forsyth County, Georgia",2131,1744,387,18.1604880338
2514,1500000US131171306011,131171306011,"Block Group 1, Census Tract 1306.01, Forsyth County, Georgia",2605,2078,527,20.2303262956
2515,1500000US131171306012,131171306012,"Block Group 2, Census Tract 1306.01, Forsyth County, Georgia",762,684,78,10.2362204724
2516,1500000US131171306013,131171306013,"Block Group 3, Census Tract 1306.01, Forsyth County, Georgia",1379,1308,71,5.14865844815
2517,1500000US131171306021,131171306021,"Block Group 1, Census Tract 1306.02, Forsyth County, Georgia",2721,1484,1237,45.4612274899
2518,1500000US131171306022,131171306022,"Block Group 2, Census Tract 1306.02, Forsyth County, Georgia",2761,2246,515,18.652662079
2519,1500000US131171306031,131171306031,"Block Group 1, Census Tract 1306.03, Forsyth County, Georgia",2890,2557,333,11.5224913495
2520,1500000US131171306032,131171306032,"Block Group 2, Census Tract 1306.03, Forsyth County, Georgia",1312,1028,284,21.6463414634
2521,1500000US131171306033,131171306033,"Block Group 3, Census Tract 1306.03, Forsyth County, Georgia",842,821,21,2.49406175772
2522,1500000US131171306041,131171306041,"Block Group 1, Census Tract 1306.04, Forsyth County, Georgia",2572,2446,126,4.89891135303
2523,1500000US131171306042,131171306042,"Block Group 2, Census Tract 1306.04, Forsyth County, Georgia",981,973,8,0.815494393476
2524,1500000US131171306043,131171306043,"Block Group 3, Census Tract 1306.04, Forsyth County, Georgia",1584,1352,232,14.6464646465
2525,1500000US131171306051,131171306051,"Block Group 1, Census Tract 1306.05, Forsyth County, Georgia",1326,1238,88,6.63650075415
2526,1500000US131171306052,131171306052,"Block Group 2, Census Tract 1306.05, Forsyth County, Georgia",2601,2491,110,4.22914263745
2527,1500000US131171306061,131171306061,"Block Group 1, Census Tract 1306.06, Forsyth County, Georgia",1790,1686,104,5.81005586592
2528,1500000US131171306062,131171306062,"Block Group 2, Census Tract 1306.06, Forsyth County, Georgia",2701,2552,149,5.51647537949
2529,1500000US131171306071,131171306071,"Block Group 1, Census Tract 1306.07, Forsyth County, Georgia",2210,2162,48,2.17194570136
2530,1500000US131171306072,131171306072,"Block Group 2, Census Tract 1306.07, Forsyth County, Georgia",662,620,42,6.34441087613
2531,1500000US131171306073,131171306073,"Block Group 3, Census Tract 1306.07, Forsyth County, Georgia",2694,2694,0,0.0
2532,1500000US131171306081,131171306081,"Block Group 1, Census Tract 1306.08, Forsyth County, Georgia",2885,2785,100,3.46620450607
2533,1500000US131171306082,131171306082,"Block Group 2, Census Tract 1306.08, Forsyth County, Georgia",1881,1863,18,0.956937799043
2534,1500000US131171306083,131171306083,"Block Group 3, Census Tract 1306.08, Forsyth County, Georgia",813,772,41,5.0430504305
2535,1500000US131171306091,131171306091,"Block Group 1, Census Tract 1306.09, Forsyth County, Georgia",2954,2841,113,3.82532159783
2536,1500000US131171306092,131171306092,"Block Group 2, Census Tract 1306.09, Forsyth County, Georgia",1170,1102,68,5.81196581197
2537,1500000US131171306093,131171306093,"Block Group 3, Census Tract 1306.09, Forsyth County, Georgia",1274,1022,252,19.7802197802
2538,1500000US131171306101,131171306101,"Block Group 1, Census Tract 1306.10, Forsyth County, Georgia",1417,1384,33,2.32886379675
2539,1500000US131171306102,131171306102,"Block Group 2, Census Tract 1306.10, Forsyth County, Georgia",1801,1497,304,16.8795113826
2540,1500000US131171306103,131171306103,"Block Group 3, Census Tract 1306.10, Forsyth County, Georgia",1167,1131,36,3.08483290488
2541,1500000US131171306111,131171306111,"Block Group 1, Census Tract 1306.11, Forsyth County, Georgia",1334,1321,13,0.974512743628
2542,1500000US131171306112,131171306112,"Block Group 2, Census Tract 1306.11, Forsyth County, Georgia",2667,2531,136,5.09936257968
2543,1500000US131171306121,131171306121,"Block Group 1, Census Tract 1306.12, Forsyth County, Georgia",2065,1998,67,3.24455205811
2544,1500000US131171306122,131171306122,"Block Group 2, Census Tract 1306.12, Forsyth County, Georgia",845,845,0,0.0
2545,1500000US131171306123,131171306123,"Block Group 3, Census Tract 1306.12, Forsyth County, Georgia",3666,3565,101,2.75504637207
2546,1500000US131171306131,131171306131,"Block Group 1, Census Tract 1306.13, Forsyth County, Georgia",1442,1346,96,6.65742024965
2547,1500000US131171306132,131171306132,"Block Group 2, Census Tract 1306.13, Forsyth County, Georgia",1670,1640,30,1.79640718563
2548,1500000US131198901011,131198901011,"Block Group 1, Census Tract 8901.01, Franklin County, Georgia",899,829,70,7.78642936596
2549,1500000US131198901012,131198901012,"Block Group 2, Census Tract 8901.01, Franklin County, Georgia",1141,1122,19,1.66520595968
2550,1500000US131198901013,131198901013,"Block Group 3, Census Tract 8901.01, Franklin County, Georgia",1807,1448,359,19.8671831765
2551,1500000US131198901021,131198901021,"Block Group 1, Census Tract 8901.02, Franklin County, Georgia",1152,1042,110,9.54861111111
2552,1500000US131198901022,131198901022,"Block Group 2, Census Tract 8901.02, Franklin County, Georgia",1172,1172,0,0.0
2553,1500000US131198901023,131198901023,"Block Group 3, Census Tract 8901.02, Franklin County, Georgia",1795,1755,40,2.22841225627
2554,1500000US131198902001,131198902001,"Block Group 1, Census Tract 8902, Franklin County, Georgia",1758,1566,192,10.9215017065
2555,1500000US131198902002,131198902002,"Block Group 2, Census Tract 8902, Franklin County, Georgia",1567,1567,0,0.0
2556,1500000US131198902003,131198902003,"Block Group 3, Census Tract 8902, Franklin County, Georgia",1336,1322,14,1.04790419162
2557,1500000US131198902004,131198902004,"Block Group 4, Census Tract 8902, Franklin County, Georgia",1060,1060,0,0.0
2558,1500000US131198903001,131198903001,"Block Group 1, Census Tract 8903, Franklin County, Georgia",1706,1696,10,0.586166471278
2559,1500000US131198903002,131198903002,"Block Group 2, Census Tract 8903, Franklin County, Georgia",1473,1473,0,0.0
2560,1500000US131198904001,131198904001,"Block Group 1, Census Tract 8904, Franklin County, Georgia",1035,1025,10,0.966183574879
2561,1500000US131198904002,131198904002,"Block Group 2, Census Tract 8904, Franklin County, Georgia",1003,1003,0,0.0
2562,1500000US131198904003,131198904003,"Block Group 3, Census Tract 8904, Franklin County, Georgia",595,592,3,0.504201680672
2563,1500000US131198904004,131198904004,"Block Group 4, Census Tract 8904, Franklin County, Georgia",2611,2504,107,4.09804672539
2564,1500000US131210001001,131210001001,"Block Group 1, Census Tract 1, Fulton County, Georgia",1068,1066,2,0.187265917603
2565,1500000US131210001002,131210001002,"Block Group 2, Census Tract 1, Fulton County, Georgia",637,615,22,3.45368916797
2566,1500000US131210001003,131210001003,"Block Group 3, Census Tract 1, Fulton County, Georgia",1795,1676,119,6.6295264624
2567,1500000US131210001004,131210001004,"Block Group 4, Census Tract 1, Fulton County, Georgia",1150,1106,44,3.82608695652
2568,1500000US131210002001,131210002001,"Block Group 1, Census Tract 2, Fulton County, Georgia",1475,1466,9,0.610169491525
2569,1500000US131210002002,131210002002,"Block Group 2, Census Tract 2, Fulton County, Georgia",1473,1401,72,4.88798370672
2570,1500000US131210002003,131210002003,"Block Group 3, Census Tract 2, Fulton County, Georgia",1129,1101,28,2.48007085917
2571,1500000US131210002004,131210002004,"Block Group 4, Census Tract 2, Fulton County, Georgia",934,858,76,8.13704496788
2572,1500000US131210002005,131210002005,"Block Group 5, Census Tract 2, Fulton County, Georgia",1267,1199,68,5.36700868193
2573,1500000US131210004001,131210004001,"Block Group 1, Census Tract 4, Fulton County, Georgia",592,551,41,6.92567567568
2574,1500000US131210004002,131210004002,"Block Group 2, Census Tract 4, Fulton County, Georgia",1000,1000,0,0.0
2575,1500000US131210005001,131210005001,"Block Group 1, Census Tract 5, Fulton County, Georgia",3480,3322,158,4.54022988506
2576,1500000US131210005002,131210005002,"Block Group 2, Census Tract 5, Fulton County, Georgia",1060,1060,0,0.0
2577,1500000US131210005003,131210005003,"Block Group 3, Census Tract 5, Fulton County, Georgia",931,911,20,2.14822771214
2578,1500000US131210006001,131210006001,"Block Group 1, Census Tract 6, Fulton County, Georgia",5906,5447,459,7.77175753471
2579,1500000US131210007001,131210007001,"Block Group 1, Census Tract 7, Fulton County, Georgia",2086,1996,90,4.31447746884
2580,1500000US131210007002,131210007002,"Block Group 2, Census Tract 7, Fulton County, Georgia",848,803,45,5.30660377358
2581,1500000US131210010011,131210010011,"Block Group 1, Census Tract 10.01, Fulton County, Georgia",1716,1631,85,4.95337995338
2582,1500000US131210010012,131210010012,"Block Group 2, Census Tract 10.01, Fulton County, Georgia",961,905,56,5.82726326743
2583,1500000US131210010021,131210010021,"Block Group 1, Census Tract 10.02, Fulton County, Georgia",7230,6778,452,6.25172890733
2584,1500000US131210011001,131210011001,"Block Group 1, Census Tract 11, Fulton County, Georgia",1021,1001,20,1.95886385896
2585,1500000US131210011002,131210011002,"Block Group 2, Census Tract 11, Fulton County, Georgia",918,890,28,3.05010893246
2586,1500000US131210011003,131210011003,"Block Group 3, Census Tract 11, Fulton County, Georgia",2306,2214,92,3.98959236774
2587,1500000US131210012011,131210012011,"Block Group 1, Census Tract 12.01, Fulton County, Georgia",1780,1714,66,3.70786516854
2588,1500000US131210012012,131210012012,"Block Group 2, Census Tract 12.01, Fulton County, Georgia",2123,1898,225,10.5982100801
2589,1500000US131210012021,131210012021,"Block Group 1, Census Tract 12.02, Fulton County, Georgia",2456,2318,138,5.61889250814
2590,1500000US131210012022,131210012022,"Block Group 2, Census Tract 12.02, Fulton County, Georgia",1442,1410,32,2.21914008322
2591,1500000US131210013001,131210013001,"Block Group 1, Census Tract 13, Fulton County, Georgia",2299,2119,180,7.82949108308
2592,1500000US131210013002,131210013002,"Block Group 2, Census Tract 13, Fulton County, Georgia",1062,983,79,7.43879472693
2593,1500000US131210013003,131210013003,"Block Group 3, Census Tract 13, Fulton County, Georgia",1168,1065,103,8.81849315068
2594,1500000US131210014001,131210014001,"Block Group 1, Census Tract 14, Fulton County, Georgia",1411,1367,44,3.11835577605
2595,1500000US131210014002,131210014002,"Block Group 2, Census Tract 14, Fulton County, Georgia",826,800,26,3.14769975787
2596,1500000US131210015001,131210015001,"Block Group 1, Census Tract 15, Fulton County, Georgia",1384,1360,24,1.73410404624
2597,1500000US131210015002,131210015002,"Block Group 2, Census Tract 15, Fulton County, Georgia",1308,1088,220,16.8195718654
2598,1500000US131210015003,131210015003,"Block Group 3, Census Tract 15, Fulton County, Georgia",774,714,60,7.7519379845
2599,1500000US131210015004,131210015004,"Block Group 4, Census Tract 15, Fulton County, Georgia",900,878,22,2.44444444444
2600,1500000US131210016001,131210016001,"Block Group 1, Census Tract 16, Fulton County, Georgia",2090,2029,61,2.91866028708
2601,1500000US131210017001,131210017001,"Block Group 1, Census Tract 17, Fulton County, Georgia",2620,2492,128,4.88549618321
2602,1500000US131210017002,131210017002,"Block Group 2, Census Tract 17, Fulton County, Georgia",1111,1050,61,5.49054905491
2603,1500000US131210018001,131210018001,"Block Group 1, Census Tract 18, Fulton County, Georgia",2684,2604,80,2.98062593145
2604,1500000US131210018002,131210018002,"Block Group 2, Census Tract 18, Fulton County, Georgia",763,752,11,1.44167758847
2605,1500000US131210018003,131210018003,"Block Group 3, Census Tract 18, Fulton County, Georgia",1082,1058,24,2.21811460259
2606,1500000US131210019001,131210019001,"Block Group 1, Census Tract 19, Fulton County, Georgia",2837,2645,192,6.76771237222
2607,1500000US131210019002,131210019002,"Block Group 2, Census Tract 19, Fulton County, Georgia",2140,2063,77,3.59813084112
2608,1500000US131210021001,131210021001,"Block Group 1, Census Tract 21, Fulton County, Georgia",2785,2762,23,0.825852782765
2609,1500000US131210023001,131210023001,"Block Group 1, Census Tract 23, Fulton County, Georgia",335,335,0,0.0
2610,1500000US131210023002,131210023002,"Block Group 2, Census Tract 23, Fulton County, Georgia",462,462,0,0.0
2611,1500000US131210023003,131210023003,"Block Group 3, Census Tract 23, Fulton County, Georgia",447,447,0,0.0
2612,1500000US131210024001,131210024001,"Block Group 1, Census Tract 24, Fulton County, Georgia",1432,1427,5,0.349162011173
2613,1500000US131210024002,131210024002,"Block Group 2, Census Tract 24, Fulton County, Georgia",1072,1072,0,0.0
2614,1500000US131210025001,131210025001,"Block Group 1, Census Tract 25, Fulton County, Georgia",1596,1569,27,1.69172932331
2615,1500000US131210025002,131210025002,"Block Group 2, Census Tract 25, Fulton County, Georgia",609,592,17,2.79146141215
2616,1500000US131210026001,131210026001,"Block Group 1, Census Tract 26, Fulton County, Georgia",1229,1121,108,8.78763222132
2617,1500000US131210028001,131210028001,"Block Group 1, Census Tract 28, Fulton County, Georgia",4148,3777,371,8.94406943105
2618,1500000US131210028002,131210028002,"Block Group 2, Census Tract 28, Fulton County, Georgia",506,484,22,4.34782608696
2619,1500000US131210029001,131210029001,"Block Group 1, Census Tract 29, Fulton County, Georgia",2578,2481,97,3.76260667184
2620,1500000US131210030001,131210030001,"Block Group 1, Census Tract 30, Fulton County, Georgia",1472,1429,43,2.92119565217
2621,1500000US131210030002,131210030002,"Block Group 2, Census Tract 30, Fulton County, Georgia",1605,1425,180,11.214953271
2622,1500000US131210031001,131210031001,"Block Group 1, Census Tract 31, Fulton County, Georgia",971,948,23,2.36869207003
2623,1500000US131210031002,131210031002,"Block Group 2, Census Tract 31, Fulton County, Georgia",916,906,10,1.09170305677
2624,1500000US131210032001,131210032001,"Block Group 1, Census Tract 32, Fulton County, Georgia",2150,1989,161,7.48837209302
2625,1500000US131210035001,131210035001,"Block Group 1, Census Tract 35, Fulton County, Georgia",671,654,17,2.53353204173
2626,1500000US131210035002,131210035002,"Block Group 2, Census Tract 35, Fulton County, Georgia",1436,1352,84,5.8495821727
2627,1500000US131210036001,131210036001,"Block Group 1, Census Tract 36, Fulton County, Georgia",1453,1408,45,3.09704060564
2628,1500000US131210037001,131210037001,"Block Group 1, Census Tract 37, Fulton County, Georgia",54,54,0,0.0
2629,1500000US131210038001,131210038001,"Block Group 1, Census Tract 38, Fulton County, Georgia",3872,3630,242,6.25
2630,1500000US131210039001,131210039001,"Block Group 1, Census Tract 39, Fulton County, Georgia",1172,1172,0,0.0
2631,1500000US131210039002,131210039002,"Block Group 2, Census Tract 39, Fulton County, Georgia",768,768,0,0.0
2632,1500000US131210040001,131210040001,"Block Group 1, Census Tract 40, Fulton County, Georgia",1148,1148,0,0.0
2633,1500000US131210040002,131210040002,"Block Group 2, Census Tract 40, Fulton County, Georgia",635,635,0,0.0
2634,1500000US131210040003,131210040003,"Block Group 3, Census Tract 40, Fulton County, Georgia",625,625,0,0.0
2635,1500000US131210041001,131210041001,"Block Group 1, Census Tract 41, Fulton County, Georgia",503,503,0,0.0
2636,1500000US131210041002,131210041002,"Block Group 2, Census Tract 41, Fulton County, Georgia",904,904,0,0.0
2637,1500000US131210041003,131210041003,"Block Group 3, Census Tract 41, Fulton County, Georgia",499,477,22,4.40881763527
2638,1500000US131210042001,131210042001,"Block Group 1, Census Tract 42, Fulton County, Georgia",414,414,0,0.0
2639,1500000US131210042002,131210042002,"Block Group 2, Census Tract 42, Fulton County, Georgia",1813,1795,18,0.992829564258
2640,1500000US131210043001,131210043001,"Block Group 1, Census Tract 43, Fulton County, Georgia",1593,1480,113,7.09353421218
2641,1500000US131210043002,131210043002,"Block Group 2, Census Tract 43, Fulton County, Georgia",1181,1128,53,4.48772226926
2642,1500000US131210044001,131210044001,"Block Group 1, Census Tract 44, Fulton County, Georgia",2509,2461,48,1.91311279394
2643,1500000US131210048001,131210048001,"Block Group 1, Census Tract 48, Fulton County, Georgia",1048,989,59,5.62977099237
2644,1500000US131210049001,131210049001,"Block Group 1, Census Tract 49, Fulton County, Georgia",1494,1421,73,4.88621151272
2645,1500000US131210049002,131210049002,"Block Group 2, Census Tract 49, Fulton County, Georgia",1397,1283,114,8.16034359341
2646,1500000US131210050001,131210050001,"Block Group 1, Census Tract 50, Fulton County, Georgia",2065,1946,119,5.76271186441
2647,1500000US131210052001,131210052001,"Block Group 1, Census Tract 52, Fulton County, Georgia",931,866,65,6.98174006445
2648,1500000US131210052002,131210052002,"Block Group 2, Census Tract 52, Fulton County, Georgia",1262,1105,157,12.440570523
2649,1500000US131210052003,131210052003,"Block Group 3, Census Tract 52, Fulton County, Georgia",2988,2799,189,6.32530120482
2650,1500000US131210053001,131210053001,"Block Group 1, Census Tract 53, Fulton County, Georgia",1730,1714,16,0.924855491329
2651,1500000US131210053002,131210053002,"Block Group 2, Census Tract 53, Fulton County, Georgia",1285,1255,30,2.33463035019
2652,1500000US131210053003,131210053003,"Block Group 3, Census Tract 53, Fulton County, Georgia",688,629,59,8.57558139535
2653,1500000US131210055011,131210055011,"Block Group 1, Census Tract 55.01, Fulton County, Georgia",1050,1002,48,4.57142857143
2654,1500000US131210055012,131210055012,"Block Group 2, Census Tract 55.01, Fulton County, Georgia",1483,1403,80,5.39447066757
2655,1500000US131210055021,131210055021,"Block Group 1, Census Tract 55.02, Fulton County, Georgia",2422,2393,29,1.19735755574
2656,1500000US131210057001,131210057001,"Block Group 1, Census Tract 57, Fulton County, Georgia",1655,1627,28,1.6918429003
2657,1500000US131210058001,131210058001,"Block Group 1, Census Tract 58, Fulton County, Georgia",2023,2010,13,0.642609985171
2658,1500000US131210060001,131210060001,"Block Group 1, Census Tract 60, Fulton County, Georgia",600,600,0,0.0
2659,1500000US131210060002,131210060002,"Block Group 2, Census Tract 60, Fulton County, Georgia",1139,1139,0,0.0
2660,1500000US131210060003,131210060003,"Block Group 3, Census Tract 60, Fulton County, Georgia",785,614,171,21.7834394904
2661,1500000US131210060004,131210060004,"Block Group 4, Census Tract 60, Fulton County, Georgia",736,712,24,3.26086956522
2662,1500000US131210061001,131210061001,"Block Group 1, Census Tract 61, Fulton County, Georgia",580,580,0,0.0
2663,1500000US131210061002,131210061002,"Block Group 2, Census Tract 61, Fulton County, Georgia",1295,1244,51,3.93822393822
2664,1500000US131210061003,131210061003,"Block Group 3, Census Tract 61, Fulton County, Georgia",730,722,8,1.09589041096
2665,1500000US131210061004,131210061004,"Block Group 4, Census Tract 61, Fulton County, Georgia",1067,1067,0,0.0
2666,1500000US131210062001,131210062001,"Block Group 1, Census Tract 62, Fulton County, Georgia",943,927,16,1.6967126193
2667,1500000US131210062002,131210062002,"Block Group 2, Census Tract 62, Fulton County, Georgia",532,532,0,0.0
2668,1500000US131210063001,131210063001,"Block Group 1, Census Tract 63, Fulton County, Georgia",1079,1079,0,0.0
2669,1500000US131210063002,131210063002,"Block Group 2, Census Tract 63, Fulton County, Georgia",571,571,0,0.0
2670,1500000US131210064001,131210064001,"Block Group 1, Census Tract 64, Fulton County, Georgia",1175,797,378,32.170212766
2671,1500000US131210065001,131210065001,"Block Group 1, Census Tract 65, Fulton County, Georgia",683,683,0,0.0
2672,1500000US131210065002,131210065002,"Block Group 2, Census Tract 65, Fulton County, Georgia",1683,1579,104,6.17944147356
2673,1500000US131210065003,131210065003,"Block Group 3, Census Tract 65, Fulton County, Georgia",605,576,29,4.79338842975
2674,1500000US131210065004,131210065004,"Block Group 4, Census Tract 65, Fulton County, Georgia",1312,1289,23,1.75304878049
2675,1500000US131210066011,131210066011,"Block Group 1, Census Tract 66.01, Fulton County, Georgia",853,852,1,0.117233294256
2676,1500000US131210066012,131210066012,"Block Group 2, Census Tract 66.01, Fulton County, Georgia",1364,1321,43,3.15249266862
2677,1500000US131210066021,131210066021,"Block Group 1, Census Tract 66.02, Fulton County, Georgia",1369,1349,20,1.46092037984
2678,1500000US131210067001,131210067001,"Block Group 1, Census Tract 67, Fulton County, Georgia",833,833,0,0.0
2679,1500000US131210067002,131210067002,"Block Group 2, Census Tract 67, Fulton County, Georgia",1560,1507,53,3.39743589744
2680,1500000US131210067003,131210067003,"Block Group 3, Census Tract 67, Fulton County, Georgia",1348,1335,13,0.964391691395
2681,1500000US131210068011,131210068011,"Block Group 1, Census Tract 68.01, Fulton County, Georgia",2382,1943,439,18.429890848
2682,1500000US131210068021,131210068021,"Block Group 1, Census Tract 68.02, Fulton County, Georgia",1992,1992,0,0.0
2683,1500000US131210069001,131210069001,"Block Group 1, Census Tract 69, Fulton County, Georgia",974,952,22,2.25872689938
2684,1500000US131210069002,131210069002,"Block Group 2, Census Tract 69, Fulton County, Georgia",1335,1065,270,20.2247191011
2685,1500000US131210069003,131210069003,"Block Group 3, Census Tract 69, Fulton County, Georgia",1242,911,331,26.6505636071
2686,1500000US131210070011,131210070011,"Block Group 1, Census Tract 70.01, Fulton County, Georgia",2406,2406,0,0.0
2687,1500000US131210070012,131210070012,"Block Group 2, Census Tract 70.01, Fulton County, Georgia",1168,1132,36,3.08219178082
2688,1500000US131210070013,131210070013,"Block Group 3, Census Tract 70.01, Fulton County, Georgia",1190,1190,0,0.0
2689,1500000US131210070021,131210070021,"Block Group 1, Census Tract 70.02, Fulton County, Georgia",860,845,15,1.74418604651
2690,1500000US131210070022,131210070022,"Block Group 2, Census Tract 70.02, Fulton County, Georgia",429,288,141,32.8671328671
2691,1500000US131210070023,131210070023,"Block Group 3, Census Tract 70.02, Fulton County, Georgia",297,297,0,0.0
2692,1500000US131210070024,131210070024,"Block Group 4, Census Tract 70.02, Fulton County, Georgia",302,289,13,4.30463576159
2693,1500000US131210071001,131210071001,"Block Group 1, Census Tract 71, Fulton County, Georgia",868,858,10,1.15207373272
2694,1500000US131210071002,131210071002,"Block Group 2, Census Tract 71, Fulton County, Georgia",1151,1143,8,0.695047784535
2695,1500000US131210072001,131210072001,"Block Group 1, Census Tract 72, Fulton County, Georgia",1687,1672,15,0.889152341434
2696,1500000US131210072002,131210072002,"Block Group 2, Census Tract 72, Fulton County, Georgia",342,342,0,0.0
2697,1500000US131210073001,131210073001,"Block Group 1, Census Tract 73, Fulton County, Georgia",2642,2589,53,2.00605601817
2698,1500000US131210073002,131210073002,"Block Group 2, Census Tract 73, Fulton County, Georgia",3397,3397,0,0.0
2699,1500000US131210073003,131210073003,"Block Group 3, Census Tract 73, Fulton County, Georgia",1913,1913,0,0.0
2700,1500000US131210074001,131210074001,"Block Group 1, Census Tract 74, Fulton County, Georgia",1409,1050,359,25.4790631654
2701,1500000US131210074002,131210074002,"Block Group 2, Census Tract 74, Fulton County, Georgia",1616,1487,129,7.98267326733
2702,1500000US131210075001,131210075001,"Block Group 1, Census Tract 75, Fulton County, Georgia",1087,1049,38,3.49586016559
2703,1500000US131210075002,131210075002,"Block Group 2, Census Tract 75, Fulton County, Georgia",511,511,0,0.0
2704,1500000US131210075003,131210075003,"Block Group 3, Census Tract 75, Fulton County, Georgia",846,809,37,4.37352245863
2705,1500000US131210075004,131210075004,"Block Group 4, Census Tract 75, Fulton County, Georgia",815,805,10,1.22699386503
2706,1500000US131210076021,131210076021,"Block Group 1, Census Tract 76.02, Fulton County, Georgia",612,612,0,0.0
2707,1500000US131210076022,131210076022,"Block Group 2, Census Tract 76.02, Fulton County, Georgia",903,891,12,1.32890365449
2708,1500000US131210076023,131210076023,"Block Group 3, Census Tract 76.02, Fulton County, Georgia",1055,1005,50,4.73933649289
2709,1500000US131210076031,131210076031,"Block Group 1, Census Tract 76.03, Fulton County, Georgia",1553,1553,0,0.0
2710,1500000US131210076032,131210076032,"Block Group 2, Census Tract 76.03, Fulton County, Georgia",1630,1630,0,0.0
2711,1500000US131210076033,131210076033,"Block Group 3, Census Tract 76.03, Fulton County, Georgia",1332,1287,45,3.37837837838
2712,1500000US131210076041,131210076041,"Block Group 1, Census Tract 76.04, Fulton County, Georgia",2331,2331,0,0.0
2713,1500000US131210077031,131210077031,"Block Group 1, Census Tract 77.03, Fulton County, Georgia",1071,1071,0,0.0
2714,1500000US131210077032,131210077032,"Block Group 2, Census Tract 77.03, Fulton County, Georgia",1740,1740,0,0.0
2715,1500000US131210077033,131210077033,"Block Group 3, Census Tract 77.03, Fulton County, Georgia",1341,1341,0,0.0
2716,1500000US131210077041,131210077041,"Block Group 1, Census Tract 77.04, Fulton County, Georgia",817,817,0,0.0
2717,1500000US131210077042,131210077042,"Block Group 2, Census Tract 77.04, Fulton County, Georgia",2156,1830,326,15.120593692
2718,1500000US131210077043,131210077043,"Block Group 3, Census Tract 77.04, Fulton County, Georgia",2344,2337,7,0.298634812287
2719,1500000US131210077051,131210077051,"Block Group 1, Census Tract 77.05, Fulton County, Georgia",2517,2487,30,1.19189511323
2720,1500000US131210077052,131210077052,"Block Group 2, Census Tract 77.05, Fulton County, Georgia",2504,2473,31,1.23801916933
2721,1500000US131210077061,131210077061,"Block Group 1, Census Tract 77.06, Fulton County, Georgia",2820,2820,0,0.0
2722,1500000US131210077062,131210077062,"Block Group 2, Census Tract 77.06, Fulton County, Georgia",2248,2240,8,0.355871886121
2723,1500000US131210077063,131210077063,"Block Group 3, Census Tract 77.06, Fulton County, Georgia",4422,4305,117,2.64586160109
2724,1500000US131210078021,131210078021,"Block Group 1, Census Tract 78.02, Fulton County, Georgia",4140,4051,89,2.14975845411
2725,1500000US131210078022,131210078022,"Block Group 2, Census Tract 78.02, Fulton County, Georgia",2852,2852,0,0.0
2726,1500000US131210078023,131210078023,"Block Group 3, Census Tract 78.02, Fulton County, Georgia",1207,1207,0,0.0
2727,1500000US131210078024,131210078024,"Block Group 4, Census Tract 78.02, Fulton County, Georgia",1815,1797,18,0.99173553719
2728,1500000US131210078051,131210078051,"Block Group 1, Census Tract 78.05, Fulton County, Georgia",1381,1366,15,1.08616944243
2729,1500000US131210078052,131210078052,"Block Group 2, Census Tract 78.05, Fulton County, Georgia",1763,1757,6,0.340328984685
2730,1500000US131210078061,131210078061,"Block Group 1, Census Tract 78.06, Fulton County, Georgia",1676,1549,127,7.57756563246
2731,1500000US131210078062,131210078062,"Block Group 2, Census Tract 78.06, Fulton County, Georgia",3863,3863,0,0.0
2732,1500000US131210078063,131210078063,"Block Group 3, Census Tract 78.06, Fulton County, Georgia",1055,917,138,13.0805687204
2733,1500000US131210078071,131210078071,"Block Group 1, Census Tract 78.07, Fulton County, Georgia",2537,2075,462,18.2104848246
2734,1500000US131210078072,131210078072,"Block Group 2, Census Tract 78.07, Fulton County, Georgia",666,666,0,0.0
2735,1500000US131210078081,131210078081,"Block Group 1, Census Tract 78.08, Fulton County, Georgia",1900,1768,132,6.94736842105
2736,1500000US131210078082,131210078082,"Block Group 2, Census Tract 78.08, Fulton County, Georgia",2587,2380,207,8.0015461925
2737,1500000US131210079001,131210079001,"Block Group 1, Census Tract 79, Fulton County, Georgia",1819,1819,0,0.0
2738,1500000US131210079002,131210079002,"Block Group 2, Census Tract 79, Fulton County, Georgia",1231,1231,0,0.0
2739,1500000US131210079003,131210079003,"Block Group 3, Census Tract 79, Fulton County, Georgia",2751,2751,0,0.0
2740,1500000US131210080001,131210080001,"Block Group 1, Census Tract 80, Fulton County, Georgia",1064,1064,0,0.0
2741,1500000US131210080002,131210080002,"Block Group 2, Census Tract 80, Fulton County, Georgia",1205,1205,0,0.0
2742,1500000US131210080003,131210080003,"Block Group 3, Census Tract 80, Fulton County, Georgia",496,496,0,0.0
2743,1500000US131210080004,131210080004,"Block Group 4, Census Tract 80, Fulton County, Georgia",1255,1246,9,0.717131474104
2744,1500000US131210080005,131210080005,"Block Group 5, Census Tract 80, Fulton County, Georgia",1402,1350,52,3.7089871612
2745,1500000US131210081011,131210081011,"Block Group 1, Census Tract 81.01, Fulton County, Georgia",1138,1138,0,0.0
2746,1500000US131210081021,131210081021,"Block Group 1, Census Tract 81.02, Fulton County, Georgia",1278,1278,0,0.0
2747,1500000US131210081022,131210081022,"Block Group 2, Census Tract 81.02, Fulton County, Georgia",940,930,10,1.06382978723
2748,1500000US131210081023,131210081023,"Block Group 3, Census Tract 81.02, Fulton County, Georgia",2160,1671,489,22.6388888889
2749,1500000US131210081024,131210081024,"Block Group 4, Census Tract 81.02, Fulton County, Georgia",2653,2346,307,11.5718055032
2750,1500000US131210082011,131210082011,"Block Group 1, Census Tract 82.01, Fulton County, Georgia",1951,1900,51,2.61404407996
2751,1500000US131210082012,131210082012,"Block Group 2, Census Tract 82.01, Fulton County, Georgia",3083,3046,37,1.20012974376
2752,1500000US131210082013,131210082013,"Block Group 3, Census Tract 82.01, Fulton County, Georgia",965,965,0,0.0
2753,1500000US131210082021,131210082021,"Block Group 1, Census Tract 82.02, Fulton County, Georgia",948,933,15,1.58227848101
2754,1500000US131210082022,131210082022,"Block Group 2, Census Tract 82.02, Fulton County, Georgia",836,830,6,0.717703349282
2755,1500000US131210082023,131210082023,"Block Group 3, Census Tract 82.02, Fulton County, Georgia",264,264,0,0.0
2756,1500000US131210082024,131210082024,"Block Group 4, Census Tract 82.02, Fulton County, Georgia",0,0,0,
2757,1500000US131210083011,131210083011,"Block Group 1, Census Tract 83.01, Fulton County, Georgia",1691,1688,3,0.177409816677
2758,1500000US131210083012,131210083012,"Block Group 2, Census Tract 83.01, Fulton County, Georgia",604,604,0,0.0
2759,1500000US131210083021,131210083021,"Block Group 1, Census Tract 83.02, Fulton County, Georgia",793,786,7,0.882723833544
2760,1500000US131210083022,131210083022,"Block Group 2, Census Tract 83.02, Fulton County, Georgia",1148,1148,0,0.0
2761,1500000US131210084001,131210084001,"Block Group 1, Census Tract 84, Fulton County, Georgia",1472,1462,10,0.679347826087
2762,1500000US131210084002,131210084002,"Block Group 2, Census Tract 84, Fulton County, Georgia",883,883,0,0.0
2763,1500000US131210084003,131210084003,"Block Group 3, Census Tract 84, Fulton County, Georgia",963,934,29,3.01142263759
2764,1500000US131210085001,131210085001,"Block Group 1, Census Tract 85, Fulton County, Georgia",565,565,0,0.0
2765,1500000US131210085002,131210085002,"Block Group 2, Census Tract 85, Fulton County, Georgia",1248,1248,0,0.0
2766,1500000US131210085003,131210085003,"Block Group 3, Census Tract 85, Fulton County, Georgia",1222,1222,0,0.0
2767,1500000US131210086011,131210086011,"Block Group 1, Census Tract 86.01, Fulton County, Georgia",1663,1663,0,0.0
2768,1500000US131210086012,131210086012,"Block Group 2, Census Tract 86.01, Fulton County, Georgia",1001,1001,0,0.0
2769,1500000US131210086013,131210086013,"Block Group 3, Census Tract 86.01, Fulton County, Georgia",1414,1379,35,2.47524752475
2770,1500000US131210086014,131210086014,"Block Group 4, Census Tract 86.01, Fulton County, Georgia",348,348,0,0.0
2771,1500000US131210086021,131210086021,"Block Group 1, Census Tract 86.02, Fulton County, Georgia",803,792,11,1.3698630137
2772,1500000US131210086022,131210086022,"Block Group 2, Census Tract 86.02, Fulton County, Georgia",260,260,0,0.0
2773,1500000US131210087001,131210087001,"Block Group 1, Census Tract 87, Fulton County, Georgia",1009,1000,9,0.891972249752
2774,1500000US131210087002,131210087002,"Block Group 2, Census Tract 87, Fulton County, Georgia",818,818,0,0.0
2775,1500000US131210087003,131210087003,"Block Group 3, Census Tract 87, Fulton County, Georgia",969,969,0,0.0
2776,1500000US131210087004,131210087004,"Block Group 4, Census Tract 87, Fulton County, Georgia",1568,1551,17,1.08418367347
2777,1500000US131210088001,131210088001,"Block Group 1, Census Tract 88, Fulton County, Georgia",2944,2413,531,18.0366847826
2778,1500000US131210088002,131210088002,"Block Group 2, Census Tract 88, Fulton County, Georgia",1625,1602,23,1.41538461538
2779,1500000US131210089021,131210089021,"Block Group 1, Census Tract 89.02, Fulton County, Georgia",1876,1876,0,0.0
2780,1500000US131210089022,131210089022,"Block Group 2, Census Tract 89.02, Fulton County, Georgia",659,613,46,6.98027314112
2781,1500000US131210089023,131210089023,"Block Group 3, Census Tract 89.02, Fulton County, Georgia",1280,1177,103,8.046875
2782,1500000US131210089024,131210089024,"Block Group 4, Census Tract 89.02, Fulton County, Georgia",2722,2423,299,10.984570169
2783,1500000US131210089031,131210089031,"Block Group 1, Census Tract 89.03, Fulton County, Georgia",1684,964,720,42.7553444181
2784,1500000US131210089041,131210089041,"Block Group 1, Census Tract 89.04, Fulton County, Georgia",1323,1237,86,6.50037792895
2785,1500000US131210089042,131210089042,"Block Group 2, Census Tract 89.04, Fulton County, Georgia",1638,1497,141,8.60805860806
2786,1500000US131210089043,131210089043,"Block Group 3, Census Tract 89.04, Fulton County, Georgia",1611,1561,50,3.10366232154
2787,1500000US131210090001,131210090001,"Block Group 1, Census Tract 90, Fulton County, Georgia",1350,1320,30,2.22222222222
2788,1500000US131210090002,131210090002,"Block Group 2, Census Tract 90, Fulton County, Georgia",1769,1700,69,3.90050876201
2789,1500000US131210090003,131210090003,"Block Group 3, Census Tract 90, Fulton County, Georgia",1829,1660,169,9.24002186987
2790,1500000US131210091011,131210091011,"Block Group 1, Census Tract 91.01, Fulton County, Georgia",1369,1369,0,0.0
2791,1500000US131210091012,131210091012,"Block Group 2, Census Tract 91.01, Fulton County, Georgia",1565,1565,0,0.0
2792,1500000US131210091013,131210091013,"Block Group 3, Census Tract 91.01, Fulton County, Georgia",627,627,0,0.0
2793,1500000US131210091014,131210091014,"Block Group 4, Census Tract 91.01, Fulton County, Georgia",1001,982,19,1.8981018981
2794,1500000US131210091021,131210091021,"Block Group 1, Census Tract 91.02, Fulton County, Georgia",443,443,0,0.0
2795,1500000US131210091022,131210091022,"Block Group 2, Census Tract 91.02, Fulton County, Georgia",963,861,102,10.5919003115
2796,1500000US131210091023,131210091023,"Block Group 3, Census Tract 91.02, Fulton County, Georgia",1840,1787,53,2.88043478261
2797,1500000US131210092001,131210092001,"Block Group 1, Census Tract 92, Fulton County, Georgia",2404,2380,24,0.998336106489
2798,1500000US131210092002,131210092002,"Block Group 2, Census Tract 92, Fulton County, Georgia",2976,1360,1616,54.3010752688
2799,1500000US131210092003,131210092003,"Block Group 3, Census Tract 92, Fulton County, Georgia",1703,1601,102,5.98943041691
2800,1500000US131210093001,131210093001,"Block Group 1, Census Tract 93, Fulton County, Georgia",1079,1079,0,0.0
2801,1500000US131210093002,131210093002,"Block Group 2, Census Tract 93, Fulton County, Georgia",1319,1145,174,13.1918119788
2802,1500000US131210093003,131210093003,"Block Group 3, Census Tract 93, Fulton County, Georgia",1510,1348,162,10.7284768212
2803,1500000US131210093004,131210093004,"Block Group 4, Census Tract 93, Fulton County, Georgia",750,717,33,4.4
2804,1500000US131210094021,131210094021,"Block Group 1, Census Tract 94.02, Fulton County, Georgia",2795,2562,233,8.33631484794
2805,1500000US131210094022,131210094022,"Block Group 2, Census Tract 94.02, Fulton County, Georgia",2227,1102,1125,50.516389762
2806,1500000US131210094031,131210094031,"Block Group 1, Census Tract 94.03, Fulton County, Georgia",2448,2031,417,17.0343137255
2807,1500000US131210094032,131210094032,"Block Group 2, Census Tract 94.03, Fulton County, Georgia",1245,1208,37,2.9718875502
2808,1500000US131210094033,131210094033,"Block Group 3, Census Tract 94.03, Fulton County, Georgia",1279,973,306,23.9249413604
2809,1500000US131210094041,131210094041,"Block Group 1, Census Tract 94.04, Fulton County, Georgia",2515,2227,288,11.4512922465
2810,1500000US131210094042,131210094042,"Block Group 2, Census Tract 94.04, Fulton County, Georgia",1995,1906,89,4.46115288221
2811,1500000US131210094043,131210094043,"Block Group 3, Census Tract 94.04, Fulton County, Georgia",311,227,84,27.0096463023
2812,1500000US131210095011,131210095011,"Block Group 1, Census Tract 95.01, Fulton County, Georgia",470,470,0,0.0
2813,1500000US131210095012,131210095012,"Block Group 2, Census Tract 95.01, Fulton County, Georgia",1736,1721,15,0.864055299539
2814,1500000US131210095013,131210095013,"Block Group 3, Census Tract 95.01, Fulton County, Georgia",1588,1588,0,0.0
2815,1500000US131210095021,131210095021,"Block Group 1, Census Tract 95.02, Fulton County, Georgia",490,490,0,0.0
2816,1500000US131210095022,131210095022,"Block Group 2, Census Tract 95.02, Fulton County, Georgia",297,265,32,10.7744107744
2817,1500000US131210095023,131210095023,"Block Group 3, Census Tract 95.02, Fulton County, Georgia",960,934,26,2.70833333333
2818,1500000US131210095024,131210095024,"Block Group 4, Census Tract 95.02, Fulton County, Georgia",1317,1277,40,3.03720577069
2819,1500000US131210096011,131210096011,"Block Group 1, Census Tract 96.01, Fulton County, Georgia",1003,993,10,0.997008973081
2820,1500000US131210096012,131210096012,"Block Group 2, Census Tract 96.01, Fulton County, Georgia",1414,1335,79,5.58698727016
2821,1500000US131210096021,131210096021,"Block Group 1, Census Tract 96.02, Fulton County, Georgia",1249,1249,0,0.0
2822,1500000US131210096022,131210096022,"Block Group 2, Census Tract 96.02, Fulton County, Georgia",2131,2088,43,2.01783200375
2823,1500000US131210096023,131210096023,"Block Group 3, Census Tract 96.02, Fulton County, Georgia",1245,1245,0,0.0
2824,1500000US131210096031,131210096031,"Block Group 1, Census Tract 96.03, Fulton County, Georgia",1086,1086,0,0.0
2825,1500000US131210096032,131210096032,"Block Group 2, Census Tract 96.03, Fulton County, Georgia",1374,1290,84,6.1135371179
2826,1500000US131210096033,131210096033,"Block Group 3, Census Tract 96.03, Fulton County, Georgia",1734,1410,324,18.6851211073
2827,1500000US131210097001,131210097001,"Block Group 1, Census Tract 97, Fulton County, Georgia",995,962,33,3.31658291457
2828,1500000US131210097002,131210097002,"Block Group 2, Census Tract 97, Fulton County, Georgia",1032,1032,0,0.0
2829,1500000US131210097003,131210097003,"Block Group 3, Census Tract 97, Fulton County, Georgia",1896,1831,65,3.42827004219
2830,1500000US131210098011,131210098011,"Block Group 1, Census Tract 98.01, Fulton County, Georgia",1826,1826,0,0.0
2831,1500000US131210098012,131210098012,"Block Group 2, Census Tract 98.01, Fulton County, Georgia",1692,1681,11,0.65011820331
2832,1500000US131210098013,131210098013,"Block Group 3, Census Tract 98.01, Fulton County, Georgia",1375,1345,30,2.18181818182
2833,1500000US131210098021,131210098021,"Block Group 1, Census Tract 98.02, Fulton County, Georgia",1774,1718,56,3.15670800451
2834,1500000US131210098022,131210098022,"Block Group 2, Census Tract 98.02, Fulton County, Georgia",2710,2638,72,2.65682656827
2835,1500000US131210099001,131210099001,"Block Group 1, Census Tract 99, Fulton County, Georgia",1579,1509,70,4.43318556048
2836,1500000US131210099002,131210099002,"Block Group 2, Census Tract 99, Fulton County, Georgia",1190,1190,0,0.0
2837,1500000US131210099003,131210099003,"Block Group 3, Census Tract 99, Fulton County, Georgia",1330,1330,0,0.0
2838,1500000US131210099004,131210099004,"Block Group 4, Census Tract 99, Fulton County, Georgia",669,669,0,0.0
2839,1500000US131210100011,131210100011,"Block Group 1, Census Tract 100.01, Fulton County, Georgia",1482,1468,14,0.944669365722
2840,1500000US131210100012,131210100012,"Block Group 2, Census Tract 100.01, Fulton County, Georgia",1076,1032,44,4.08921933086
2841,1500000US131210100013,131210100013,"Block Group 3, Census Tract 100.01, Fulton County, Georgia",718,718,0,0.0
2842,1500000US131210100014,131210100014,"Block Group 4, Census Tract 100.01, Fulton County, Georgia",1228,1204,24,1.95439739414
2843,1500000US131210100021,131210100021,"Block Group 1, Census Tract 100.02, Fulton County, Georgia",1474,1474,0,0.0
2844,1500000US131210100022,131210100022,"Block Group 2, Census Tract 100.02, Fulton County, Georgia",2041,2041,0,0.0
2845,1500000US131210100023,131210100023,"Block Group 3, Census Tract 100.02, Fulton County, Georgia",3894,3581,313,8.03800719055
2846,1500000US131210101061,131210101061,"Block Group 1, Census Tract 101.06, Fulton County, Georgia",2099,1989,110,5.2405907575
2847,1500000US131210101062,131210101062,"Block Group 2, Census Tract 101.06, Fulton County, Georgia",881,842,39,4.4267877412
2848,1500000US131210101063,131210101063,"Block Group 3, Census Tract 101.06, Fulton County, Georgia",1087,1073,14,1.28794848206
2849,1500000US131210101071,131210101071,"Block Group 1, Census Tract 101.07, Fulton County, Georgia",912,908,4,0.438596491228
2850,1500000US131210101072,131210101072,"Block Group 2, Census Tract 101.07, Fulton County, Georgia",1035,1004,31,2.99516908213
2851,1500000US131210101081,131210101081,"Block Group 1, Census Tract 101.08, Fulton County, Georgia",1266,1253,13,1.02685624013
2852,1500000US131210101082,131210101082,"Block Group 2, Census Tract 101.08, Fulton County, Georgia",2333,2188,145,6.21517359623
2853,1500000US131210101101,131210101101,"Block Group 1, Census Tract 101.10, Fulton County, Georgia",2609,2597,12,0.459946339594
2854,1500000US131210101102,131210101102,"Block Group 2, Census Tract 101.10, Fulton County, Georgia",1118,994,124,11.091234347
2855,1500000US131210101103,131210101103,"Block Group 3, Census Tract 101.10, Fulton County, Georgia",1756,1479,277,15.7744874715
2856,1500000US131210101131,131210101131,"Block Group 1, Census Tract 101.13, Fulton County, Georgia",1749,1617,132,7.54716981132
2857,1500000US131210101132,131210101132,"Block Group 2, Census Tract 101.13, Fulton County, Georgia",3024,945,2079,68.75
2858,1500000US131210101133,131210101133,"Block Group 3, Census Tract 101.13, Fulton County, Georgia",1975,1340,635,32.1518987342
2859,1500000US131210101141,131210101141,"Block Group 1, Census Tract 101.14, Fulton County, Georgia",1953,1924,29,1.48489503328
2860,1500000US131210101142,131210101142,"Block Group 2, Census Tract 101.14, Fulton County, Georgia",2988,1609,1379,46.1512717537
2861,1500000US131210101143,131210101143,"Block Group 3, Census Tract 101.14, Fulton County, Georgia",2408,1971,437,18.1478405316
2862,1500000US131210101151,131210101151,"Block Group 1, Census Tract 101.15, Fulton County, Georgia",2342,2306,36,1.53714773698
2863,1500000US131210101171,131210101171,"Block Group 1, Census Tract 101.17, Fulton County, Georgia",2494,2121,373,14.955894146
2864,1500000US131210101172,131210101172,"Block Group 2, Census Tract 101.17, Fulton County, Georgia",838,771,67,7.99522673031
2865,1500000US131210101181,131210101181,"Block Group 1, Census Tract 101.18, Fulton County, Georgia",3083,2389,694,22.5105416802
2866,1500000US131210101182,131210101182,"Block Group 2, Census Tract 101.18, Fulton County, Georgia",974,767,207,21.2525667351
2867,1500000US131210101183,131210101183,"Block Group 3, Census Tract 101.18, Fulton County, Georgia",1377,1090,287,20.8424110385
2868,1500000US131210101191,131210101191,"Block Group 1, Census Tract 101.19, Fulton County, Georgia",1407,1287,120,8.52878464819
2869,1500000US131210101192,131210101192,"Block Group 2, Census Tract 101.19, Fulton County, Georgia",1999,1603,396,19.8099049525
2870,1500000US131210101193,131210101193,"Block Group 3, Census Tract 101.19, Fulton County, Georgia",1678,1431,247,14.7199046484
2871,1500000US131210101201,131210101201,"Block Group 1, Census Tract 101.20, Fulton County, Georgia",2302,2003,299,12.9887054735
2872,1500000US131210101211,131210101211,"Block Group 1, Census Tract 101.21, Fulton County, Georgia",2199,2159,40,1.81900864029
2873,1500000US131210101221,131210101221,"Block Group 1, Census Tract 101.22, Fulton County, Georgia",2320,2270,50,2.15517241379
2874,1500000US131210101222,131210101222,"Block Group 2, Census Tract 101.22, Fulton County, Georgia",1853,1776,77,4.15542363734
2875,1500000US131210101223,131210101223,"Block Group 3, Census Tract 101.22, Fulton County, Georgia",2096,2036,60,2.86259541985
2876,1500000US131210101231,131210101231,"Block Group 1, Census Tract 101.23, Fulton County, Georgia",2793,1703,1090,39.0261367705
2877,1500000US131210101232,131210101232,"Block Group 2, Census Tract 101.23, Fulton County, Georgia",1401,1068,333,23.7687366167
2878,1500000US131210101233,131210101233,"Block Group 3, Census Tract 101.23, Fulton County, Georgia",1704,1634,70,4.10798122066
2879,1500000US131210102041,131210102041,"Block Group 1, Census Tract 102.04, Fulton County, Georgia",1056,982,74,7.00757575758
2880,1500000US131210102042,131210102042,"Block Group 2, Census Tract 102.04, Fulton County, Georgia",1991,1972,19,0.95429432446
2881,1500000US131210102043,131210102043,"Block Group 3, Census Tract 102.04, Fulton County, Georgia",1242,1224,18,1.44927536232
2882,1500000US131210102044,131210102044,"Block Group 4, Census Tract 102.04, Fulton County, Georgia",607,607,0,0.0
2883,1500000US131210102051,131210102051,"Block Group 1, Census Tract 102.05, Fulton County, Georgia",938,897,41,4.3710021322
2884,1500000US131210102052,131210102052,"Block Group 2, Census Tract 102.05, Fulton County, Georgia",1057,1057,0,0.0
2885,1500000US131210102053,131210102053,"Block Group 3, Census Tract 102.05, Fulton County, Georgia",1933,1933,0,0.0
2886,1500000US131210102054,131210102054,"Block Group 4, Census Tract 102.05, Fulton County, Georgia",1050,1050,0,0.0
2887,1500000US131210102061,131210102061,"Block Group 1, Census Tract 102.06, Fulton County, Georgia",2365,2170,195,8.24524312896
2888,1500000US131210102062,131210102062,"Block Group 2, Census Tract 102.06, Fulton County, Georgia",1552,1531,21,1.35309278351
2889,1500000US131210102063,131210102063,"Block Group 3, Census Tract 102.06, Fulton County, Georgia",1343,1322,21,1.56366344006
2890,1500000US131210102081,131210102081,"Block Group 1, Census Tract 102.08, Fulton County, Georgia",1799,1722,77,4.28015564202
2891,1500000US131210102082,131210102082,"Block Group 2, Census Tract 102.08, Fulton County, Georgia",336,336,0,0.0
2892,1500000US131210102083,131210102083,"Block Group 3, Census Tract 102.08, Fulton County, Georgia",2058,2033,25,1.21477162293
2893,1500000US131210102091,131210102091,"Block Group 1, Census Tract 102.09, Fulton County, Georgia",1206,1022,184,15.2570480929
2894,1500000US131210102092,131210102092,"Block Group 2, Census Tract 102.09, Fulton County, Georgia",969,872,97,10.0103199174
2895,1500000US131210102093,131210102093,"Block Group 3, Census Tract 102.09, Fulton County, Georgia",3600,3159,441,12.25
2896,1500000US131210102101,131210102101,"Block Group 1, Census Tract 102.10, Fulton County, Georgia",1534,1446,88,5.73663624511
2897,1500000US131210102102,131210102102,"Block Group 2, Census Tract 102.10, Fulton County, Georgia",2304,2216,88,3.81944444444
2898,1500000US131210102103,131210102103,"Block Group 3, Census Tract 102.10, Fulton County, Georgia",1950,1913,37,1.89743589744
2899,1500000US131210102111,131210102111,"Block Group 1, Census Tract 102.11, Fulton County, Georgia",1227,1204,23,1.87449062755
2900,1500000US131210102112,131210102112,"Block Group 2, Census Tract 102.11, Fulton County, Georgia",2030,1778,252,12.4137931034
2901,1500000US131210102121,131210102121,"Block Group 1, Census Tract 102.12, Fulton County, Georgia",1999,715,1284,64.232116058
2902,1500000US131210102122,131210102122,"Block Group 2, Census Tract 102.12, Fulton County, Georgia",773,664,109,14.1009055627
2903,1500000US131210102123,131210102123,"Block Group 3, Census Tract 102.12, Fulton County, Georgia",2256,1861,395,17.5088652482
2904,1500000US131210103011,131210103011,"Block Group 1, Census Tract 103.01, Fulton County, Georgia",9800,9512,288,2.9387755102
2905,1500000US131210103012,131210103012,"Block Group 2, Census Tract 103.01, Fulton County, Georgia",6419,6419,0,0.0
2906,1500000US131210103031,131210103031,"Block Group 1, Census Tract 103.03, Fulton County, Georgia",3107,3107,0,0.0
2907,1500000US131210103032,131210103032,"Block Group 2, Census Tract 103.03, Fulton County, Georgia",6387,6340,47,0.7358697354
2908,1500000US131210103041,131210103041,"Block Group 1, Census Tract 103.04, Fulton County, Georgia",4897,4801,96,1.96038390852
2909,1500000US131210103042,131210103042,"Block Group 2, Census Tract 103.04, Fulton County, Georgia",10491,10270,221,2.10656753408
2910,1500000US131210104001,131210104001,"Block Group 1, Census Tract 104, Fulton County, Georgia",1756,1614,142,8.08656036446
2911,1500000US131210104002,131210104002,"Block Group 2, Census Tract 104, Fulton County, Georgia",1514,1284,230,15.1915455746
2912,1500000US131210104003,131210104003,"Block Group 3, Census Tract 104, Fulton County, Georgia",3896,3291,605,15.5287474333
2913,1500000US131210104004,131210104004,"Block Group 4, Census Tract 104, Fulton County, Georgia",1297,990,307,23.6700077101
2914,1500000US131210105071,131210105071,"Block Group 1, Census Tract 105.07, Fulton County, Georgia",3164,3164,0,0.0
2915,1500000US131210105072,131210105072,"Block Group 2, Census Tract 105.07, Fulton County, Georgia",1068,842,226,21.1610486891
2916,1500000US131210105073,131210105073,"Block Group 3, Census Tract 105.07, Fulton County, Georgia",2146,2108,38,1.77073625349
2917,1500000US131210105074,131210105074,"Block Group 4, Census Tract 105.07, Fulton County, Georgia",2021,2021,0,0.0
2918,1500000US131210105081,131210105081,"Block Group 1, Census Tract 105.08, Fulton County, Georgia",4009,3755,254,6.33574457471
2919,1500000US131210105101,131210105101,"Block Group 1, Census Tract 105.10, Fulton County, Georgia",3040,3040,0,0.0
2920,1500000US131210105102,131210105102,"Block Group 2, Census Tract 105.10, Fulton County, Georgia",1265,1265,0,0.0
2921,1500000US131210105103,131210105103,"Block Group 3, Census Tract 105.10, Fulton County, Georgia",9378,7538,1840,19.6203881425
2922,1500000US131210105104,131210105104,"Block Group 4, Census Tract 105.10, Fulton County, Georgia",2152,2152,0,0.0
2923,1500000US131210105111,131210105111,"Block Group 1, Census Tract 105.11, Fulton County, Georgia",1883,1883,0,0.0
2924,1500000US131210105112,131210105112,"Block Group 2, Census Tract 105.11, Fulton County, Georgia",5839,5823,16,0.274019523891
2925,1500000US131210105113,131210105113,"Block Group 3, Census Tract 105.11, Fulton County, Georgia",611,589,22,3.60065466448
2926,1500000US131210105121,131210105121,"Block Group 1, Census Tract 105.12, Fulton County, Georgia",3387,3353,34,1.0038382049
2927,1500000US131210105122,131210105122,"Block Group 2, Census Tract 105.12, Fulton County, Georgia",1042,1042,0,0.0
2928,1500000US131210105123,131210105123,"Block Group 3, Census Tract 105.12, Fulton County, Georgia",2220,2220,0,0.0
2929,1500000US131210105131,131210105131,"Block Group 1, Census Tract 105.13, Fulton County, Georgia",4628,4245,383,8.27571305099
2930,1500000US131210105132,131210105132,"Block Group 2, Census Tract 105.13, Fulton County, Georgia",3191,3086,105,3.29050454403
2931,1500000US131210105133,131210105133,"Block Group 3, Census Tract 105.13, Fulton County, Georgia",5218,4114,1104,21.1575316213
2932,1500000US131210105141,131210105141,"Block Group 1, Census Tract 105.14, Fulton County, Georgia",4227,3956,271,6.41116631181
2933,1500000US131210105142,131210105142,"Block Group 2, Census Tract 105.14, Fulton County, Georgia",4389,4321,68,1.54932786512
2934,1500000US131210105143,131210105143,"Block Group 3, Census Tract 105.14, Fulton County, Georgia",3189,2641,548,17.1840702415
2935,1500000US131210105151,131210105151,"Block Group 1, Census Tract 105.15, Fulton County, Georgia",4809,4692,117,2.4329382408
2936,1500000US131210105161,131210105161,"Block Group 1, Census Tract 105.16, Fulton County, Georgia",2719,2519,200,7.35564545789
2937,1500000US131210105162,131210105162,"Block Group 2, Census Tract 105.16, Fulton County, Georgia",3837,3573,264,6.8803752932
2938,1500000US131210105163,131210105163,"Block Group 3, Census Tract 105.16, Fulton County, Georgia",2377,2377,0,0.0
2939,1500000US131210106011,131210106011,"Block Group 1, Census Tract 106.01, Fulton County, Georgia",1242,1048,194,15.6199677939
2940,1500000US131210106012,131210106012,"Block Group 2, Census Tract 106.01, Fulton County, Georgia",1078,1078,0,0.0
2941,1500000US131210106013,131210106013,"Block Group 3, Census Tract 106.01, Fulton County, Georgia",486,486,0,0.0
2942,1500000US131210106014,131210106014,"Block Group 4, Census Tract 106.01, Fulton County, Georgia",781,773,8,1.02432778489
2943,1500000US131210106031,131210106031,"Block Group 1, Census Tract 106.03, Fulton County, Georgia",833,833,0,0.0
2944,1500000US131210106032,131210106032,"Block Group 2, Census Tract 106.03, Fulton County, Georgia",2224,2224,0,0.0
2945,1500000US131210106033,131210106033,"Block Group 3, Census Tract 106.03, Fulton County, Georgia",752,725,27,3.59042553191
2946,1500000US131210106041,131210106041,"Block Group 1, Census Tract 106.04, Fulton County, Georgia",639,639,0,0.0
2947,1500000US131210106042,131210106042,"Block Group 2, Census Tract 106.04, Fulton County, Georgia",223,144,79,35.4260089686
2948,1500000US131210106043,131210106043,"Block Group 3, Census Tract 106.04, Fulton County, Georgia",1901,1400,501,26.3545502367
2949,1500000US131210108001,131210108001,"Block Group 1, Census Tract 108, Fulton County, Georgia",537,313,224,41.7132216015
2950,1500000US131210108002,131210108002,"Block Group 2, Census Tract 108, Fulton County, Georgia",1007,986,21,2.08540218471
2951,1500000US131210108003,131210108003,"Block Group 3, Census Tract 108, Fulton County, Georgia",2013,1201,812,40.3378042722
2952,1500000US131210108004,131210108004,"Block Group 4, Census Tract 108, Fulton County, Georgia",1428,1236,192,13.4453781513
2953,1500000US131210108005,131210108005,"Block Group 5, Census Tract 108, Fulton County, Georgia",355,355,0,0.0
2954,1500000US131210108006,131210108006,"Block Group 6, Census Tract 108, Fulton County, Georgia",1309,949,360,27.5019098549
2955,1500000US131210110001,131210110001,"Block Group 1, Census Tract 110, Fulton County, Georgia",682,357,325,47.6539589443
2956,1500000US131210110002,131210110002,"Block Group 2, Census Tract 110, Fulton County, Georgia",1076,935,141,13.1040892193
2957,1500000US131210110003,131210110003,"Block Group 3, Census Tract 110, Fulton County, Georgia",931,931,0,0.0
2958,1500000US131210110004,131210110004,"Block Group 4, Census Tract 110, Fulton County, Georgia",408,241,167,40.931372549
2959,1500000US131210111001,131210111001,"Block Group 1, Census Tract 111, Fulton County, Georgia",658,642,16,2.43161094225
2960,1500000US131210111002,131210111002,"Block Group 2, Census Tract 111, Fulton County, Georgia",1100,1087,13,1.18181818182
2961,1500000US131210111003,131210111003,"Block Group 3, Census Tract 111, Fulton County, Georgia",551,437,114,20.6896551724
2962,1500000US131210112011,131210112011,"Block Group 1, Census Tract 112.01, Fulton County, Georgia",1422,1394,28,1.96905766526
2963,1500000US131210112012,131210112012,"Block Group 2, Census Tract 112.01, Fulton County, Georgia",1286,1247,39,3.03265940902
2964,1500000US131210112013,131210112013,"Block Group 3, Census Tract 112.01, Fulton County, Georgia",1458,1398,60,4.11522633745
2965,1500000US131210112021,131210112021,"Block Group 1, Census Tract 112.02, Fulton County, Georgia",388,363,25,6.44329896907
2966,1500000US131210112022,131210112022,"Block Group 2, Census Tract 112.02, Fulton County, Georgia",568,568,0,0.0
2967,1500000US131210112023,131210112023,"Block Group 3, Census Tract 112.02, Fulton County, Georgia",1052,558,494,46.9581749049
2968,1500000US131210112024,131210112024,"Block Group 4, Census Tract 112.02, Fulton County, Georgia",698,636,62,8.88252148997
2969,1500000US131210112025,131210112025,"Block Group 5, Census Tract 112.02, Fulton County, Georgia",1465,1200,265,18.0887372014
2970,1500000US131210112026,131210112026,"Block Group 6, Census Tract 112.02, Fulton County, Georgia",699,655,44,6.29470672389
2971,1500000US131210113011,131210113011,"Block Group 1, Census Tract 113.01, Fulton County, Georgia",733,666,67,9.14051841746
2972,1500000US131210113012,131210113012,"Block Group 2, Census Tract 113.01, Fulton County, Georgia",512,323,189,36.9140625
2973,1500000US131210113013,131210113013,"Block Group 3, Census Tract 113.01, Fulton County, Georgia",296,296,0,0.0
2974,1500000US131210113014,131210113014,"Block Group 4, Census Tract 113.01, Fulton County, Georgia",1242,1238,4,0.322061191626
2975,1500000US131210113015,131210113015,"Block Group 5, Census Tract 113.01, Fulton County, Georgia",701,547,154,21.9686162625
2976,1500000US131210113016,131210113016,"Block Group 6, Census Tract 113.01, Fulton County, Georgia",985,745,240,24.3654822335
2977,1500000US131210113031,131210113031,"Block Group 1, Census Tract 113.03, Fulton County, Georgia",3749,3579,170,4.53454254468
2978,1500000US131210113032,131210113032,"Block Group 2, Census Tract 113.03, Fulton County, Georgia",1139,1139,0,0.0
2979,1500000US131210113033,131210113033,"Block Group 3, Census Tract 113.03, Fulton County, Georgia",500,500,0,0.0
2980,1500000US131210113034,131210113034,"Block Group 4, Census Tract 113.03, Fulton County, Georgia",613,156,457,74.5513866232
2981,1500000US131210113035,131210113035,"Block Group 5, Census Tract 113.03, Fulton County, Georgia",3109,2428,681,21.9041492441
2982,1500000US131210113051,131210113051,"Block Group 1, Census Tract 113.05, Fulton County, Georgia",1129,1129,0,0.0
2983,1500000US131210113052,131210113052,"Block Group 2, Census Tract 113.05, Fulton County, Georgia",2369,2334,35,1.47741663149
2984,1500000US131210113053,131210113053,"Block Group 3, Census Tract 113.05, Fulton County, Georgia",1645,1637,8,0.48632218845
2985,1500000US131210113061,131210113061,"Block Group 1, Census Tract 113.06, Fulton County, Georgia",1307,1281,26,1.98928844682
2986,1500000US131210113062,131210113062,"Block Group 2, Census Tract 113.06, Fulton County, Georgia",1129,1057,72,6.37732506643
2987,1500000US131210114051,131210114051,"Block Group 1, Census Tract 114.05, Fulton County, Georgia",1771,1749,22,1.24223602484
2988,1500000US131210114052,131210114052,"Block Group 2, Census Tract 114.05, Fulton County, Georgia",1036,795,241,23.2625482625
2989,1500000US131210114053,131210114053,"Block Group 3, Census Tract 114.05, Fulton County, Georgia",2344,880,1464,62.457337884
2990,1500000US131210114054,131210114054,"Block Group 4, Census Tract 114.05, Fulton County, Georgia",2735,2171,564,20.6215722121
2991,1500000US131210114101,131210114101,"Block Group 1, Census Tract 114.10, Fulton County, Georgia",2514,2434,80,3.18217979316
2992,1500000US131210114102,131210114102,"Block Group 2, Census Tract 114.10, Fulton County, Georgia",2106,2082,24,1.1396011396
2993,1500000US131210114103,131210114103,"Block Group 3, Census Tract 114.10, Fulton County, Georgia",2076,2021,55,2.6493256262
2994,1500000US131210114111,131210114111,"Block Group 1, Census Tract 114.11, Fulton County, Georgia",2605,2429,176,6.75623800384
2995,1500000US131210114112,131210114112,"Block Group 2, Census Tract 114.11, Fulton County, Georgia",765,765,0,0.0
2996,1500000US131210114113,131210114113,"Block Group 3, Census Tract 114.11, Fulton County, Georgia",2666,1849,817,30.6451612903
2997,1500000US131210114114,131210114114,"Block Group 4, Census Tract 114.11, Fulton County, Georgia",1001,1001,0,0.0
2998,1500000US131210114115,131210114115,"Block Group 5, Census Tract 114.11, Fulton County, Georgia",1359,1174,185,13.612950699
2999,1500000US131210114121,131210114121,"Block Group 1, Census Tract 114.12, Fulton County, Georgia",4063,3502,561,13.8075313808
3000,1500000US131210114122,131210114122,"Block Group 2, Census Tract 114.12, Fulton County, Georgia",1924,1672,252,13.0977130977
3001,1500000US131210114123,131210114123,"Block Group 3, Census Tract 114.12, Fulton County, Georgia",3327,3023,304,9.13736098587
3002,1500000US131210114141,131210114141,"Block Group 1, Census Tract 114.14, Fulton County, Georgia",2174,1714,460,21.1591536339
3003,1500000US131210114142,131210114142,"Block Group 2, Census Tract 114.14, Fulton County, Georgia",1251,1234,17,1.3589128697
3004,1500000US131210114143,131210114143,"Block Group 3, Census Tract 114.14, Fulton County, Georgia",1970,1889,81,4.1116751269
3005,1500000US131210114144,131210114144,"Block Group 4, Census Tract 114.14, Fulton County, Georgia",2148,2047,101,4.70204841713
3006,1500000US131210114161,131210114161,"Block Group 1, Census Tract 114.16, Fulton County, Georgia",1984,1884,100,5.04032258065
3007,1500000US131210114162,131210114162,"Block Group 2, Census Tract 114.16, Fulton County, Georgia",2187,1998,189,8.64197530864
3008,1500000US131210114163,131210114163,"Block Group 3, Census Tract 114.16, Fulton County, Georgia",1085,1054,31,2.85714285714
3009,1500000US131210114171,131210114171,"Block Group 1, Census Tract 114.17, Fulton County, Georgia",1021,919,102,9.99020568071
3010,1500000US131210114172,131210114172,"Block Group 2, Census Tract 114.17, Fulton County, Georgia",1527,1520,7,0.458415193189
3011,1500000US131210114173,131210114173,"Block Group 3, Census Tract 114.17, Fulton County, Georgia",1639,1412,227,13.8499084808
3012,1500000US131210114174,131210114174,"Block Group 4, Census Tract 114.17, Fulton County, Georgia",609,581,28,4.59770114943
3013,1500000US131210114181,131210114181,"Block Group 1, Census Tract 114.18, Fulton County, Georgia",854,854,0,0.0
3014,1500000US131210114182,131210114182,"Block Group 2, Census Tract 114.18, Fulton County, Georgia",511,511,0,0.0
3015,1500000US131210114183,131210114183,"Block Group 3, Census Tract 114.18, Fulton County, Georgia",1134,1134,0,0.0
3016,1500000US131210114184,131210114184,"Block Group 4, Census Tract 114.18, Fulton County, Georgia",3810,3736,74,1.94225721785
3017,1500000US131210114191,131210114191,"Block Group 1, Census Tract 114.19, Fulton County, Georgia",1484,1325,159,10.7142857143
3018,1500000US131210114192,131210114192,"Block Group 2, Census Tract 114.19, Fulton County, Georgia",1919,1845,74,3.85617509119
3019,1500000US131210114193,131210114193,"Block Group 3, Census Tract 114.19, Fulton County, Georgia",2235,2205,30,1.34228187919
3020,1500000US131210114201,131210114201,"Block Group 1, Census Tract 114.20, Fulton County, Georgia",1576,1029,547,34.7081218274
3021,1500000US131210114202,131210114202,"Block Group 2, Census Tract 114.20, Fulton County, Georgia",3989,1226,2763,69.2654800702
3022,1500000US131210114203,131210114203,"Block Group 3, Census Tract 114.20, Fulton County, Georgia",2261,685,1576,69.7036709421
3023,1500000US131210114211,131210114211,"Block Group 1, Census Tract 114.21, Fulton County, Georgia",2274,1632,642,28.2321899736
3024,1500000US131210114212,131210114212,"Block Group 2, Census Tract 114.21, Fulton County, Georgia",1569,1009,560,35.6915232632
3025,1500000US131210114221,131210114221,"Block Group 1, Census Tract 114.22, Fulton County, Georgia",3156,2879,277,8.77693282636
3026,1500000US131210114222,131210114222,"Block Group 2, Census Tract 114.22, Fulton County, Georgia",1043,994,49,4.69798657718
3027,1500000US131210114231,131210114231,"Block Group 1, Census Tract 114.23, Fulton County, Georgia",1110,1110,0,0.0
3028,1500000US131210114232,131210114232,"Block Group 2, Census Tract 114.23, Fulton County, Georgia",1495,1375,120,8.02675585284
3029,1500000US131210114233,131210114233,"Block Group 3, Census Tract 114.23, Fulton County, Georgia",1427,1398,29,2.032235459
3030,1500000US131210114234,131210114234,"Block Group 4, Census Tract 114.23, Fulton County, Georgia",962,961,1,0.10395010395
3031,1500000US131210114241,131210114241,"Block Group 1, Census Tract 114.24, Fulton County, Georgia",3680,3521,159,4.32065217391
3032,1500000US131210114242,131210114242,"Block Group 2, Census Tract 114.24, Fulton County, Georgia",1995,1877,118,5.91478696742
3033,1500000US131210114251,131210114251,"Block Group 1, Census Tract 114.25, Fulton County, Georgia",2279,2261,18,0.789820096534
3034,1500000US131210114252,131210114252,"Block Group 2, Census Tract 114.25, Fulton County, Georgia",3037,2992,45,1.48172538689
3035,1500000US131210114253,131210114253,"Block Group 3, Census Tract 114.25, Fulton County, Georgia",1922,1817,105,5.46305931322
3036,1500000US131210114261,131210114261,"Block Group 1, Census Tract 114.26, Fulton County, Georgia",2555,2029,526,20.5870841487
3037,1500000US131210114271,131210114271,"Block Group 1, Census Tract 114.27, Fulton County, Georgia",2468,2312,156,6.3209076175
3038,1500000US131210114272,131210114272,"Block Group 2, Census Tract 114.27, Fulton County, Georgia",3025,2791,234,7.73553719008
3039,1500000US131210114273,131210114273,"Block Group 3, Census Tract 114.27, Fulton County, Georgia",2309,2200,109,4.72065829363
3040,1500000US131210115031,131210115031,"Block Group 1, Census Tract 115.03, Fulton County, Georgia",2036,2036,0,0.0
3041,1500000US131210115032,131210115032,"Block Group 2, Census Tract 115.03, Fulton County, Georgia",2095,2095,0,0.0
3042,1500000US131210115033,131210115033,"Block Group 3, Census Tract 115.03, Fulton County, Georgia",5914,5504,410,6.9327020629
3043,1500000US131210115041,131210115041,"Block Group 1, Census Tract 115.04, Fulton County, Georgia",3411,3162,249,7.29991204925
3044,1500000US131210115042,131210115042,"Block Group 2, Census Tract 115.04, Fulton County, Georgia",2225,2207,18,0.808988764045
3045,1500000US131210115043,131210115043,"Block Group 3, Census Tract 115.04, Fulton County, Georgia",4255,3711,544,12.7849588719
3046,1500000US131210115044,131210115044,"Block Group 4, Census Tract 115.04, Fulton County, Georgia",2930,2848,82,2.79863481229
3047,1500000US131210115051,131210115051,"Block Group 1, Census Tract 115.05, Fulton County, Georgia",2664,2549,115,4.31681681682
3048,1500000US131210115052,131210115052,"Block Group 2, Census Tract 115.05, Fulton County, Georgia",1967,1855,112,5.69395017794
3049,1500000US131210115061,131210115061,"Block Group 1, Census Tract 115.06, Fulton County, Georgia",1953,1953,0,0.0
3050,1500000US131210115062,131210115062,"Block Group 2, Census Tract 115.06, Fulton County, Georgia",2790,2699,91,3.26164874552
3051,1500000US131210115063,131210115063,"Block Group 3, Census Tract 115.06, Fulton County, Georgia",1594,1594,0,0.0
3052,1500000US131210116101,131210116101,"Block Group 1, Census Tract 116.10, Fulton County, Georgia",2822,2724,98,3.47271438696
3053,1500000US131210116102,131210116102,"Block Group 2, Census Tract 116.10, Fulton County, Georgia",3028,2827,201,6.63804491413
3054,1500000US131210116111,131210116111,"Block Group 1, Census Tract 116.11, Fulton County, Georgia",2665,2478,187,7.01688555347
3055,1500000US131210116112,131210116112,"Block Group 2, Census Tract 116.11, Fulton County, Georgia",1395,1372,23,1.64874551971
3056,1500000US131210116113,131210116113,"Block Group 3, Census Tract 116.11, Fulton County, Georgia",3137,2126,1011,32.2282435448
3057,1500000US131210116121,131210116121,"Block Group 1, Census Tract 116.12, Fulton County, Georgia",2534,2417,117,4.61720599842
3058,1500000US131210116122,131210116122,"Block Group 2, Census Tract 116.12, Fulton County, Georgia",847,847,0,0.0
3059,1500000US131210116131,131210116131,"Block Group 1, Census Tract 116.13, Fulton County, Georgia",3677,3139,538,14.631493065
3060,1500000US131210116132,131210116132,"Block Group 2, Census Tract 116.13, Fulton County, Georgia",3242,3202,40,1.23380629241
3061,1500000US131210116141,131210116141,"Block Group 1, Census Tract 116.14, Fulton County, Georgia",2896,2720,176,6.0773480663
3062,1500000US131210116142,131210116142,"Block Group 2, Census Tract 116.14, Fulton County, Georgia",5129,4286,843,16.4359524274
3063,1500000US131210116143,131210116143,"Block Group 3, Census Tract 116.14, Fulton County, Georgia",6452,5474,978,15.1580905146
3064,1500000US131210116151,131210116151,"Block Group 1, Census Tract 116.15, Fulton County, Georgia",3881,3780,101,2.60242205617
3065,1500000US131210116152,131210116152,"Block Group 2, Census Tract 116.15, Fulton County, Georgia",2023,1915,108,5.33860603065
3066,1500000US131210116153,131210116153,"Block Group 3, Census Tract 116.15, Fulton County, Georgia",4074,3711,363,8.91016200295
3067,1500000US131210116161,131210116161,"Block Group 1, Census Tract 116.16, Fulton County, Georgia",2068,1737,331,16.0058027079
3068,1500000US131210116162,131210116162,"Block Group 2, Census Tract 116.16, Fulton County, Georgia",1696,1397,299,17.6297169811
3069,1500000US131210116163,131210116163,"Block Group 3, Census Tract 116.16, Fulton County, Georgia",1180,1147,33,2.79661016949
3070,1500000US131210116171,131210116171,"Block Group 1, Census Tract 116.17, Fulton County, Georgia",2625,2513,112,4.26666666667
3071,1500000US131210116172,131210116172,"Block Group 2, Census Tract 116.17, Fulton County, Georgia",2447,2387,60,2.4519820188
3072,1500000US131210116173,131210116173,"Block Group 3, Census Tract 116.17, Fulton County, Georgia",2606,2511,95,3.64543361474
3073,1500000US131210116181,131210116181,"Block Group 1, Census Tract 116.18, Fulton County, Georgia",4426,4268,158,3.56981473113
3074,1500000US131210116191,131210116191,"Block Group 1, Census Tract 116.19, Fulton County, Georgia",2791,2523,268,9.60229308492
3075,1500000US131210116192,131210116192,"Block Group 2, Census Tract 116.19, Fulton County, Georgia",2382,2062,320,13.4340890008
3076,1500000US131210116193,131210116193,"Block Group 3, Census Tract 116.19, Fulton County, Georgia",3221,2863,358,11.1145606954
3077,1500000US131210116201,131210116201,"Block Group 1, Census Tract 116.20, Fulton County, Georgia",3201,3113,88,2.74914089347
3078,1500000US131210116202,131210116202,"Block Group 2, Census Tract 116.20, Fulton County, Georgia",4329,4271,58,1.3398013398
3079,1500000US131210116203,131210116203,"Block Group 3, Census Tract 116.20, Fulton County, Georgia",3104,2317,787,25.3543814433
3080,1500000US131210116211,131210116211,"Block Group 1, Census Tract 116.21, Fulton County, Georgia",828,768,60,7.24637681159
3081,1500000US131210116212,131210116212,"Block Group 2, Census Tract 116.21, Fulton County, Georgia",2359,1963,396,16.7867740568
3082,1500000US131210116213,131210116213,"Block Group 3, Census Tract 116.21, Fulton County, Georgia",4031,3911,120,2.97692880179
3083,1500000US131210116221,131210116221,"Block Group 1, Census Tract 116.22, Fulton County, Georgia",3922,3724,198,5.04844467109
3084,1500000US131210116222,131210116222,"Block Group 2, Census Tract 116.22, Fulton County, Georgia",3196,3056,140,4.38047559449
3085,1500000US131210116223,131210116223,"Block Group 3, Census Tract 116.22, Fulton County, Georgia",2896,2896,0,0.0
3086,1500000US131210116231,131210116231,"Block Group 1, Census Tract 116.23, Fulton County, Georgia",3451,3290,161,4.66531440162
3087,1500000US131210116232,131210116232,"Block Group 2, Census Tract 116.23, Fulton County, Georgia",4570,4396,174,3.80743982495
3088,1500000US131210116233,131210116233,"Block Group 3, Census Tract 116.23, Fulton County, Georgia",1035,986,49,4.73429951691
3089,1500000US131210116234,131210116234,"Block Group 4, Census Tract 116.23, Fulton County, Georgia",2945,2945,0,0.0
3090,1500000US131210116241,131210116241,"Block Group 1, Census Tract 116.24, Fulton County, Georgia",2535,2494,41,1.61735700197
3091,1500000US131210116242,131210116242,"Block Group 2, Census Tract 116.24, Fulton County, Georgia",1766,1717,49,2.77463193658
3092,1500000US131210116251,131210116251,"Block Group 1, Census Tract 116.25, Fulton County, Georgia",2646,2541,105,3.96825396825
3093,1500000US131210116252,131210116252,"Block Group 2, Census Tract 116.25, Fulton County, Georgia",2011,1895,116,5.7682744903
3094,1500000US131210116253,131210116253,"Block Group 3, Census Tract 116.25, Fulton County, Georgia",2937,2913,24,0.817160367722
3095,1500000US131210116261,131210116261,"Block Group 1, Census Tract 116.26, Fulton County, Georgia",5100,4394,706,13.8431372549
3096,1500000US131210116262,131210116262,"Block Group 2, Census Tract 116.26, Fulton County, Georgia",4199,4017,182,4.33436532508
3097,1500000US131210118001,131210118001,"Block Group 1, Census Tract 118, Fulton County, Georgia",290,290,0,0.0
3098,1500000US131210118002,131210118002,"Block Group 2, Census Tract 118, Fulton County, Georgia",1894,1844,50,2.6399155227
3099,1500000US131210118003,131210118003,"Block Group 3, Census Tract 118, Fulton County, Georgia",708,583,125,17.6553672316
3100,1500000US131210119001,131210119001,"Block Group 1, Census Tract 119, Fulton County, Georgia",1174,1165,9,0.76660988075
3101,1500000US131210119002,131210119002,"Block Group 2, Census Tract 119, Fulton County, Georgia",1992,1863,129,6.47590361446
3102,1500000US131210120001,131210120001,"Block Group 1, Census Tract 120, Fulton County, Georgia",1383,1337,46,3.32610267534
3103,1500000US131210120002,131210120002,"Block Group 2, Census Tract 120, Fulton County, Georgia",1386,1380,6,0.4329004329
3104,1500000US131210123001,131210123001,"Block Group 1, Census Tract 123, Fulton County, Georgia",974,974,0,0.0
3105,1500000US131210123002,131210123002,"Block Group 2, Census Tract 123, Fulton County, Georgia",834,656,178,21.3429256595
3106,1500000US131210123003,131210123003,"Block Group 3, Census Tract 123, Fulton County, Georgia",656,624,32,4.87804878049
3107,1500000US131219800001,131219800001,"Block Group 1, Census Tract 9800, Fulton County, Georgia",0,0,0,
3108,1500000US131230801001,131230801001,"Block Group 1, Census Tract 801, Gilmer County, Georgia",1762,1754,8,0.454029511918
3109,1500000US131230801002,131230801002,"Block Group 2, Census Tract 801, Gilmer County, Georgia",1427,1245,182,12.7540294324
3110,1500000US131230801003,131230801003,"Block Group 3, Census Tract 801, Gilmer County, Georgia",818,798,20,2.44498777506
3111,1500000US131230802001,131230802001,"Block Group 1, Census Tract 802, Gilmer County, Georgia",1182,1182,0,0.0
3112,1500000US131230802002,131230802002,"Block Group 2, Census Tract 802, Gilmer County, Georgia",2144,2120,24,1.11940298507
3113,1500000US131230802003,131230802003,"Block Group 3, Census Tract 802, Gilmer County, Georgia",2389,2058,331,13.855169527
3114,1500000US131230803001,131230803001,"Block Group 1, Census Tract 803, Gilmer County, Georgia",1457,951,506,34.7288949897
3115,1500000US131230803002,131230803002,"Block Group 2, Census Tract 803, Gilmer County, Georgia",1556,748,808,51.9280205656
3116,1500000US131230803003,131230803003,"Block Group 3, Census Tract 803, Gilmer County, Georgia",1545,1545,0,0.0
3117,1500000US131230803004,131230803004,"Block Group 4, Census Tract 803, Gilmer County, Georgia",2157,1884,273,12.6564673157
3118,1500000US131230804001,131230804001,"Block Group 1, Census Tract 804, Gilmer County, Georgia",2943,2551,392,13.3197417601
3119,1500000US131230804002,131230804002,"Block Group 2, Census Tract 804, Gilmer County, Georgia",2972,2659,313,10.531628533
3120,1500000US131230804003,131230804003,"Block Group 3, Census Tract 804, Gilmer County, Georgia",2446,2354,92,3.76124284546
3121,1500000US131230805001,131230805001,"Block Group 1, Census Tract 805, Gilmer County, Georgia",729,729,0,0.0
3122,1500000US131230805002,131230805002,"Block Group 2, Census Tract 805, Gilmer County, Georgia",1649,1619,30,1.8192844148
3123,1500000US131230805003,131230805003,"Block Group 3, Census Tract 805, Gilmer County, Georgia",1497,1410,87,5.81162324649
3124,1500000US131250101001,131250101001,"Block Group 1, Census Tract 101, Glascock County, Georgia",1214,1214,0,0.0
3125,1500000US131250101002,131250101002,"Block Group 2, Census Tract 101, Glascock County, Georgia",946,925,21,2.21987315011
3126,1500000US131250101003,131250101003,"Block Group 3, Census Tract 101, Glascock County, Georgia",927,900,27,2.91262135922
3127,1500000US131270001011,131270001011,"Block Group 1, Census Tract 1.01, Glynn County, Georgia",677,677,0,0.0
3128,1500000US131270001012,131270001012,"Block Group 2, Census Tract 1.01, Glynn County, Georgia",544,544,0,0.0
3129,1500000US131270001021,131270001021,"Block Group 1, Census Tract 1.02, Glynn County, Georgia",1753,1699,54,3.0804335425
3130,1500000US131270001022,131270001022,"Block Group 2, Census Tract 1.02, Glynn County, Georgia",744,744,0,0.0
3131,1500000US131270001023,131270001023,"Block Group 3, Census Tract 1.02, Glynn County, Georgia",977,889,88,9.00716479017
3132,1500000US131270002001,131270002001,"Block Group 1, Census Tract 2, Glynn County, Georgia",1448,1413,35,2.41712707182
3133,1500000US131270002002,131270002002,"Block Group 2, Census Tract 2, Glynn County, Georgia",1797,1787,10,0.556483027268
3134,1500000US131270002003,131270002003,"Block Group 3, Census Tract 2, Glynn County, Georgia",1664,1594,70,4.20673076923
3135,1500000US131270003001,131270003001,"Block Group 1, Census Tract 3, Glynn County, Georgia",2477,2452,25,1.00928542592
3136,1500000US131270003002,131270003002,"Block Group 2, Census Tract 3, Glynn County, Georgia",1045,1022,23,2.2009569378
3137,1500000US131270003003,131270003003,"Block Group 3, Census Tract 3, Glynn County, Georgia",2164,2027,137,6.33086876155
3138,1500000US131270003004,131270003004,"Block Group 4, Census Tract 3, Glynn County, Georgia",630,609,21,3.33333333333
3139,1500000US131270004011,131270004011,"Block Group 1, Census Tract 4.01, Glynn County, Georgia",3757,3502,255,6.78733031674
3140,1500000US131270004012,131270004012,"Block Group 2, Census Tract 4.01, Glynn County, Georgia",1079,1079,0,0.0
3141,1500000US131270004013,131270004013,"Block Group 3, Census Tract 4.01, Glynn County, Georgia",3114,2881,233,7.48233782916
3142,1500000US131270004031,131270004031,"Block Group 1, Census Tract 4.03, Glynn County, Georgia",1619,1515,104,6.42371834466
3143,1500000US131270004032,131270004032,"Block Group 2, Census Tract 4.03, Glynn County, Georgia",1521,1500,21,1.38067061144
3144,1500000US131270004041,131270004041,"Block Group 1, Census Tract 4.04, Glynn County, Georgia",948,948,0,0.0
3145,1500000US131270004042,131270004042,"Block Group 2, Census Tract 4.04, Glynn County, Georgia",5291,4745,546,10.3194103194
3146,1500000US131270004043,131270004043,"Block Group 3, Census Tract 4.04, Glynn County, Georgia",5484,5200,284,5.17870167761
3147,1500000US131270005011,131270005011,"Block Group 1, Census Tract 5.01, Glynn County, Georgia",675,675,0,0.0
3148,1500000US131270005012,131270005012,"Block Group 2, Census Tract 5.01, Glynn County, Georgia",2061,1721,340,16.4968461912
3149,1500000US131270005013,131270005013,"Block Group 3, Census Tract 5.01, Glynn County, Georgia",1162,1154,8,0.688468158348
3150,1500000US131270005031,131270005031,"Block Group 1, Census Tract 5.03, Glynn County, Georgia",1046,1002,44,4.20650095602
3151,1500000US131270005032,131270005032,"Block Group 2, Census Tract 5.03, Glynn County, Georgia",1129,1042,87,7.70593445527
3152,1500000US131270005033,131270005033,"Block Group 3, Census Tract 5.03, Glynn County, Georgia",1818,1535,283,15.5665566557
3153,1500000US131270005041,131270005041,"Block Group 1, Census Tract 5.04, Glynn County, Georgia",607,557,50,8.23723228995
3154,1500000US131270005042,131270005042,"Block Group 2, Census Tract 5.04, Glynn County, Georgia",983,813,170,17.2939979654
3155,1500000US131270005043,131270005043,"Block Group 3, Census Tract 5.04, Glynn County, Georgia",1863,1799,64,3.43531937735
3156,1500000US131270006001,131270006001,"Block Group 1, Census Tract 6, Glynn County, Georgia",1509,1495,14,0.927766732936
3157,1500000US131270006002,131270006002,"Block Group 2, Census Tract 6, Glynn County, Georgia",1604,1448,156,9.72568578554
3158,1500000US131270006003,131270006003,"Block Group 3, Census Tract 6, Glynn County, Georgia",1133,988,145,12.7978817299
3159,1500000US131270006004,131270006004,"Block Group 4, Census Tract 6, Glynn County, Georgia",1522,1522,0,0.0
3160,1500000US131270007001,131270007001,"Block Group 1, Census Tract 7, Glynn County, Georgia",2461,2397,64,2.60056887444
3161,1500000US131270007002,131270007002,"Block Group 2, Census Tract 7, Glynn County, Georgia",992,992,0,0.0
3162,1500000US131270007003,131270007003,"Block Group 3, Census Tract 7, Glynn County, Georgia",852,852,0,0.0
3163,1500000US131270007004,131270007004,"Block Group 4, Census Tract 7, Glynn County, Georgia",1213,1213,0,0.0
3164,1500000US131270007005,131270007005,"Block Group 5, Census Tract 7, Glynn County, Georgia",666,666,0,0.0
3165,1500000US131270007006,131270007006,"Block Group 6, Census Tract 7, Glynn County, Georgia",582,348,234,40.206185567
3166,1500000US131270007007,131270007007,"Block Group 7, Census Tract 7, Glynn County, Georgia",334,334,0,0.0
3167,1500000US131270007008,131270007008,"Block Group 8, Census Tract 7, Glynn County, Georgia",690,690,0,0.0
3168,1500000US131270008001,131270008001,"Block Group 1, Census Tract 8, Glynn County, Georgia",890,832,58,6.51685393258
3169,1500000US131270008002,131270008002,"Block Group 2, Census Tract 8, Glynn County, Georgia",1355,1355,0,0.0
3170,1500000US131270008003,131270008003,"Block Group 3, Census Tract 8, Glynn County, Georgia",854,854,0,0.0
3171,1500000US131270008004,131270008004,"Block Group 4, Census Tract 8, Glynn County, Georgia",1011,977,34,3.36300692384
3172,1500000US131270009001,131270009001,"Block Group 1, Census Tract 9, Glynn County, Georgia",597,591,6,1.00502512563
3173,1500000US131270009002,131270009002,"Block Group 2, Census Tract 9, Glynn County, Georgia",470,459,11,2.34042553191
3174,1500000US131270009003,131270009003,"Block Group 3, Census Tract 9, Glynn County, Georgia",901,593,308,34.1842397336
3175,1500000US131270009004,131270009004,"Block Group 4, Census Tract 9, Glynn County, Georgia",1388,731,657,47.3342939481
3176,1500000US131270009005,131270009005,"Block Group 5, Census Tract 9, Glynn County, Georgia",1179,1040,139,11.7896522477
3177,1500000US131270010001,131270010001,"Block Group 1, Census Tract 10, Glynn County, Georgia",588,571,17,2.89115646259
3178,1500000US131270010002,131270010002,"Block Group 2, Census Tract 10, Glynn County, Georgia",2552,2462,90,3.52664576803
3179,1500000US131270010003,131270010003,"Block Group 3, Census Tract 10, Glynn County, Georgia",2216,2056,160,7.2202166065
3180,1500000US131270010004,131270010004,"Block Group 4, Census Tract 10, Glynn County, Georgia",4107,3757,350,8.52203554906
3181,1500000US131279900000,131279900000,"Block Group 0, Census Tract 9900, Glynn County, Georgia",0,0,0,
3182,1500000US131299701001,131299701001,"Block Group 1, Census Tract 9701, Gordon County, Georgia",1256,1237,19,1.5127388535
3183,1500000US131299701002,131299701002,"Block Group 2, Census Tract 9701, Gordon County, Georgia",1501,1501,0,0.0
3184,1500000US131299701003,131299701003,"Block Group 3, Census Tract 9701, Gordon County, Georgia",3554,3159,395,11.1142374789
3185,1500000US131299702001,131299702001,"Block Group 1, Census Tract 9702, Gordon County, Georgia",1364,1356,8,0.58651026393
3186,1500000US131299702002,131299702002,"Block Group 2, Census Tract 9702, Gordon County, Georgia",1304,1274,30,2.30061349693
3187,1500000US131299702003,131299702003,"Block Group 3, Census Tract 9702, Gordon County, Georgia",2429,2282,147,6.05187319885
3188,1500000US131299702004,131299702004,"Block Group 4, Census Tract 9702, Gordon County, Georgia",2036,2036,0,0.0
3189,1500000US131299703001,131299703001,"Block Group 1, Census Tract 9703, Gordon County, Georgia",1102,985,117,10.6170598911
3190,1500000US131299703002,131299703002,"Block Group 2, Census Tract 9703, Gordon County, Georgia",2705,2447,258,9.53789279113
3191,1500000US131299703003,131299703003,"Block Group 3, Census Tract 9703, Gordon County, Georgia",4281,2473,1808,42.2331231021
3192,1500000US131299703004,131299703004,"Block Group 4, Census Tract 9703, Gordon County, Georgia",1116,876,240,21.5053763441
3193,1500000US131299704001,131299704001,"Block Group 1, Census Tract 9704, Gordon County, Georgia",2451,2248,203,8.28233374133
3194,1500000US131299704002,131299704002,"Block Group 2, Census Tract 9704, Gordon County, Georgia",1518,1380,138,9.09090909091
3195,1500000US131299704003,131299704003,"Block Group 3, Census Tract 9704, Gordon County, Georgia",1008,764,244,24.2063492063
3196,1500000US131299705001,131299705001,"Block Group 1, Census Tract 9705, Gordon County, Georgia",2031,1371,660,32.4963072378
3197,1500000US131299705002,131299705002,"Block Group 2, Census Tract 9705, Gordon County, Georgia",1326,960,366,27.6018099548
3198,1500000US131299705003,131299705003,"Block Group 3, Census Tract 9705, Gordon County, Georgia",1410,742,668,47.3758865248
3199,1500000US131299706001,131299706001,"Block Group 1, Census Tract 9706, Gordon County, Georgia",645,367,278,43.1007751938
3200,1500000US131299706002,131299706002,"Block Group 2, Census Tract 9706, Gordon County, Georgia",2211,1700,511,23.1117141565
3201,1500000US131299706003,131299706003,"Block Group 3, Census Tract 9706, Gordon County, Georgia",3642,2050,1592,43.7122460187
3202,1500000US131299707001,131299707001,"Block Group 1, Census Tract 9707, Gordon County, Georgia",1682,1597,85,5.05350772889
3203,1500000US131299707002,131299707002,"Block Group 2, Census Tract 9707, Gordon County, Georgia",902,902,0,0.0
3204,1500000US131299707003,131299707003,"Block Group 3, Census Tract 9707, Gordon County, Georgia",1680,1673,7,0.416666666667
3205,1500000US131299708001,131299708001,"Block Group 1, Census Tract 9708, Gordon County, Georgia",1160,1099,61,5.25862068966
3206,1500000US131299708002,131299708002,"Block Group 2, Census Tract 9708, Gordon County, Georgia",1900,1676,224,11.7894736842
3207,1500000US131299708003,131299708003,"Block Group 3, Census Tract 9708, Gordon County, Georgia",2775,2731,44,1.58558558559
3208,1500000US131299709001,131299709001,"Block Group 1, Census Tract 9709, Gordon County, Georgia",1650,1647,3,0.181818181818
3209,1500000US131299709002,131299709002,"Block Group 2, Census Tract 9709, Gordon County, Georgia",1408,1331,77,5.46875
3210,1500000US131299709003,131299709003,"Block Group 3, Census Tract 9709, Gordon County, Georgia",3842,3738,104,2.70692347736
3211,1500000US131319501001,131319501001,"Block Group 1, Census Tract 9501, Grady County, Georgia",1311,1199,112,8.54309687262
3212,1500000US131319501002,131319501002,"Block Group 2, Census Tract 9501, Grady County, Georgia",823,823,0,0.0
3213,1500000US131319502001,131319502001,"Block Group 1, Census Tract 9502, Grady County, Georgia",1440,1438,2,0.138888888889
3214,1500000US131319502002,131319502002,"Block Group 2, Census Tract 9502, Grady County, Georgia",1361,1360,1,0.0734753857458
3215,1500000US131319503001,131319503001,"Block Group 1, Census Tract 9503, Grady County, Georgia",1729,1618,111,6.41989589358
3216,1500000US131319503002,131319503002,"Block Group 2, Census Tract 9503, Grady County, Georgia",1172,1097,75,6.39931740614
3217,1500000US131319503003,131319503003,"Block Group 3, Census Tract 9503, Grady County, Georgia",643,643,0,0.0
3218,1500000US131319503004,131319503004,"Block Group 4, Census Tract 9503, Grady County, Georgia",865,865,0,0.0
3219,1500000US131319504001,131319504001,"Block Group 1, Census Tract 9504, Grady County, Georgia",2412,2276,136,5.63847429519
3220,1500000US131319504002,131319504002,"Block Group 2, Census Tract 9504, Grady County, Georgia",1774,1774,0,0.0
3221,1500000US131319504003,131319504003,"Block Group 3, Census Tract 9504, Grady County, Georgia",1802,780,1022,56.7147613762
3222,1500000US131319504004,131319504004,"Block Group 4, Census Tract 9504, Grady County, Georgia",673,392,281,41.7533432392
3223,1500000US131319505001,131319505001,"Block Group 1, Census Tract 9505, Grady County, Georgia",2680,2387,293,10.9328358209
3224,1500000US131319505002,131319505002,"Block Group 2, Census Tract 9505, Grady County, Georgia",1215,748,467,38.4362139918
3225,1500000US131319505003,131319505003,"Block Group 3, Census Tract 9505, Grady County, Georgia",1573,1573,0,0.0
3226,1500000US131319505004,131319505004,"Block Group 4, Census Tract 9505, Grady County, Georgia",1439,1439,0,0.0
3227,1500000US131319506001,131319506001,"Block Group 1, Census Tract 9506, Grady County, Georgia",2331,2177,154,6.60660660661
3228,1500000US131339501001,131339501001,"Block Group 1, Census Tract 9501, Greene County, Georgia",1154,1136,18,1.55979202773
3229,1500000US131339501002,131339501002,"Block Group 2, Census Tract 9501, Greene County, Georgia",1116,1116,0,0.0
3230,1500000US131339502001,131339502001,"Block Group 1, Census Tract 9502, Greene County, Georgia",775,769,6,0.774193548387
3231,1500000US131339502002,131339502002,"Block Group 2, Census Tract 9502, Greene County, Georgia",795,758,37,4.65408805031
3232,1500000US131339502003,131339502003,"Block Group 3, Census Tract 9502, Greene County, Georgia",583,583,0,0.0
3233,1500000US131339503011,131339503011,"Block Group 1, Census Tract 9503.01, Greene County, Georgia",849,832,17,2.0023557126
3234,1500000US131339503012,131339503012,"Block Group 2, Census Tract 9503.01, Greene County, Georgia",718,718,0,0.0
3235,1500000US131339503013,131339503013,"Block Group 3, Census Tract 9503.01, Greene County, Georgia",472,442,30,6.35593220339
3236,1500000US131339503014,131339503014,"Block Group 4, Census Tract 9503.01, Greene County, Georgia",371,354,17,4.58221024259
3237,1500000US131339503021,131339503021,"Block Group 1, Census Tract 9503.02, Greene County, Georgia",1771,1764,7,0.395256916996
3238,1500000US131339503022,131339503022,"Block Group 2, Census Tract 9503.02, Greene County, Georgia",755,746,9,1.19205298013
3239,1500000US131339503031,131339503031,"Block Group 1, Census Tract 9503.03, Greene County, Georgia",800,654,146,18.25
3240,1500000US131339503032,131339503032,"Block Group 2, Census Tract 9503.03, Greene County, Georgia",1418,1035,383,27.0098730606
3241,1500000US131339503033,131339503033,"Block Group 3, Census Tract 9503.03, Greene County, Georgia",1514,1189,325,21.4663143989
3242,1500000US131339503034,131339503034,"Block Group 4, Census Tract 9503.03, Greene County, Georgia",237,237,0,0.0
3243,1500000US131339503035,131339503035,"Block Group 5, Census Tract 9503.03, Greene County, Georgia",278,278,0,0.0
3244,1500000US131339504001,131339504001,"Block Group 1, Census Tract 9504, Greene County, Georgia",1325,1325,0,0.0
3245,1500000US131339505001,131339505001,"Block Group 1, Census Tract 9505, Greene County, Georgia",637,620,17,2.66875981162
3246,1500000US131339505002,131339505002,"Block Group 2, Census Tract 9505, Greene County, Georgia",763,763,0,0.0
3247,1500000US131350501031,131350501031,"Block Group 1, Census Tract 501.03, Gwinnett County, Georgia",4562,3991,571,12.5164401578
3248,1500000US131350501032,131350501032,"Block Group 2, Census Tract 501.03, Gwinnett County, Georgia",1565,1140,425,27.1565495208
3249,1500000US131350501033,131350501033,"Block Group 3, Census Tract 501.03, Gwinnett County, Georgia",4397,3104,1293,29.4064134637
3250,1500000US131350501051,131350501051,"Block Group 1, Census Tract 501.05, Gwinnett County, Georgia",571,571,0,0.0
3251,1500000US131350501052,131350501052,"Block Group 2, Census Tract 501.05, Gwinnett County, Georgia",1320,730,590,44.696969697
3252,1500000US131350501053,131350501053,"Block Group 3, Census Tract 501.05, Gwinnett County, Georgia",1934,1111,823,42.5542916236
3253,1500000US131350501061,131350501061,"Block Group 1, Census Tract 501.06, Gwinnett County, Georgia",5090,3280,1810,35.5599214145
3254,1500000US131350501062,131350501062,"Block Group 2, Census Tract 501.06, Gwinnett County, Georgia",1644,1644,0,0.0
3255,1500000US131350501063,131350501063,"Block Group 3, Census Tract 501.06, Gwinnett County, Georgia",2149,1678,471,21.9171707771
3256,1500000US131350501064,131350501064,"Block Group 4, Census Tract 501.06, Gwinnett County, Georgia",2560,912,1648,64.375
3257,1500000US131350501071,131350501071,"Block Group 1, Census Tract 501.07, Gwinnett County, Georgia",7312,6508,804,10.9956236324
3258,1500000US131350501081,131350501081,"Block Group 1, Census Tract 501.08, Gwinnett County, Georgia",6628,6385,243,3.66626433313
3259,1500000US131350501082,131350501082,"Block Group 2, Census Tract 501.08, Gwinnett County, Georgia",3007,2270,737,24.5094778849
3260,1500000US131350501091,131350501091,"Block Group 1, Census Tract 501.09, Gwinnett County, Georgia",2966,2534,432,14.5650708024
3261,1500000US131350501092,131350501092,"Block Group 2, Census Tract 501.09, Gwinnett County, Georgia",4911,4378,533,10.8531867237
3262,1500000US131350502051,131350502051,"Block Group 1, Census Tract 502.05, Gwinnett County, Georgia",2535,2169,366,14.4378698225
3263,1500000US131350502052,131350502052,"Block Group 2, Census Tract 502.05, Gwinnett County, Georgia",1724,1656,68,3.94431554524
3264,1500000US131350502081,131350502081,"Block Group 1, Census Tract 502.08, Gwinnett County, Georgia",3294,2989,305,9.25925925926
3265,1500000US131350502082,131350502082,"Block Group 2, Census Tract 502.08, Gwinnett County, Georgia",3277,2095,1182,36.0695758316
3266,1500000US131350502091,131350502091,"Block Group 1, Census Tract 502.09, Gwinnett County, Georgia",4434,3941,493,11.1186287776
3267,1500000US131350502092,131350502092,"Block Group 2, Census Tract 502.09, Gwinnett County, Georgia",2737,2124,613,22.3967848009
3268,1500000US131350502093,131350502093,"Block Group 3, Census Tract 502.09, Gwinnett County, Georgia",2858,2358,500,17.4947515745
3269,1500000US131350502101,131350502101,"Block Group 1, Census Tract 502.10, Gwinnett County, Georgia",3045,2032,1013,33.2676518883
3270,1500000US131350502102,131350502102,"Block Group 2, Census Tract 502.10, Gwinnett County, Georgia",3881,3648,233,6.0036073177
3271,1500000US131350502111,131350502111,"Block Group 1, Census Tract 502.11, Gwinnett County, Georgia",1351,402,949,70.2442635085
3272,1500000US131350502112,131350502112,"Block Group 2, Census Tract 502.11, Gwinnett County, Georgia",1087,532,555,51.0579576817
3273,1500000US131350502113,131350502113,"Block Group 3, Census Tract 502.11, Gwinnett County, Georgia",2814,2115,699,24.8400852878
3274,1500000US131350502121,131350502121,"Block Group 1, Census Tract 502.12, Gwinnett County, Georgia",3116,3116,0,0.0
3275,1500000US131350502122,131350502122,"Block Group 2, Census Tract 502.12, Gwinnett County, Georgia",2652,2409,243,9.1628959276
3276,1500000US131350502123,131350502123,"Block Group 3, Census Tract 502.12, Gwinnett County, Georgia",6965,6615,350,5.02512562814
3277,1500000US131350502131,131350502131,"Block Group 1, Census Tract 502.13, Gwinnett County, Georgia",5111,4950,161,3.15006847975
3278,1500000US131350502132,131350502132,"Block Group 2, Census Tract 502.13, Gwinnett County, Georgia",7897,6886,1011,12.8023299987
3279,1500000US131350502141,131350502141,"Block Group 1, Census Tract 502.14, Gwinnett County, Georgia",2210,2174,36,1.62895927602
3280,1500000US131350502142,131350502142,"Block Group 2, Census Tract 502.14, Gwinnett County, Georgia",4908,4571,337,6.8663406683
3281,1500000US131350502143,131350502143,"Block Group 3, Census Tract 502.14, Gwinnett County, Georgia",1637,1488,149,9.10201588271
3282,1500000US131350502151,131350502151,"Block Group 1, Census Tract 502.15, Gwinnett County, Georgia",3380,3287,93,2.75147928994
3283,1500000US131350502161,131350502161,"Block Group 1, Census Tract 502.16, Gwinnett County, Georgia",2471,2290,181,7.32496964792
3284,1500000US131350502162,131350502162,"Block Group 2, Census Tract 502.16, Gwinnett County, Georgia",2795,2795,0,0.0
3285,1500000US131350502163,131350502163,"Block Group 3, Census Tract 502.16, Gwinnett County, Georgia",3758,3527,231,6.14688664183
3286,1500000US131350502171,131350502171,"Block Group 1, Census Tract 502.17, Gwinnett County, Georgia",8288,7658,630,7.60135135135
3287,1500000US131350502172,131350502172,"Block Group 2, Census Tract 502.17, Gwinnett County, Georgia",1873,1847,26,1.38814735718
3288,1500000US131350502181,131350502181,"Block Group 1, Census Tract 502.18, Gwinnett County, Georgia",2463,1233,1230,49.9390986602
3289,1500000US131350502182,131350502182,"Block Group 2, Census Tract 502.18, Gwinnett County, Georgia",1493,1174,319,21.3663764233
3290,1500000US131350502191,131350502191,"Block Group 1, Census Tract 502.19, Gwinnett County, Georgia",849,836,13,1.53121319199
3291,1500000US131350502192,131350502192,"Block Group 2, Census Tract 502.19, Gwinnett County, Georgia",2918,2721,197,6.75119945168
3292,1500000US131350502201,131350502201,"Block Group 1, Census Tract 502.20, Gwinnett County, Georgia",2130,1717,413,19.3896713615
3293,1500000US131350502202,131350502202,"Block Group 2, Census Tract 502.20, Gwinnett County, Georgia",2990,2663,327,10.9364548495
3294,1500000US131350502203,131350502203,"Block Group 3, Census Tract 502.20, Gwinnett County, Georgia",1115,904,211,18.9237668161
3295,1500000US131350503041,131350503041,"Block Group 1, Census Tract 503.04, Gwinnett County, Georgia",2501,1208,1293,51.6993202719
3296,1500000US131350503042,131350503042,"Block Group 2, Census Tract 503.04, Gwinnett County, Georgia",1629,776,853,52.3634131369
3297,1500000US131350503043,131350503043,"Block Group 3, Census Tract 503.04, Gwinnett County, Georgia",889,727,162,18.2227221597
3298,1500000US131350503061,131350503061,"Block Group 1, Census Tract 503.06, Gwinnett County, Georgia",2717,1021,1696,62.4217887376
3299,1500000US131350503062,131350503062,"Block Group 2, Census Tract 503.06, Gwinnett County, Georgia",2151,613,1538,71.5016271502
3300,1500000US131350503081,131350503081,"Block Group 1, Census Tract 503.08, Gwinnett County, Georgia",2037,1982,55,2.7000490918
3301,1500000US131350503082,131350503082,"Block Group 2, Census Tract 503.08, Gwinnett County, Georgia",1890,1858,32,1.69312169312
3302,1500000US131350503091,131350503091,"Block Group 1, Census Tract 503.09, Gwinnett County, Georgia",2074,1974,100,4.82160077146
3303,1500000US131350503092,131350503092,"Block Group 2, Census Tract 503.09, Gwinnett County, Georgia",2038,2019,19,0.932286555447
3304,1500000US131350503093,131350503093,"Block Group 3, Census Tract 503.09, Gwinnett County, Georgia",1666,1601,65,3.90156062425
3305,1500000US131350503094,131350503094,"Block Group 4, Census Tract 503.09, Gwinnett County, Georgia",2338,2192,146,6.24465355004
3306,1500000US131350503101,131350503101,"Block Group 1, Census Tract 503.10, Gwinnett County, Georgia",2026,1901,125,6.16979269497
3307,1500000US131350503102,131350503102,"Block Group 2, Census Tract 503.10, Gwinnett County, Georgia",739,709,30,4.05953991881
3308,1500000US131350503103,131350503103,"Block Group 3, Census Tract 503.10, Gwinnett County, Georgia",2564,2298,266,10.3744149766
3309,1500000US131350503111,131350503111,"Block Group 1, Census Tract 503.11, Gwinnett County, Georgia",1907,1851,56,2.93654955427
3310,1500000US131350503112,131350503112,"Block Group 2, Census Tract 503.11, Gwinnett County, Georgia",825,656,169,20.4848484848
3311,1500000US131350503131,131350503131,"Block Group 1, Census Tract 503.13, Gwinnett County, Georgia",1827,623,1204,65.9003831418
3312,1500000US131350503132,131350503132,"Block Group 2, Census Tract 503.13, Gwinnett County, Georgia",1895,1383,512,27.018469657
3313,1500000US131350503133,131350503133,"Block Group 3, Census Tract 503.13, Gwinnett County, Georgia",820,746,74,9.0243902439
3314,1500000US131350503134,131350503134,"Block Group 4, Census Tract 503.13, Gwinnett County, Georgia",982,754,228,23.2179226069
3315,1500000US131350503135,131350503135,"Block Group 5, Census Tract 503.13, Gwinnett County, Georgia",1044,957,87,8.33333333333
3316,1500000US131350503136,131350503136,"Block Group 6, Census Tract 503.13, Gwinnett County, Georgia",1533,1134,399,26.0273972603
3317,1500000US131350503141,131350503141,"Block Group 1, Census Tract 503.14, Gwinnett County, Georgia",2706,1601,1105,40.8351810791
3318,1500000US131350503142,131350503142,"Block Group 2, Census Tract 503.14, Gwinnett County, Georgia",4831,3105,1726,35.7275926309
3319,1500000US131350503143,131350503143,"Block Group 3, Census Tract 503.14, Gwinnett County, Georgia",1391,878,513,36.8799424874
3320,1500000US131350503144,131350503144,"Block Group 4, Census Tract 503.14, Gwinnett County, Georgia",1169,918,251,21.4713430282
3321,1500000US131350503151,131350503151,"Block Group 1, Census Tract 503.15, Gwinnett County, Georgia",1534,1447,87,5.67144719687
3322,1500000US131350503152,131350503152,"Block Group 2, Census Tract 503.15, Gwinnett County, Georgia",3476,2064,1412,40.6214039125
3323,1500000US131350503153,131350503153,"Block Group 3, Census Tract 503.15, Gwinnett County, Georgia",714,701,13,1.82072829132
3324,1500000US131350503171,131350503171,"Block Group 1, Census Tract 503.17, Gwinnett County, Georgia",390,355,35,8.97435897436
3325,1500000US131350503172,131350503172,"Block Group 2, Census Tract 503.17, Gwinnett County, Georgia",2086,1088,998,47.8427612656
3326,1500000US131350503173,131350503173,"Block Group 3, Census Tract 503.17, Gwinnett County, Georgia",1217,711,506,41.5776499589
3327,1500000US131350503181,131350503181,"Block Group 1, Census Tract 503.18, Gwinnett County, Georgia",1905,1799,106,5.56430446194
3328,1500000US131350503182,131350503182,"Block Group 2, Census Tract 503.18, Gwinnett County, Georgia",1088,560,528,48.5294117647
3329,1500000US131350503191,131350503191,"Block Group 1, Census Tract 503.19, Gwinnett County, Georgia",3564,1088,2476,69.4725028058
3330,1500000US131350503192,131350503192,"Block Group 2, Census Tract 503.19, Gwinnett County, Georgia",2861,1222,1639,57.2876616568
3331,1500000US131350503201,131350503201,"Block Group 1, Census Tract 503.20, Gwinnett County, Georgia",1801,972,829,46.0299833426
3332,1500000US131350503202,131350503202,"Block Group 2, Census Tract 503.20, Gwinnett County, Georgia",3167,1314,1853,58.5096305652
3333,1500000US131350503203,131350503203,"Block Group 3, Census Tract 503.20, Gwinnett County, Georgia",1283,484,799,62.2759158223
3334,1500000US131350503211,131350503211,"Block Group 1, Census Tract 503.21, Gwinnett County, Georgia",2079,2045,34,1.6354016354
3335,1500000US131350503212,131350503212,"Block Group 2, Census Tract 503.21, Gwinnett County, Georgia",2424,2289,135,5.56930693069
3336,1500000US131350503221,131350503221,"Block Group 1, Census Tract 503.22, Gwinnett County, Georgia",1164,1164,0,0.0
3337,1500000US131350503222,131350503222,"Block Group 2, Census Tract 503.22, Gwinnett County, Georgia",2623,2594,29,1.10560426992
3338,1500000US131350503223,131350503223,"Block Group 3, Census Tract 503.22, Gwinnett County, Georgia",949,949,0,0.0
3339,1500000US131350504101,131350504101,"Block Group 1, Census Tract 504.10, Gwinnett County, Georgia",1826,1035,791,43.3187294633
3340,1500000US131350504102,131350504102,"Block Group 2, Census Tract 504.10, Gwinnett County, Georgia",2675,1575,1100,41.1214953271
3341,1500000US131350504103,131350504103,"Block Group 3, Census Tract 504.10, Gwinnett County, Georgia",1271,1066,205,16.1290322581
3342,1500000US131350504151,131350504151,"Block Group 1, Census Tract 504.15, Gwinnett County, Georgia",874,827,47,5.37757437071
3343,1500000US131350504152,131350504152,"Block Group 2, Census Tract 504.15, Gwinnett County, Georgia",1135,1112,23,2.02643171806
3344,1500000US131350504153,131350504153,"Block Group 3, Census Tract 504.15, Gwinnett County, Georgia",1646,1631,15,0.911300121507
3345,1500000US131350504161,131350504161,"Block Group 1, Census Tract 504.16, Gwinnett County, Georgia",2832,2347,485,17.1257062147
3346,1500000US131350504162,131350504162,"Block Group 2, Census Tract 504.16, Gwinnett County, Georgia",693,693,0,0.0
3347,1500000US131350504171,131350504171,"Block Group 1, Census Tract 504.17, Gwinnett County, Georgia",2437,789,1648,67.6241280263
3348,1500000US131350504172,131350504172,"Block Group 2, Census Tract 504.17, Gwinnett County, Georgia",1494,318,1176,78.7148594378
3349,1500000US131350504173,131350504173,"Block Group 3, Census Tract 504.17, Gwinnett County, Georgia",2095,1275,820,39.1408114558
3350,1500000US131350504181,131350504181,"Block Group 1, Census Tract 504.18, Gwinnett County, Georgia",3046,2012,1034,33.9461588969
3351,1500000US131350504182,131350504182,"Block Group 2, Census Tract 504.18, Gwinnett County, Georgia",2562,872,1690,65.9640905543
3352,1500000US131350504183,131350504183,"Block Group 3, Census Tract 504.18, Gwinnett County, Georgia",1646,382,1264,76.7922235723
3353,1500000US131350504191,131350504191,"Block Group 1, Census Tract 504.19, Gwinnett County, Georgia",2342,775,1567,66.9086251067
3354,1500000US131350504192,131350504192,"Block Group 2, Census Tract 504.19, Gwinnett County, Georgia",2654,2038,616,23.2102486812
3355,1500000US131350504193,131350504193,"Block Group 3, Census Tract 504.19, Gwinnett County, Georgia",2903,1696,1207,41.5776782639
3356,1500000US131350504211,131350504211,"Block Group 1, Census Tract 504.21, Gwinnett County, Georgia",2909,1565,1344,46.2014437951
3357,1500000US131350504212,131350504212,"Block Group 2, Census Tract 504.21, Gwinnett County, Georgia",1218,699,519,42.6108374384
3358,1500000US131350504213,131350504213,"Block Group 3, Census Tract 504.21, Gwinnett County, Georgia",3171,2091,1080,34.0586565752
3359,1500000US131350504221,131350504221,"Block Group 1, Census Tract 504.22, Gwinnett County, Georgia",1945,987,958,49.2544987147
3360,1500000US131350504222,131350504222,"Block Group 2, Census Tract 504.22, Gwinnett County, Georgia",2418,1143,1275,52.729528536
3361,1500000US131350504223,131350504223,"Block Group 3, Census Tract 504.22, Gwinnett County, Georgia",4135,1536,2599,62.853688029
3362,1500000US131350504231,131350504231,"Block Group 1, Census Tract 504.23, Gwinnett County, Georgia",2621,1865,756,28.8439526898
3363,1500000US131350504232,131350504232,"Block Group 2, Census Tract 504.23, Gwinnett County, Georgia",2380,1483,897,37.6890756303
3364,1500000US131350504233,131350504233,"Block Group 3, Census Tract 504.23, Gwinnett County, Georgia",2325,1416,909,39.0967741935
3365,1500000US131350504241,131350504241,"Block Group 1, Census Tract 504.24, Gwinnett County, Georgia",2332,935,1397,59.9056603774
3366,1500000US131350504242,131350504242,"Block Group 2, Census Tract 504.24, Gwinnett County, Georgia",3930,1955,1975,50.2544529262
3367,1500000US131350504243,131350504243,"Block Group 3, Census Tract 504.24, Gwinnett County, Georgia",1649,788,861,52.2134627047
3368,1500000US131350504251,131350504251,"Block Group 1, Census Tract 504.25, Gwinnett County, Georgia",1356,1348,8,0.589970501475
3369,1500000US131350504252,131350504252,"Block Group 2, Census Tract 504.25, Gwinnett County, Georgia",1633,1512,121,7.40967544397
3370,1500000US131350504253,131350504253,"Block Group 3, Census Tract 504.25, Gwinnett County, Georgia",2459,2251,208,8.45872305815
3371,1500000US131350504261,131350504261,"Block Group 1, Census Tract 504.26, Gwinnett County, Georgia",1722,1486,236,13.7049941928
3372,1500000US131350504262,131350504262,"Block Group 2, Census Tract 504.26, Gwinnett County, Georgia",760,760,0,0.0
3373,1500000US131350504263,131350504263,"Block Group 3, Census Tract 504.26, Gwinnett County, Georgia",928,928,0,0.0
3374,1500000US131350504264,131350504264,"Block Group 4, Census Tract 504.26, Gwinnett County, Georgia",1599,1444,155,9.69355847405
3375,1500000US131350504265,131350504265,"Block Group 5, Census Tract 504.26, Gwinnett County, Georgia",1807,1807,0,0.0
3376,1500000US131350504271,131350504271,"Block Group 1, Census Tract 504.27, Gwinnett County, Georgia",3194,2637,557,17.4389480276
3377,1500000US131350504272,131350504272,"Block Group 2, Census Tract 504.27, Gwinnett County, Georgia",2031,1830,201,9.89660265879
3378,1500000US131350504273,131350504273,"Block Group 3, Census Tract 504.27, Gwinnett County, Georgia",1073,1056,17,1.58434296365
3379,1500000US131350504281,131350504281,"Block Group 1, Census Tract 504.28, Gwinnett County, Georgia",1695,1551,144,8.49557522124
3380,1500000US131350504282,131350504282,"Block Group 2, Census Tract 504.28, Gwinnett County, Georgia",1092,1071,21,1.92307692308
3381,1500000US131350504283,131350504283,"Block Group 3, Census Tract 504.28, Gwinnett County, Georgia",2339,2267,72,3.07823856349
3382,1500000US131350504284,131350504284,"Block Group 4, Census Tract 504.28, Gwinnett County, Georgia",1645,1377,268,16.2917933131
3383,1500000US131350504291,131350504291,"Block Group 1, Census Tract 504.29, Gwinnett County, Georgia",2348,2237,111,4.72742759796
3384,1500000US131350504292,131350504292,"Block Group 2, Census Tract 504.29, Gwinnett County, Georgia",3166,2844,322,10.1705622236
3385,1500000US131350504293,131350504293,"Block Group 3, Census Tract 504.29, Gwinnett County, Georgia",1790,1565,225,12.5698324022
3386,1500000US131350504301,131350504301,"Block Group 1, Census Tract 504.30, Gwinnett County, Georgia",1452,1289,163,11.2258953168
3387,1500000US131350504302,131350504302,"Block Group 2, Census Tract 504.30, Gwinnett County, Georgia",1327,1000,327,24.6420497362
3388,1500000US131350504303,131350504303,"Block Group 3, Census Tract 504.30, Gwinnett County, Georgia",2675,2539,136,5.08411214953
3389,1500000US131350504311,131350504311,"Block Group 1, Census Tract 504.31, Gwinnett County, Georgia",1067,557,510,47.7975632615
3390,1500000US131350504312,131350504312,"Block Group 2, Census Tract 504.31, Gwinnett County, Georgia",3099,2280,819,26.4278799613
3391,1500000US131350504313,131350504313,"Block Group 3, Census Tract 504.31, Gwinnett County, Georgia",4231,3329,902,21.3188371543
3392,1500000US131350504321,131350504321,"Block Group 1, Census Tract 504.32, Gwinnett County, Georgia",1382,751,631,45.6584659913
3393,1500000US131350504322,131350504322,"Block Group 2, Census Tract 504.32, Gwinnett County, Georgia",1860,1535,325,17.4731182796
3394,1500000US131350504323,131350504323,"Block Group 3, Census Tract 504.32, Gwinnett County, Georgia",2824,2380,444,15.7223796034
3395,1500000US131350504331,131350504331,"Block Group 1, Census Tract 504.33, Gwinnett County, Georgia",2337,1494,843,36.0718870347
3396,1500000US131350504341,131350504341,"Block Group 1, Census Tract 504.34, Gwinnett County, Georgia",2005,939,1066,53.1670822943
3397,1500000US131350504342,131350504342,"Block Group 2, Census Tract 504.34, Gwinnett County, Georgia",4658,1561,3097,66.4877629884
3398,1500000US131350504343,131350504343,"Block Group 3, Census Tract 504.34, Gwinnett County, Georgia",1251,599,652,52.1183053557
3399,1500000US131350504351,131350504351,"Block Group 1, Census Tract 504.35, Gwinnett County, Georgia",2451,1255,1196,48.7964096287
3400,1500000US131350504352,131350504352,"Block Group 2, Census Tract 504.35, Gwinnett County, Georgia",1072,915,157,14.6455223881
3401,1500000US131350504361,131350504361,"Block Group 1, Census Tract 504.36, Gwinnett County, Georgia",1351,1139,212,15.6920799408
3402,1500000US131350504362,131350504362,"Block Group 2, Census Tract 504.36, Gwinnett County, Georgia",1544,856,688,44.5595854922
3403,1500000US131350504363,131350504363,"Block Group 3, Census Tract 504.36, Gwinnett County, Georgia",1394,1164,230,16.4992826399
3404,1500000US131350504364,131350504364,"Block Group 4, Census Tract 504.36, Gwinnett County, Georgia",856,676,180,21.0280373832
3405,1500000US131350504365,131350504365,"Block Group 5, Census Tract 504.36, Gwinnett County, Georgia",1454,621,833,57.2902338377
3406,1500000US131350505111,131350505111,"Block Group 1, Census Tract 505.11, Gwinnett County, Georgia",2537,2223,314,12.3768230193
3407,1500000US131350505112,131350505112,"Block Group 2, Census Tract 505.11, Gwinnett County, Georgia",3386,2518,868,25.6349675133
3408,1500000US131350505113,131350505113,"Block Group 3, Census Tract 505.11, Gwinnett County, Georgia",5268,2580,2688,51.0250569476
3409,1500000US131350505201,131350505201,"Block Group 1, Census Tract 505.20, Gwinnett County, Georgia",1811,1373,438,24.1855328548
3410,1500000US131350505202,131350505202,"Block Group 2, Census Tract 505.20, Gwinnett County, Georgia",1315,1012,303,23.0418250951
3411,1500000US131350505203,131350505203,"Block Group 3, Census Tract 505.20, Gwinnett County, Georgia",1718,1571,147,8.55646100116
3412,1500000US131350505211,131350505211,"Block Group 1, Census Tract 505.21, Gwinnett County, Georgia",733,563,170,23.1923601637
3413,1500000US131350505212,131350505212,"Block Group 2, Census Tract 505.21, Gwinnett County, Georgia",1471,992,479,32.5628823929
3414,1500000US131350505213,131350505213,"Block Group 3, Census Tract 505.21, Gwinnett County, Georgia",1952,1547,405,20.7479508197
3415,1500000US131350505214,131350505214,"Block Group 4, Census Tract 505.21, Gwinnett County, Georgia",1382,979,403,29.1606367583
3416,1500000US131350505221,131350505221,"Block Group 1, Census Tract 505.22, Gwinnett County, Georgia",1305,1086,219,16.7816091954
3417,1500000US131350505222,131350505222,"Block Group 2, Census Tract 505.22, Gwinnett County, Georgia",4029,3169,860,21.3452469595
3418,1500000US131350505231,131350505231,"Block Group 1, Census Tract 505.23, Gwinnett County, Georgia",3229,2787,442,13.688448436
3419,1500000US131350505232,131350505232,"Block Group 2, Census Tract 505.23, Gwinnett County, Georgia",943,937,6,0.636267232238
3420,1500000US131350505233,131350505233,"Block Group 3, Census Tract 505.23, Gwinnett County, Georgia",2844,1724,1120,39.3811533052
3421,1500000US131350505241,131350505241,"Block Group 1, Census Tract 505.24, Gwinnett County, Georgia",3168,1853,1315,41.5088383838
3422,1500000US131350505242,131350505242,"Block Group 2, Census Tract 505.24, Gwinnett County, Georgia",2994,1471,1523,50.8684034736
3423,1500000US131350505251,131350505251,"Block Group 1, Census Tract 505.25, Gwinnett County, Georgia",2435,1907,528,21.6837782341
3424,1500000US131350505252,131350505252,"Block Group 2, Census Tract 505.25, Gwinnett County, Georgia",1626,1375,251,15.4366543665
3425,1500000US131350505253,131350505253,"Block Group 3, Census Tract 505.25, Gwinnett County, Georgia",2677,2402,275,10.2726933134
3426,1500000US131350505254,131350505254,"Block Group 4, Census Tract 505.25, Gwinnett County, Georgia",1465,1394,71,4.84641638225
3427,1500000US131350505261,131350505261,"Block Group 1, Census Tract 505.26, Gwinnett County, Georgia",3045,1437,1608,52.8078817734
3428,1500000US131350505262,131350505262,"Block Group 2, Census Tract 505.26, Gwinnett County, Georgia",1796,1265,531,29.565701559
3429,1500000US131350505271,131350505271,"Block Group 1, Census Tract 505.27, Gwinnett County, Georgia",2385,1893,492,20.6289308176
3430,1500000US131350505272,131350505272,"Block Group 2, Census Tract 505.27, Gwinnett County, Georgia",2239,1851,388,17.3291648057
3431,1500000US131350505273,131350505273,"Block Group 3, Census Tract 505.27, Gwinnett County, Georgia",1726,1543,183,10.6025492468
3432,1500000US131350505281,131350505281,"Block Group 1, Census Tract 505.28, Gwinnett County, Georgia",3367,3079,288,8.55360855361
3433,1500000US131350505282,131350505282,"Block Group 2, Census Tract 505.28, Gwinnett County, Georgia",1863,1625,238,12.7750939345
3434,1500000US131350505291,131350505291,"Block Group 1, Census Tract 505.29, Gwinnett County, Georgia",2487,2304,183,7.35826296743
3435,1500000US131350505292,131350505292,"Block Group 2, Census Tract 505.29, Gwinnett County, Georgia",1528,1159,369,24.1492146597
3436,1500000US131350505301,131350505301,"Block Group 1, Census Tract 505.30, Gwinnett County, Georgia",4082,3790,292,7.15335619794
3437,1500000US131350505302,131350505302,"Block Group 2, Census Tract 505.30, Gwinnett County, Georgia",1296,1207,89,6.86728395062
3438,1500000US131350505303,131350505303,"Block Group 3, Census Tract 505.30, Gwinnett County, Georgia",682,672,10,1.46627565982
3439,1500000US131350505311,131350505311,"Block Group 1, Census Tract 505.31, Gwinnett County, Georgia",2928,2127,801,27.356557377
3440,1500000US131350505312,131350505312,"Block Group 2, Census Tract 505.31, Gwinnett County, Georgia",2252,1121,1131,50.2220248668
3441,1500000US131350505313,131350505313,"Block Group 3, Census Tract 505.31, Gwinnett County, Georgia",3492,2015,1477,42.2966781214
3442,1500000US131350505321,131350505321,"Block Group 1, Census Tract 505.32, Gwinnett County, Georgia",3842,3274,568,14.783966684
3443,1500000US131350505322,131350505322,"Block Group 2, Census Tract 505.32, Gwinnett County, Georgia",4096,3423,673,16.4306640625
3444,1500000US131350505331,131350505331,"Block Group 1, Census Tract 505.33, Gwinnett County, Georgia",1837,1554,283,15.4055525313
3445,1500000US131350505332,131350505332,"Block Group 2, Census Tract 505.33, Gwinnett County, Georgia",4290,2660,1630,37.9953379953
3446,1500000US131350505333,131350505333,"Block Group 3, Census Tract 505.33, Gwinnett County, Georgia",1839,887,952,51.7672648178
3447,1500000US131350505341,131350505341,"Block Group 1, Census Tract 505.34, Gwinnett County, Georgia",3977,2297,1680,42.2428966558
3448,1500000US131350505342,131350505342,"Block Group 2, Census Tract 505.34, Gwinnett County, Georgia",2076,1398,678,32.6589595376
3449,1500000US131350505343,131350505343,"Block Group 3, Census Tract 505.34, Gwinnett County, Georgia",2322,1651,671,28.8975021533
3450,1500000US131350505351,131350505351,"Block Group 1, Census Tract 505.35, Gwinnett County, Georgia",3055,2257,798,26.1211129296
3451,1500000US131350505352,131350505352,"Block Group 2, Census Tract 505.35, Gwinnett County, Georgia",4083,2683,1400,34.288513348
3452,1500000US131350505361,131350505361,"Block Group 1, Census Tract 505.36, Gwinnett County, Georgia",1522,1233,289,18.988173456
3453,1500000US131350505362,131350505362,"Block Group 2, Census Tract 505.36, Gwinnett County, Georgia",1129,804,325,28.7865367582
3454,1500000US131350505363,131350505363,"Block Group 3, Census Tract 505.36, Gwinnett County, Georgia",2397,1670,727,30.32957864
3455,1500000US131350505371,131350505371,"Block Group 1, Census Tract 505.37, Gwinnett County, Georgia",1827,1141,686,37.5478927203
3456,1500000US131350505372,131350505372,"Block Group 2, Census Tract 505.37, Gwinnett County, Georgia",3008,2154,854,28.3909574468
3457,1500000US131350505381,131350505381,"Block Group 1, Census Tract 505.38, Gwinnett County, Georgia",2198,2152,46,2.09281164695
3458,1500000US131350505382,131350505382,"Block Group 2, Census Tract 505.38, Gwinnett County, Georgia",3659,2554,1105,30.1995080623
3459,1500000US131350505383,131350505383,"Block Group 3, Census Tract 505.38, Gwinnett County, Georgia",1983,1851,132,6.65658093797
3460,1500000US131350505391,131350505391,"Block Group 1, Census Tract 505.39, Gwinnett County, Georgia",3114,1672,1442,46.3070006423
3461,1500000US131350505392,131350505392,"Block Group 2, Census Tract 505.39, Gwinnett County, Georgia",1919,994,925,48.2021886399
3462,1500000US131350505401,131350505401,"Block Group 1, Census Tract 505.40, Gwinnett County, Georgia",2901,2214,687,23.6814891417
3463,1500000US131350505402,131350505402,"Block Group 2, Census Tract 505.40, Gwinnett County, Georgia",1984,1731,253,12.752016129
3464,1500000US131350505403,131350505403,"Block Group 3, Census Tract 505.40, Gwinnett County, Georgia",2159,2159,0,0.0
3465,1500000US131350505411,131350505411,"Block Group 1, Census Tract 505.41, Gwinnett County, Georgia",2176,1277,899,41.3143382353
3466,1500000US131350505412,131350505412,"Block Group 2, Census Tract 505.41, Gwinnett County, Georgia",1547,616,931,60.1809954751
3467,1500000US131350505413,131350505413,"Block Group 3, Census Tract 505.41, Gwinnett County, Georgia",2270,1164,1106,48.7224669604
3468,1500000US131350505421,131350505421,"Block Group 1, Census Tract 505.42, Gwinnett County, Georgia",4798,3690,1108,23.0929553981
3469,1500000US131350505431,131350505431,"Block Group 1, Census Tract 505.43, Gwinnett County, Georgia",3795,3418,377,9.93412384717
3470,1500000US131350505432,131350505432,"Block Group 2, Census Tract 505.43, Gwinnett County, Georgia",3337,2669,668,20.0179802218
3471,1500000US131350505441,131350505441,"Block Group 1, Census Tract 505.44, Gwinnett County, Georgia",4078,3723,355,8.70524767043
3472,1500000US131350505442,131350505442,"Block Group 2, Census Tract 505.44, Gwinnett County, Georgia",3506,3059,447,12.749572162
3473,1500000US131350505443,131350505443,"Block Group 3, Census Tract 505.44, Gwinnett County, Georgia",4308,3835,473,10.9795728877
3474,1500000US131350505451,131350505451,"Block Group 1, Census Tract 505.45, Gwinnett County, Georgia",2692,2240,452,16.7904903418
3475,1500000US131350505452,131350505452,"Block Group 2, Census Tract 505.45, Gwinnett County, Georgia",4147,2137,2010,48.4687726067
3476,1500000US131350505453,131350505453,"Block Group 3, Census Tract 505.45, Gwinnett County, Georgia",4558,4102,456,10.0043878894
3477,1500000US131350505461,131350505461,"Block Group 1, Census Tract 505.46, Gwinnett County, Georgia",10230,9024,1206,11.788856305
3478,1500000US131350505462,131350505462,"Block Group 2, Census Tract 505.46, Gwinnett County, Georgia",2949,1145,1804,61.1732790777
3479,1500000US131350505463,131350505463,"Block Group 3, Census Tract 505.46, Gwinnett County, Georgia",3678,2976,702,19.0864600326
3480,1500000US131350505471,131350505471,"Block Group 1, Census Tract 505.47, Gwinnett County, Georgia",5168,4629,539,10.4295665635
3481,1500000US131350505472,131350505472,"Block Group 2, Census Tract 505.47, Gwinnett County, Georgia",2995,2718,277,9.24874791319
3482,1500000US131350505481,131350505481,"Block Group 1, Census Tract 505.48, Gwinnett County, Georgia",4460,3634,826,18.5201793722
3483,1500000US131350505482,131350505482,"Block Group 2, Census Tract 505.48, Gwinnett County, Georgia",2627,2254,373,14.198705748
3484,1500000US131350505483,131350505483,"Block Group 3, Census Tract 505.48, Gwinnett County, Georgia",3933,3685,248,6.30561912026
3485,1500000US131350505491,131350505491,"Block Group 1, Census Tract 505.49, Gwinnett County, Georgia",3726,2999,727,19.511540526
3486,1500000US131350505492,131350505492,"Block Group 2, Census Tract 505.49, Gwinnett County, Georgia",1470,1376,94,6.39455782313
3487,1500000US131350506051,131350506051,"Block Group 1, Census Tract 506.05, Gwinnett County, Georgia",7977,6153,1824,22.8657389996
3488,1500000US131350506052,131350506052,"Block Group 2, Census Tract 506.05, Gwinnett County, Georgia",2050,2014,36,1.75609756098
3489,1500000US131350506053,131350506053,"Block Group 3, Census Tract 506.05, Gwinnett County, Georgia",4473,3321,1152,25.754527163
3490,1500000US131350506061,131350506061,"Block Group 1, Census Tract 506.06, Gwinnett County, Georgia",6434,5800,634,9.85390115014
3491,1500000US131350506062,131350506062,"Block Group 2, Census Tract 506.06, Gwinnett County, Georgia",7353,6350,1003,13.6406908745
3492,1500000US131350506063,131350506063,"Block Group 3, Census Tract 506.06, Gwinnett County, Georgia",9639,9167,472,4.89677352422
3493,1500000US131350506071,131350506071,"Block Group 1, Census Tract 506.07, Gwinnett County, Georgia",10219,9335,884,8.65055289167
3494,1500000US131350506072,131350506072,"Block Group 2, Census Tract 506.07, Gwinnett County, Georgia",6940,5514,1426,20.5475504323
3495,1500000US131350506081,131350506081,"Block Group 1, Census Tract 506.08, Gwinnett County, Georgia",8285,5886,2399,28.955944478
3496,1500000US131350506082,131350506082,"Block Group 2, Census Tract 506.08, Gwinnett County, Georgia",6437,5163,1274,19.7918284915
3497,1500000US131350506083,131350506083,"Block Group 3, Census Tract 506.08, Gwinnett County, Georgia",2633,1594,1039,39.4606912267
3498,1500000US131350506091,131350506091,"Block Group 1, Census Tract 506.09, Gwinnett County, Georgia",2052,1640,412,20.0779727096
3499,1500000US131350506092,131350506092,"Block Group 2, Census Tract 506.09, Gwinnett County, Georgia",6445,6079,366,5.67882079131
3500,1500000US131350506093,131350506093,"Block Group 3, Census Tract 506.09, Gwinnett County, Georgia",3035,2887,148,4.87644151565
3501,1500000US131350506101,131350506101,"Block Group 1, Census Tract 506.10, Gwinnett County, Georgia",5186,4772,414,7.98303123795
3502,1500000US131350506102,131350506102,"Block Group 2, Census Tract 506.10, Gwinnett County, Georgia",4387,3552,835,19.0335080921
3503,1500000US131350506103,131350506103,"Block Group 3, Census Tract 506.10, Gwinnett County, Georgia",3456,3456,0,0.0
3504,1500000US131350506104,131350506104,"Block Group 4, Census Tract 506.10, Gwinnett County, Georgia",3796,3451,345,9.0885142255
3505,1500000US131350507091,131350507091,"Block Group 1, Census Tract 507.09, Gwinnett County, Georgia",5528,4982,546,9.87698986975
3506,1500000US131350507092,131350507092,"Block Group 2, Census Tract 507.09, Gwinnett County, Georgia",2693,1792,901,33.4571110286
3507,1500000US131350507093,131350507093,"Block Group 3, Census Tract 507.09, Gwinnett County, Georgia",4377,4239,138,3.15284441398
3508,1500000US131350507121,131350507121,"Block Group 1, Census Tract 507.12, Gwinnett County, Georgia",1708,1671,37,2.1662763466
3509,1500000US131350507122,131350507122,"Block Group 2, Census Tract 507.12, Gwinnett County, Georgia",1666,1615,51,3.0612244898
3510,1500000US131350507123,131350507123,"Block Group 3, Census Tract 507.12, Gwinnett County, Georgia",2054,1366,688,33.4956183057
3511,1500000US131350507124,131350507124,"Block Group 4, Census Tract 507.12, Gwinnett County, Georgia",1351,1321,30,2.22057735011
3512,1500000US131350507131,131350507131,"Block Group 1, Census Tract 507.13, Gwinnett County, Georgia",4348,3931,417,9.59061637534
3513,1500000US131350507132,131350507132,"Block Group 2, Census Tract 507.13, Gwinnett County, Georgia",659,644,15,2.27617602428
3514,1500000US131350507133,131350507133,"Block Group 3, Census Tract 507.13, Gwinnett County, Georgia",1553,1531,22,1.41661300708
3515,1500000US131350507134,131350507134,"Block Group 4, Census Tract 507.13, Gwinnett County, Georgia",1092,1092,0,0.0
3516,1500000US131350507141,131350507141,"Block Group 1, Census Tract 507.14, Gwinnett County, Georgia",2476,2224,252,10.1777059774
3517,1500000US131350507142,131350507142,"Block Group 2, Census Tract 507.14, Gwinnett County, Georgia",2988,2818,170,5.68942436412
3518,1500000US131350507151,131350507151,"Block Group 1, Census Tract 507.15, Gwinnett County, Georgia",2844,2213,631,22.1870604782
3519,1500000US131350507152,131350507152,"Block Group 2, Census Tract 507.15, Gwinnett County, Georgia",1529,1141,388,25.3760627861
3520,1500000US131350507153,131350507153,"Block Group 3, Census Tract 507.15, Gwinnett County, Georgia",1437,1437,0,0.0
3521,1500000US131350507181,131350507181,"Block Group 1, Census Tract 507.18, Gwinnett County, Georgia",2338,2338,0,0.0
3522,1500000US131350507182,131350507182,"Block Group 2, Census Tract 507.18, Gwinnett County, Georgia",2426,2106,320,13.1904369332
3523,1500000US131350507183,131350507183,"Block Group 3, Census Tract 507.18, Gwinnett County, Georgia",530,530,0,0.0
3524,1500000US131350507184,131350507184,"Block Group 4, Census Tract 507.18, Gwinnett County, Georgia",3087,2923,164,5.31260123097
3525,1500000US131350507191,131350507191,"Block Group 1, Census Tract 507.19, Gwinnett County, Georgia",3276,2803,473,14.4383394383
3526,1500000US131350507192,131350507192,"Block Group 2, Census Tract 507.19, Gwinnett County, Georgia",2172,1894,278,12.7992633517
3527,1500000US131350507201,131350507201,"Block Group 1, Census Tract 507.20, Gwinnett County, Georgia",2014,1925,89,4.41906653426
3528,1500000US131350507202,131350507202,"Block Group 2, Census Tract 507.20, Gwinnett County, Georgia",2700,2620,80,2.96296296296
3529,1500000US131350507203,131350507203,"Block Group 3, Census Tract 507.20, Gwinnett County, Georgia",1689,1639,50,2.96033155713
3530,1500000US131350507204,131350507204,"Block Group 4, Census Tract 507.20, Gwinnett County, Georgia",1531,1443,88,5.74787720444
3531,1500000US131350507211,131350507211,"Block Group 1, Census Tract 507.21, Gwinnett County, Georgia",3164,2570,594,18.7737041719
3532,1500000US131350507212,131350507212,"Block Group 2, Census Tract 507.21, Gwinnett County, Georgia",813,726,87,10.7011070111
3533,1500000US131350507213,131350507213,"Block Group 3, Census Tract 507.21, Gwinnett County, Georgia",2637,2478,159,6.02957906712
3534,1500000US131350507214,131350507214,"Block Group 4, Census Tract 507.21, Gwinnett County, Georgia",3104,2879,225,7.24871134021
3535,1500000US131350507221,131350507221,"Block Group 1, Census Tract 507.22, Gwinnett County, Georgia",3694,2566,1128,30.5360043313
3536,1500000US131350507231,131350507231,"Block Group 1, Census Tract 507.23, Gwinnett County, Georgia",1127,1026,101,8.96184560781
3537,1500000US131350507232,131350507232,"Block Group 2, Census Tract 507.23, Gwinnett County, Georgia",3271,2990,281,8.59064506267
3538,1500000US131350507233,131350507233,"Block Group 3, Census Tract 507.23, Gwinnett County, Georgia",3035,2920,115,3.78912685338
3539,1500000US131350507241,131350507241,"Block Group 1, Census Tract 507.24, Gwinnett County, Georgia",4711,4619,92,1.95287624708
3540,1500000US131350507242,131350507242,"Block Group 2, Census Tract 507.24, Gwinnett County, Georgia",5461,5205,256,4.68778611976
3541,1500000US131350507243,131350507243,"Block Group 3, Census Tract 507.24, Gwinnett County, Georgia",5693,5175,518,9.09889337783
3542,1500000US131350507251,131350507251,"Block Group 1, Census Tract 507.25, Gwinnett County, Georgia",2460,1951,509,20.6910569106
3543,1500000US131350507252,131350507252,"Block Group 2, Census Tract 507.25, Gwinnett County, Georgia",2469,2329,140,5.67031186715
3544,1500000US131350507253,131350507253,"Block Group 3, Census Tract 507.25, Gwinnett County, Georgia",997,989,8,0.802407221665
3545,1500000US131350507261,131350507261,"Block Group 1, Census Tract 507.26, Gwinnett County, Georgia",4070,3416,654,16.0687960688
3546,1500000US131350507262,131350507262,"Block Group 2, Census Tract 507.26, Gwinnett County, Georgia",5288,4940,348,6.58093797277
3547,1500000US131350507271,131350507271,"Block Group 1, Census Tract 507.27, Gwinnett County, Georgia",2051,2051,0,0.0
3548,1500000US131350507272,131350507272,"Block Group 2, Census Tract 507.27, Gwinnett County, Georgia",4446,4266,180,4.04858299595
3549,1500000US131350507273,131350507273,"Block Group 3, Census Tract 507.27, Gwinnett County, Georgia",3993,3741,252,6.31104432757
3550,1500000US131350507281,131350507281,"Block Group 1, Census Tract 507.28, Gwinnett County, Georgia",5114,4398,716,14.0007821666
3551,1500000US131350507282,131350507282,"Block Group 2, Census Tract 507.28, Gwinnett County, Georgia",3721,3519,202,5.42864821285
3552,1500000US131350507283,131350507283,"Block Group 3, Census Tract 507.28, Gwinnett County, Georgia",3022,2972,50,1.65453342158
3553,1500000US131350507284,131350507284,"Block Group 4, Census Tract 507.28, Gwinnett County, Georgia",1879,1879,0,0.0
3554,1500000US131350507291,131350507291,"Block Group 1, Census Tract 507.29, Gwinnett County, Georgia",797,589,208,26.0978670013
3555,1500000US131350507292,131350507292,"Block Group 2, Census Tract 507.29, Gwinnett County, Georgia",2495,2394,101,4.04809619238
3556,1500000US131350507301,131350507301,"Block Group 1, Census Tract 507.30, Gwinnett County, Georgia",3827,3713,114,2.97883459629
3557,1500000US131350507302,131350507302,"Block Group 2, Census Tract 507.30, Gwinnett County, Georgia",3239,2731,508,15.6838530411
3558,1500000US131350507311,131350507311,"Block Group 1, Census Tract 507.31, Gwinnett County, Georgia",4966,4528,438,8.81997583568
3559,1500000US131350507312,131350507312,"Block Group 2, Census Tract 507.31, Gwinnett County, Georgia",4429,3880,549,12.3955746218
3560,1500000US131370001001,131370001001,"Block Group 1, Census Tract 1, Habersham County, Georgia",1491,1491,0,0.0
3561,1500000US131370001002,131370001002,"Block Group 2, Census Tract 1, Habersham County, Georgia",2338,2275,63,2.69461077844
3562,1500000US131370002011,131370002011,"Block Group 1, Census Tract 2.01, Habersham County, Georgia",1940,1712,228,11.7525773196
3563,1500000US131370002012,131370002012,"Block Group 2, Census Tract 2.01, Habersham County, Georgia",1967,1967,0,0.0
3564,1500000US131370002021,131370002021,"Block Group 1, Census Tract 2.02, Habersham County, Georgia",1201,1201,0,0.0
3565,1500000US131370002022,131370002022,"Block Group 2, Census Tract 2.02, Habersham County, Georgia",2130,2115,15,0.704225352113
3566,1500000US131370002023,131370002023,"Block Group 3, Census Tract 2.02, Habersham County, Georgia",1877,1871,6,0.319659030368
3567,1500000US131370003001,131370003001,"Block Group 1, Census Tract 3, Habersham County, Georgia",1351,939,412,30.4959289415
3568,1500000US131370003002,131370003002,"Block Group 2, Census Tract 3, Habersham County, Georgia",1364,1240,124,9.09090909091
3569,1500000US131370003003,131370003003,"Block Group 3, Census Tract 3, Habersham County, Georgia",1312,1192,120,9.14634146341
3570,1500000US131370004001,131370004001,"Block Group 1, Census Tract 4, Habersham County, Georgia",3348,2902,446,13.321385902
3571,1500000US131370004002,131370004002,"Block Group 2, Census Tract 4, Habersham County, Georgia",1190,919,271,22.7731092437
3572,1500000US131370004003,131370004003,"Block Group 3, Census Tract 4, Habersham County, Georgia",980,972,8,0.816326530612
3573,1500000US131370005001,131370005001,"Block Group 1, Census Tract 5, Habersham County, Georgia",1801,1508,293,16.2687395891
3574,1500000US131370005002,131370005002,"Block Group 2, Census Tract 5, Habersham County, Georgia",1693,1655,38,2.24453632605
3575,1500000US131370005003,131370005003,"Block Group 3, Census Tract 5, Habersham County, Georgia",1671,1553,118,7.06163973668
3576,1500000US131370005004,131370005004,"Block Group 4, Census Tract 5, Habersham County, Georgia",543,517,26,4.78821362799
3577,1500000US131370005005,131370005005,"Block Group 5, Census Tract 5, Habersham County, Georgia",898,872,26,2.89532293987
3578,1500000US131370006011,131370006011,"Block Group 1, Census Tract 6.01, Habersham County, Georgia",1798,1224,574,31.9243604004
3579,1500000US131370006012,131370006012,"Block Group 2, Census Tract 6.01, Habersham County, Georgia",3656,3456,200,5.4704595186
3580,1500000US131370006013,131370006013,"Block Group 3, Census Tract 6.01, Habersham County, Georgia",606,606,0,0.0
3581,1500000US131370006021,131370006021,"Block Group 1, Census Tract 6.02, Habersham County, Georgia",1235,1017,218,17.6518218623
3582,1500000US131370006022,131370006022,"Block Group 2, Census Tract 6.02, Habersham County, Georgia",1829,1829,0,0.0
3583,1500000US131370006023,131370006023,"Block Group 3, Census Tract 6.02, Habersham County, Georgia",2834,1362,1472,51.9407198306
3584,1500000US131370006024,131370006024,"Block Group 4, Census Tract 6.02, Habersham County, Georgia",1521,932,589,38.7245233399
3585,1500000US131370006025,131370006025,"Block Group 5, Census Tract 6.02, Habersham County, Georgia",953,316,637,66.8415529906
3586,1500000US131390001011,131390001011,"Block Group 1, Census Tract 1.01, Hall County, Georgia",1943,1873,70,3.6026762738
3587,1500000US131390001012,131390001012,"Block Group 2, Census Tract 1.01, Hall County, Georgia",2642,2319,323,12.2255866768
3588,1500000US131390001021,131390001021,"Block Group 1, Census Tract 1.02, Hall County, Georgia",2121,1878,243,11.4568599717
3589,1500000US131390001022,131390001022,"Block Group 2, Census Tract 1.02, Hall County, Georgia",1347,1244,103,7.64662212324
3590,1500000US131390002011,131390002011,"Block Group 1, Census Tract 2.01, Hall County, Georgia",2057,1897,160,7.77831793875
3591,1500000US131390002012,131390002012,"Block Group 2, Census Tract 2.01, Hall County, Georgia",1220,1196,24,1.96721311475
3592,1500000US131390002013,131390002013,"Block Group 3, Census Tract 2.01, Hall County, Georgia",2466,1571,895,36.2935928629
3593,1500000US131390002031,131390002031,"Block Group 1, Census Tract 2.03, Hall County, Georgia",2204,2200,4,0.181488203267
3594,1500000US131390002032,131390002032,"Block Group 2, Census Tract 2.03, Hall County, Georgia",2187,2187,0,0.0
3595,1500000US131390002041,131390002041,"Block Group 1, Census Tract 2.04, Hall County, Georgia",1899,1884,15,0.789889415482
3596,1500000US131390002042,131390002042,"Block Group 2, Census Tract 2.04, Hall County, Georgia",2088,1858,230,11.0153256705
3597,1500000US131390003021,131390003021,"Block Group 1, Census Tract 3.02, Hall County, Georgia",1471,1471,0,0.0
3598,1500000US131390003022,131390003022,"Block Group 2, Census Tract 3.02, Hall County, Georgia",2994,2279,715,23.8810955244
3599,1500000US131390003023,131390003023,"Block Group 3, Census Tract 3.02, Hall County, Georgia",1193,1193,0,0.0
3600,1500000US131390003024,131390003024,"Block Group 4, Census Tract 3.02, Hall County, Georgia",1194,1157,37,3.09882747069
3601,1500000US131390003031,131390003031,"Block Group 1, Census Tract 3.03, Hall County, Georgia",1978,1735,243,12.2851365015
3602,1500000US131390003032,131390003032,"Block Group 2, Census Tract 3.03, Hall County, Georgia",777,777,0,0.0
3603,1500000US131390003041,131390003041,"Block Group 1, Census Tract 3.04, Hall County, Georgia",2009,1668,341,16.9736187158
3604,1500000US131390003042,131390003042,"Block Group 2, Census Tract 3.04, Hall County, Georgia",1519,1466,53,3.48913759052
3605,1500000US131390003051,131390003051,"Block Group 1, Census Tract 3.05, Hall County, Georgia",1171,1035,136,11.6140051238
3606,1500000US131390003052,131390003052,"Block Group 2, Census Tract 3.05, Hall County, Georgia",3116,2686,430,13.7997432606
3607,1500000US131390003053,131390003053,"Block Group 3, Census Tract 3.05, Hall County, Georgia",598,598,0,0.0
3608,1500000US131390004001,131390004001,"Block Group 1, Census Tract 4, Hall County, Georgia",1884,1853,31,1.64543524416
3609,1500000US131390004002,131390004002,"Block Group 2, Census Tract 4, Hall County, Georgia",1533,1271,262,17.0906718852
3610,1500000US131390004003,131390004003,"Block Group 3, Census Tract 4, Hall County, Georgia",1484,1410,74,4.98652291105
3611,1500000US131390004004,131390004004,"Block Group 4, Census Tract 4, Hall County, Georgia",1872,1046,826,44.1239316239
3612,1500000US131390005001,131390005001,"Block Group 1, Census Tract 5, Hall County, Georgia",891,871,20,2.24466891134
3613,1500000US131390005002,131390005002,"Block Group 2, Census Tract 5, Hall County, Georgia",2067,1196,871,42.1383647799
3614,1500000US131390005003,131390005003,"Block Group 3, Census Tract 5, Hall County, Georgia",499,499,0,0.0
3615,1500000US131390005004,131390005004,"Block Group 4, Census Tract 5, Hall County, Georgia",2515,2467,48,1.90854870775
3616,1500000US131390005005,131390005005,"Block Group 5, Census Tract 5, Hall County, Georgia",1111,1024,87,7.83078307831
3617,1500000US131390006001,131390006001,"Block Group 1, Census Tract 6, Hall County, Georgia",1460,828,632,43.2876712329
3618,1500000US131390006002,131390006002,"Block Group 2, Census Tract 6, Hall County, Georgia",2313,1813,500,21.616947687
3619,1500000US131390006003,131390006003,"Block Group 3, Census Tract 6, Hall County, Georgia",2164,1878,286,13.2162661738
3620,1500000US131390007011,131390007011,"Block Group 1, Census Tract 7.01, Hall County, Georgia",2425,1645,780,32.1649484536
3621,1500000US131390007012,131390007012,"Block Group 2, Census Tract 7.01, Hall County, Georgia",4002,2117,1885,47.1014492754
3622,1500000US131390007021,131390007021,"Block Group 1, Census Tract 7.02, Hall County, Georgia",3020,1598,1422,47.0860927152
3623,1500000US131390007022,131390007022,"Block Group 2, Census Tract 7.02, Hall County, Georgia",2670,635,2035,76.2172284644
3624,1500000US131390008001,131390008001,"Block Group 1, Census Tract 8, Hall County, Georgia",915,486,429,46.8852459016
3625,1500000US131390008002,131390008002,"Block Group 2, Census Tract 8, Hall County, Georgia",754,434,320,42.4403183024
3626,1500000US131390008003,131390008003,"Block Group 3, Census Tract 8, Hall County, Georgia",1947,1422,525,26.9645608629
3627,1500000US131390009001,131390009001,"Block Group 1, Census Tract 9, Hall County, Georgia",1262,1240,22,1.74326465927
3628,1500000US131390009002,131390009002,"Block Group 2, Census Tract 9, Hall County, Georgia",1498,1314,184,12.2830440587
3629,1500000US131390009003,131390009003,"Block Group 3, Census Tract 9, Hall County, Georgia",1464,686,778,53.1420765027
3630,1500000US131390009004,131390009004,"Block Group 4, Census Tract 9, Hall County, Georgia",1059,892,167,15.7695939566
3631,1500000US131390010021,131390010021,"Block Group 1, Census Tract 10.02, Hall County, Georgia",1231,1125,106,8.61088545898
3632,1500000US131390010022,131390010022,"Block Group 2, Census Tract 10.02, Hall County, Georgia",2310,1295,1015,43.9393939394
3633,1500000US131390010023,131390010023,"Block Group 3, Census Tract 10.02, Hall County, Georgia",3327,1369,1958,58.8518184551
3634,1500000US131390010031,131390010031,"Block Group 1, Census Tract 10.03, Hall County, Georgia",2537,587,1950,76.862435948
3635,1500000US131390010032,131390010032,"Block Group 2, Census Tract 10.03, Hall County, Georgia",3219,1288,1931,59.9875737807
3636,1500000US131390010033,131390010033,"Block Group 3, Census Tract 10.03, Hall County, Georgia",872,199,673,77.1788990826
3637,1500000US131390010041,131390010041,"Block Group 1, Census Tract 10.04, Hall County, Georgia",3205,2523,682,21.27925117
3638,1500000US131390011011,131390011011,"Block Group 1, Census Tract 11.01, Hall County, Georgia",1684,386,1298,77.0783847981
3639,1500000US131390011012,131390011012,"Block Group 2, Census Tract 11.01, Hall County, Georgia",1675,128,1547,92.3582089552
3640,1500000US131390011013,131390011013,"Block Group 3, Census Tract 11.01, Hall County, Georgia",1448,82,1366,94.3370165746
3641,1500000US131390011021,131390011021,"Block Group 1, Census Tract 11.02, Hall County, Georgia",4460,1126,3334,74.7533632287
3642,1500000US131390012011,131390012011,"Block Group 1, Census Tract 12.01, Hall County, Georgia",1651,1283,368,22.2895215021
3643,1500000US131390012012,131390012012,"Block Group 2, Census Tract 12.01, Hall County, Georgia",2116,1248,868,41.0207939509
3644,1500000US131390012013,131390012013,"Block Group 3, Census Tract 12.01, Hall County, Georgia",3663,1493,2170,59.2410592411
3645,1500000US131390012021,131390012021,"Block Group 1, Census Tract 12.02, Hall County, Georgia",4632,1578,3054,65.932642487
3646,1500000US131390012022,131390012022,"Block Group 2, Census Tract 12.02, Hall County, Georgia",2089,1153,936,44.8061273337
3647,1500000US131390013011,131390013011,"Block Group 1, Census Tract 13.01, Hall County, Georgia",1972,1747,225,11.4097363083
3648,1500000US131390013012,131390013012,"Block Group 2, Census Tract 13.01, Hall County, Georgia",1395,569,826,59.2114695341
3649,1500000US131390013013,131390013013,"Block Group 3, Census Tract 13.01, Hall County, Georgia",2619,1926,693,26.4604810997
3650,1500000US131390013021,131390013021,"Block Group 1, Census Tract 13.02, Hall County, Georgia",2656,2571,85,3.20030120482
3651,1500000US131390013022,131390013022,"Block Group 2, Census Tract 13.02, Hall County, Georgia",2573,2196,377,14.6521570152
3652,1500000US131390014021,131390014021,"Block Group 1, Census Tract 14.02, Hall County, Georgia",1013,934,79,7.79861796644
3653,1500000US131390014022,131390014022,"Block Group 2, Census Tract 14.02, Hall County, Georgia",2119,1812,307,14.4879660217
3654,1500000US131390014023,131390014023,"Block Group 3, Census Tract 14.02, Hall County, Georgia",2402,1879,523,21.7735220649
3655,1500000US131390014031,131390014031,"Block Group 1, Census Tract 14.03, Hall County, Georgia",1663,741,922,55.4419723391
3656,1500000US131390014032,131390014032,"Block Group 2, Census Tract 14.03, Hall County, Georgia",1990,1363,627,31.5075376884
3657,1500000US131390014041,131390014041,"Block Group 1, Census Tract 14.04, Hall County, Georgia",3635,2611,1024,28.1705639615
3658,1500000US131390014042,131390014042,"Block Group 2, Census Tract 14.04, Hall County, Georgia",742,686,56,7.54716981132
3659,1500000US131390014043,131390014043,"Block Group 3, Census Tract 14.04, Hall County, Georgia",815,420,395,48.4662576687
3660,1500000US131390015011,131390015011,"Block Group 1, Census Tract 15.01, Hall County, Georgia",3030,2954,76,2.50825082508
3661,1500000US131390015012,131390015012,"Block Group 2, Census Tract 15.01, Hall County, Georgia",1577,1255,322,20.4185161699
3662,1500000US131390015021,131390015021,"Block Group 1, Census Tract 15.02, Hall County, Georgia",2135,2125,10,0.468384074941
3663,1500000US131390015022,131390015022,"Block Group 2, Census Tract 15.02, Hall County, Georgia",2825,1888,937,33.1681415929
3664,1500000US131390016031,131390016031,"Block Group 1, Census Tract 16.03, Hall County, Georgia",3077,2720,357,11.6022099448
3665,1500000US131390016032,131390016032,"Block Group 2, Census Tract 16.03, Hall County, Georgia",2247,1476,771,34.3124165554
3666,1500000US131390016041,131390016041,"Block Group 1, Census Tract 16.04, Hall County, Georgia",3136,2461,675,21.5242346939
3667,1500000US131390016042,131390016042,"Block Group 2, Census Tract 16.04, Hall County, Georgia",3589,3267,322,8.97185845639
3668,1500000US131390016051,131390016051,"Block Group 1, Census Tract 16.05, Hall County, Georgia",1605,1342,263,16.3862928349
3669,1500000US131390016052,131390016052,"Block Group 2, Census Tract 16.05, Hall County, Georgia",3748,3504,244,6.51013874066
3670,1500000US131390016061,131390016061,"Block Group 1, Census Tract 16.06, Hall County, Georgia",1573,1234,339,21.5511760966
3671,1500000US131390016062,131390016062,"Block Group 2, Census Tract 16.06, Hall County, Georgia",2257,2045,212,9.39299955693
3672,1500000US131390016071,131390016071,"Block Group 1, Census Tract 16.07, Hall County, Georgia",1569,1380,189,12.0458891013
3673,1500000US131390016072,131390016072,"Block Group 2, Census Tract 16.07, Hall County, Georgia",1853,1830,23,1.24123043713
3674,1500000US131390016073,131390016073,"Block Group 3, Census Tract 16.07, Hall County, Georgia",1364,1236,128,9.38416422287
3675,1500000US131390016081,131390016081,"Block Group 1, Census Tract 16.08, Hall County, Georgia",5615,5171,444,7.90739091719
3676,1500000US131414803001,131414803001,"Block Group 1, Census Tract 4803, Hancock County, Georgia",1823,1823,0,0.0
3677,1500000US131414803002,131414803002,"Block Group 2, Census Tract 4803, Hancock County, Georgia",472,472,0,0.0
3678,1500000US131414804001,131414804001,"Block Group 1, Census Tract 4804, Hancock County, Georgia",3026,2859,167,5.51883674818
3679,1500000US131414804002,131414804002,"Block Group 2, Census Tract 4804, Hancock County, Georgia",457,456,1,0.218818380744
3680,1500000US131414804003,131414804003,"Block Group 3, Census Tract 4804, Hancock County, Georgia",962,962,0,0.0
3681,1500000US131414804004,131414804004,"Block Group 4, Census Tract 4804, Hancock County, Georgia",1052,1052,0,0.0
3682,1500000US131414804005,131414804005,"Block Group 5, Census Tract 4804, Hancock County, Georgia",1089,1084,5,0.459136822773
3683,1500000US131430101001,131430101001,"Block Group 1, Census Tract 101, Haralson County, Georgia",1920,1920,0,0.0
3684,1500000US131430101002,131430101002,"Block Group 2, Census Tract 101, Haralson County, Georgia",1523,1523,0,0.0
3685,1500000US131430102001,131430102001,"Block Group 1, Census Tract 102, Haralson County, Georgia",849,849,0,0.0
3686,1500000US131430102002,131430102002,"Block Group 2, Census Tract 102, Haralson County, Georgia",1937,1937,0,0.0
3687,1500000US131430102003,131430102003,"Block Group 3, Census Tract 102, Haralson County, Georgia",2641,2641,0,0.0
3688,1500000US131430102004,131430102004,"Block Group 4, Census Tract 102, Haralson County, Georgia",790,735,55,6.96202531646
3689,1500000US131430103011,131430103011,"Block Group 1, Census Tract 103.01, Haralson County, Georgia",1414,1414,0,0.0
3690,1500000US131430103012,131430103012,"Block Group 2, Census Tract 103.01, Haralson County, Georgia",1918,1918,0,0.0
3691,1500000US131430103021,131430103021,"Block Group 1, Census Tract 103.02, Haralson County, Georgia",1501,1407,94,6.26249167222
3692,1500000US131430103022,131430103022,"Block Group 2, Census Tract 103.02, Haralson County, Georgia",1915,1889,26,1.35770234987
3693,1500000US131430103023,131430103023,"Block Group 3, Census Tract 103.02, Haralson County, Georgia",1634,1634,0,0.0
3694,1500000US131430103024,131430103024,"Block Group 4, Census Tract 103.02, Haralson County, Georgia",464,464,0,0.0
3695,1500000US131430103025,131430103025,"Block Group 5, Census Tract 103.02, Haralson County, Georgia",1610,1610,0,0.0
3696,1500000US131430103026,131430103026,"Block Group 6, Census Tract 103.02, Haralson County, Georgia",613,613,0,0.0
3697,1500000US131430104001,131430104001,"Block Group 1, Census Tract 104, Haralson County, Georgia",2971,2938,33,1.11073712555
3698,1500000US131430104002,131430104002,"Block Group 2, Census Tract 104, Haralson County, Georgia",2224,2159,65,2.9226618705
3699,1500000US131430104003,131430104003,"Block Group 3, Census Tract 104, Haralson County, Georgia",2641,2537,104,3.93790230973
3700,1500000US131451201981,131451201981,"Block Group 1, Census Tract 1201.98, Harris County, Georgia",2181,2132,49,2.24667583677
3701,1500000US131451201982,131451201982,"Block Group 2, Census Tract 1201.98, Harris County, Georgia",1391,1391,0,0.0
3702,1500000US131451201983,131451201983,"Block Group 3, Census Tract 1201.98, Harris County, Georgia",575,558,17,2.95652173913
3703,1500000US131451201984,131451201984,"Block Group 4, Census Tract 1201.98, Harris County, Georgia",1033,1010,23,2.22652468538
3704,1500000US131451202001,131451202001,"Block Group 1, Census Tract 1202, Harris County, Georgia",1742,1726,16,0.918484500574
3705,1500000US131451202002,131451202002,"Block Group 2, Census Tract 1202, Harris County, Georgia",2054,1986,68,3.3106134372
3706,1500000US131451203001,131451203001,"Block Group 1, Census Tract 1203, Harris County, Georgia",1370,1354,16,1.16788321168
3707,1500000US131451203002,131451203002,"Block Group 2, Census Tract 1203, Harris County, Georgia",1776,1703,73,4.11036036036
3708,1500000US131451203003,131451203003,"Block Group 3, Census Tract 1203, Harris County, Georgia",2320,2159,161,6.93965517241
3709,1500000US131451203004,131451203004,"Block Group 4, Census Tract 1203, Harris County, Georgia",920,910,10,1.08695652174
3710,1500000US131451203005,131451203005,"Block Group 5, Census Tract 1203, Harris County, Georgia",2730,2730,0,0.0
3711,1500000US131451204011,131451204011,"Block Group 1, Census Tract 1204.01, Harris County, Georgia",2781,2726,55,1.9777058612
3712,1500000US131451204012,131451204012,"Block Group 2, Census Tract 1204.01, Harris County, Georgia",3748,3378,370,9.87193169691
3713,1500000US131451204021,131451204021,"Block Group 1, Census Tract 1204.02, Harris County, Georgia",1175,1175,0,0.0
3714,1500000US131451204022,131451204022,"Block Group 2, Census Tract 1204.02, Harris County, Georgia",4930,4787,143,2.90060851927
3715,1500000US131451204023,131451204023,"Block Group 3, Census Tract 1204.02, Harris County, Georgia",2050,2016,34,1.65853658537
3716,1500000US131479601001,131479601001,"Block Group 1, Census Tract 9601, Hart County, Georgia",1512,1488,24,1.5873015873
3717,1500000US131479601002,131479601002,"Block Group 2, Census Tract 9601, Hart County, Georgia",833,833,0,0.0
3718,1500000US131479601003,131479601003,"Block Group 3, Census Tract 9601, Hart County, Georgia",1327,1309,18,1.35644310475
3719,1500000US131479601004,131479601004,"Block Group 4, Census Tract 9601, Hart County, Georgia",856,772,84,9.81308411215
3720,1500000US131479601005,131479601005,"Block Group 5, Census Tract 9601, Hart County, Georgia",1152,1152,0,0.0
3721,1500000US131479602001,131479602001,"Block Group 1, Census Tract 9602, Hart County, Georgia",1481,1474,7,0.472653612424
3722,1500000US131479602002,131479602002,"Block Group 2, Census Tract 9602, Hart County, Georgia",1112,1112,0,0.0
3723,1500000US131479602003,131479602003,"Block Group 3, Census Tract 9602, Hart County, Georgia",723,723,0,0.0
3724,1500000US131479603001,131479603001,"Block Group 1, Census Tract 9603, Hart County, Georgia",1808,1796,12,0.663716814159
3725,1500000US131479603002,131479603002,"Block Group 2, Census Tract 9603, Hart County, Georgia",1456,1393,63,4.32692307692
3726,1500000US131479604001,131479604001,"Block Group 1, Census Tract 9604, Hart County, Georgia",1462,1462,0,0.0
3727,1500000US131479604002,131479604002,"Block Group 2, Census Tract 9604, Hart County, Georgia",2156,1929,227,10.5287569573
3728,1500000US131479604003,131479604003,"Block Group 3, Census Tract 9604, Hart County, Georgia",713,548,165,23.141654979
3729,1500000US131479604004,131479604004,"Block Group 4, Census Tract 9604, Hart County, Georgia",973,962,11,1.13052415211
3730,1500000US131479605001,131479605001,"Block Group 1, Census Tract 9605, Hart County, Georgia",1386,1386,0,0.0
3731,1500000US131479605002,131479605002,"Block Group 2, Census Tract 9605, Hart County, Georgia",1558,1548,10,0.641848523748
3732,1500000US131479605003,131479605003,"Block Group 3, Census Tract 9605, Hart County, Georgia",892,855,37,4.14798206278
3733,1500000US131479605004,131479605004,"Block Group 4, Census Tract 9605, Hart County, Georgia",2150,2128,22,1.02325581395
3734,1500000US131479605005,131479605005,"Block Group 5, Census Tract 9605, Hart County, Georgia",1948,1709,239,12.2689938398
3735,1500000US131499701001,131499701001,"Block Group 1, Census Tract 9701, Heard County, Georgia",1462,1346,116,7.93433652531
3736,1500000US131499701002,131499701002,"Block Group 2, Census Tract 9701, Heard County, Georgia",1698,1564,134,7.89163722026
3737,1500000US131499701003,131499701003,"Block Group 3, Census Tract 9701, Heard County, Georgia",1345,1345,0,0.0
3738,1500000US131499702001,131499702001,"Block Group 1, Census Tract 9702, Heard County, Georgia",1882,1882,0,0.0
3739,1500000US131499702002,131499702002,"Block Group 2, Census Tract 9702, Heard County, Georgia",1259,1259,0,0.0
3740,1500000US131499702003,131499702003,"Block Group 3, Census Tract 9702, Heard County, Georgia",1052,1031,21,1.99619771863
3741,1500000US131499703001,131499703001,"Block Group 1, Census Tract 9703, Heard County, Georgia",1151,1151,0,0.0
3742,1500000US131499703002,131499703002,"Block Group 2, Census Tract 9703, Heard County, Georgia",1768,1768,0,0.0
3743,1500000US131510701041,131510701041,"Block Group 1, Census Tract 701.04, Henry County, Georgia",5921,5465,456,7.70140179024
3744,1500000US131510701042,131510701042,"Block Group 2, Census Tract 701.04, Henry County, Georgia",2559,2559,0,0.0
3745,1500000US131510701043,131510701043,"Block Group 3, Census Tract 701.04, Henry County, Georgia",3857,3796,61,1.58154005704
3746,1500000US131510701061,131510701061,"Block Group 1, Census Tract 701.06, Henry County, Georgia",3445,3124,321,9.31785195936
3747,1500000US131510701062,131510701062,"Block Group 2, Census Tract 701.06, Henry County, Georgia",3035,2977,58,1.91103789127
3748,1500000US131510701071,131510701071,"Block Group 1, Census Tract 701.07, Henry County, Georgia",2434,2434,0,0.0
3749,1500000US131510701072,131510701072,"Block Group 2, Census Tract 701.07, Henry County, Georgia",2318,2197,121,5.22001725626
3750,1500000US131510701073,131510701073,"Block Group 3, Census Tract 701.07, Henry County, Georgia",2425,2264,161,6.63917525773
3751,1500000US131510701081,131510701081,"Block Group 1, Census Tract 701.08, Henry County, Georgia",3026,2941,85,2.80898876404
3752,1500000US131510701082,131510701082,"Block Group 2, Census Tract 701.08, Henry County, Georgia",2139,1871,268,12.5292192613
3753,1500000US131510701091,131510701091,"Block Group 1, Census Tract 701.09, Henry County, Georgia",2183,2117,66,3.0233623454
3754,1500000US131510701092,131510701092,"Block Group 2, Census Tract 701.09, Henry County, Georgia",1427,1272,155,10.861948143
3755,1500000US131510701101,131510701101,"Block Group 1, Census Tract 701.10, Henry County, Georgia",1770,1754,16,0.90395480226
3756,1500000US131510701102,131510701102,"Block Group 2, Census Tract 701.10, Henry County, Georgia",3080,2984,96,3.11688311688
3757,1500000US131510701103,131510701103,"Block Group 3, Census Tract 701.10, Henry County, Georgia",2680,2680,0,0.0
3758,1500000US131510701111,131510701111,"Block Group 1, Census Tract 701.11, Henry County, Georgia",3190,2982,208,6.52037617555
3759,1500000US131510701112,131510701112,"Block Group 2, Census Tract 701.11, Henry County, Georgia",3363,3059,304,9.0395480226
3760,1500000US131510701113,131510701113,"Block Group 3, Census Tract 701.11, Henry County, Georgia",2416,1750,666,27.5662251656
3761,1500000US131510701131,131510701131,"Block Group 1, Census Tract 701.13, Henry County, Georgia",1721,1484,237,13.7710633353
3762,1500000US131510701132,131510701132,"Block Group 2, Census Tract 701.13, Henry County, Georgia",2112,1655,457,21.6382575758
3763,1500000US131510701141,131510701141,"Block Group 1, Census Tract 701.14, Henry County, Georgia",2758,2711,47,1.70413343002
3764,1500000US131510701142,131510701142,"Block Group 2, Census Tract 701.14, Henry County, Georgia",2514,2514,0,0.0
3765,1500000US131510702021,131510702021,"Block Group 1, Census Tract 702.02, Henry County, Georgia",3235,3114,121,3.74034003091
3766,1500000US131510702022,131510702022,"Block Group 2, Census Tract 702.02, Henry County, Georgia",4274,3964,310,7.2531586336
3767,1500000US131510702023,131510702023,"Block Group 3, Census Tract 702.02, Henry County, Georgia",3269,3269,0,0.0
3768,1500000US131510702031,131510702031,"Block Group 1, Census Tract 702.03, Henry County, Georgia",4820,4749,71,1.47302904564
3769,1500000US131510702032,131510702032,"Block Group 2, Census Tract 702.03, Henry County, Georgia",4964,4764,200,4.02900886382
3770,1500000US131510702033,131510702033,"Block Group 3, Census Tract 702.03, Henry County, Georgia",4768,4235,533,11.1786912752
3771,1500000US131510702041,131510702041,"Block Group 1, Census Tract 702.04, Henry County, Georgia",2490,2490,0,0.0
3772,1500000US131510702042,131510702042,"Block Group 2, Census Tract 702.04, Henry County, Georgia",2000,1878,122,6.1
3773,1500000US131510702051,131510702051,"Block Group 1, Census Tract 702.05, Henry County, Georgia",2873,2485,388,13.5050469892
3774,1500000US131510702052,131510702052,"Block Group 2, Census Tract 702.05, Henry County, Georgia",3752,3195,557,14.8454157783
3775,1500000US131510702053,131510702053,"Block Group 3, Census Tract 702.05, Henry County, Georgia",4452,3691,761,17.09344115
3776,1500000US131510703041,131510703041,"Block Group 1, Census Tract 703.04, Henry County, Georgia",2462,2433,29,1.17790414297
3777,1500000US131510703042,131510703042,"Block Group 2, Census Tract 703.04, Henry County, Georgia",4219,4094,125,2.96278739038
3778,1500000US131510703043,131510703043,"Block Group 3, Census Tract 703.04, Henry County, Georgia",5216,4902,314,6.01993865031
3779,1500000US131510703051,131510703051,"Block Group 1, Census Tract 703.05, Henry County, Georgia",4869,4605,264,5.42205791744
3780,1500000US131510703052,131510703052,"Block Group 2, Census Tract 703.05, Henry County, Georgia",2595,2558,37,1.42581888247
3781,1500000US131510703053,131510703053,"Block Group 3, Census Tract 703.05, Henry County, Georgia",1923,1741,182,9.46437857514
3782,1500000US131510703061,131510703061,"Block Group 1, Census Tract 703.06, Henry County, Georgia",9651,9196,455,4.71453735364
3783,1500000US131510703071,131510703071,"Block Group 1, Census Tract 703.07, Henry County, Georgia",4432,4040,392,8.84476534296
3784,1500000US131510703091,131510703091,"Block Group 1, Census Tract 703.09, Henry County, Georgia",3186,2699,487,15.2856246077
3785,1500000US131510703092,131510703092,"Block Group 2, Census Tract 703.09, Henry County, Georgia",4143,4061,82,1.9792420951
3786,1500000US131510703101,131510703101,"Block Group 1, Census Tract 703.10, Henry County, Georgia",1740,1546,194,11.1494252874
3787,1500000US131510703102,131510703102,"Block Group 2, Census Tract 703.10, Henry County, Georgia",1267,1267,0,0.0
3788,1500000US131510703103,131510703103,"Block Group 3, Census Tract 703.10, Henry County, Georgia",879,828,51,5.80204778157
3789,1500000US131510703111,131510703111,"Block Group 1, Census Tract 703.11, Henry County, Georgia",2918,2526,392,13.4338588074
3790,1500000US131510703112,131510703112,"Block Group 2, Census Tract 703.11, Henry County, Georgia",4261,3894,367,8.61300164281
3791,1500000US131510703113,131510703113,"Block Group 3, Census Tract 703.11, Henry County, Georgia",5213,4749,464,8.90082486092
3792,1500000US131510704021,131510704021,"Block Group 1, Census Tract 704.02, Henry County, Georgia",4985,4944,41,0.822467402207
3793,1500000US131510704022,131510704022,"Block Group 2, Census Tract 704.02, Henry County, Georgia",3877,3654,223,5.75187000258
3794,1500000US131510704023,131510704023,"Block Group 3, Census Tract 704.02, Henry County, Georgia",3111,3081,30,0.964320154291
3795,1500000US131510704031,131510704031,"Block Group 1, Census Tract 704.03, Henry County, Georgia",3825,3640,185,4.83660130719
3796,1500000US131510704032,131510704032,"Block Group 2, Census Tract 704.03, Henry County, Georgia",3634,3269,365,10.0440286186
3797,1500000US131510704033,131510704033,"Block Group 3, Census Tract 704.03, Henry County, Georgia",3203,2970,233,7.27443022167
3798,1500000US131510704041,131510704041,"Block Group 1, Census Tract 704.04, Henry County, Georgia",3264,3061,203,6.2193627451
3799,1500000US131510704042,131510704042,"Block Group 2, Census Tract 704.04, Henry County, Georgia",2854,2696,158,5.53608969867
3800,1500000US131510704043,131510704043,"Block Group 3, Census Tract 704.04, Henry County, Georgia",1078,1078,0,0.0
3801,1500000US131510705011,131510705011,"Block Group 1, Census Tract 705.01, Henry County, Georgia",5738,5469,269,4.68804461485
3802,1500000US131510705012,131510705012,"Block Group 2, Census Tract 705.01, Henry County, Georgia",1653,1254,399,24.1379310345
3803,1500000US131510705021,131510705021,"Block Group 1, Census Tract 705.02, Henry County, Georgia",4194,4174,20,0.476871721507
3804,1500000US131510705022,131510705022,"Block Group 2, Census Tract 705.02, Henry County, Georgia",8726,8330,396,4.53816181526
3805,1500000US131510705023,131510705023,"Block Group 3, Census Tract 705.02, Henry County, Georgia",1126,1105,21,1.86500888099
3806,1500000US131530201051,131530201051,"Block Group 1, Census Tract 201.05, Houston County, Georgia",2226,2181,45,2.02156334232
3807,1500000US131530201052,131530201052,"Block Group 2, Census Tract 201.05, Houston County, Georgia",2140,1994,146,6.82242990654
3808,1500000US131530201053,131530201053,"Block Group 3, Census Tract 201.05, Houston County, Georgia",1904,1867,37,1.94327731092
3809,1500000US131530201061,131530201061,"Block Group 1, Census Tract 201.06, Houston County, Georgia",3123,3032,91,2.91386487352
3810,1500000US131530201081,131530201081,"Block Group 1, Census Tract 201.08, Houston County, Georgia",1858,1511,347,18.6759956943
3811,1500000US131530201082,131530201082,"Block Group 2, Census Tract 201.08, Houston County, Georgia",2307,2256,51,2.21066319896
3812,1500000US131530201083,131530201083,"Block Group 3, Census Tract 201.08, Houston County, Georgia",1820,1794,26,1.42857142857
3813,1500000US131530201091,131530201091,"Block Group 1, Census Tract 201.09, Houston County, Georgia",5023,4326,697,13.8761696197
3814,1500000US131530201092,131530201092,"Block Group 2, Census Tract 201.09, Houston County, Georgia",4068,3776,292,7.17797443461
3815,1500000US131530202001,131530202001,"Block Group 1, Census Tract 202, Houston County, Georgia",1538,1522,16,1.04031209363
3816,1500000US131530202002,131530202002,"Block Group 2, Census Tract 202, Houston County, Georgia",840,840,0,0.0
3817,1500000US131530202003,131530202003,"Block Group 3, Census Tract 202, Houston County, Georgia",1702,1531,171,10.0470035253
3818,1500000US131530202004,131530202004,"Block Group 4, Census Tract 202, Houston County, Georgia",1194,1135,59,4.94137353434
3819,1500000US131530203001,131530203001,"Block Group 1, Census Tract 203, Houston County, Georgia",390,346,44,11.2820512821
3820,1500000US131530203002,131530203002,"Block Group 2, Census Tract 203, Houston County, Georgia",1525,1525,0,0.0
3821,1500000US131530203003,131530203003,"Block Group 3, Census Tract 203, Houston County, Georgia",1372,1074,298,21.7201166181
3822,1500000US131530203004,131530203004,"Block Group 4, Census Tract 203, Houston County, Georgia",2581,2547,34,1.31731886866
3823,1500000US131530203005,131530203005,"Block Group 5, Census Tract 203, Houston County, Georgia",626,626,0,0.0
3824,1500000US131530204001,131530204001,"Block Group 1, Census Tract 204, Houston County, Georgia",1102,1102,0,0.0
3825,1500000US131530204002,131530204002,"Block Group 2, Census Tract 204, Houston County, Georgia",2201,1674,527,23.9436619718
3826,1500000US131530206001,131530206001,"Block Group 1, Census Tract 206, Houston County, Georgia",1171,1056,115,9.82066609735
3827,1500000US131530206002,131530206002,"Block Group 2, Census Tract 206, Houston County, Georgia",238,207,31,13.025210084
3828,1500000US131530207001,131530207001,"Block Group 1, Census Tract 207, Houston County, Georgia",1273,1063,210,16.4964650432
3829,1500000US131530207002,131530207002,"Block Group 2, Census Tract 207, Houston County, Georgia",1144,1144,0,0.0
3830,1500000US131530207003,131530207003,"Block Group 3, Census Tract 207, Houston County, Georgia",968,968,0,0.0
3831,1500000US131530208001,131530208001,"Block Group 1, Census Tract 208, Houston County, Georgia",1364,1251,113,8.28445747801
3832,1500000US131530208002,131530208002,"Block Group 2, Census Tract 208, Houston County, Georgia",1048,925,123,11.7366412214
3833,1500000US131530209001,131530209001,"Block Group 1, Census Tract 209, Houston County, Georgia",995,985,10,1.00502512563
3834,1500000US131530209002,131530209002,"Block Group 2, Census Tract 209, Houston County, Georgia",1626,1570,56,3.44403444034
3835,1500000US131530209003,131530209003,"Block Group 3, Census Tract 209, Houston County, Georgia",920,920,0,0.0
3836,1500000US131530209004,131530209004,"Block Group 4, Census Tract 209, Houston County, Georgia",723,723,0,0.0
3837,1500000US131530210001,131530210001,"Block Group 1, Census Tract 210, Houston County, Georgia",1525,1463,62,4.06557377049
3838,1500000US131530210002,131530210002,"Block Group 2, Census Tract 210, Houston County, Georgia",1655,1585,70,4.22960725076
3839,1500000US131530210003,131530210003,"Block Group 3, Census Tract 210, Houston County, Georgia",1715,1615,100,5.83090379009
3840,1500000US131530210004,131530210004,"Block Group 4, Census Tract 210, Houston County, Georgia",2157,1733,424,19.6569309226
3841,1500000US131530211031,131530211031,"Block Group 1, Census Tract 211.03, Houston County, Georgia",2713,2627,86,3.16992259491
3842,1500000US131530211032,131530211032,"Block Group 2, Census Tract 211.03, Houston County, Georgia",2735,2463,272,9.94515539305
3843,1500000US131530211033,131530211033,"Block Group 3, Census Tract 211.03, Houston County, Georgia",5061,4803,258,5.09780675756
3844,1500000US131530211034,131530211034,"Block Group 4, Census Tract 211.03, Houston County, Georgia",552,552,0,0.0
3845,1500000US131530211041,131530211041,"Block Group 1, Census Tract 211.04, Houston County, Georgia",708,484,224,31.6384180791
3846,1500000US131530211042,131530211042,"Block Group 2, Census Tract 211.04, Houston County, Georgia",3301,2979,322,9.75461981218
3847,1500000US131530211043,131530211043,"Block Group 3, Census Tract 211.04, Houston County, Georgia",1304,976,328,25.1533742331
3848,1500000US131530211044,131530211044,"Block Group 4, Census Tract 211.04, Houston County, Georgia",1415,1374,41,2.89752650177
3849,1500000US131530211045,131530211045,"Block Group 5, Census Tract 211.04, Houston County, Georgia",687,687,0,0.0
3850,1500000US131530211051,131530211051,"Block Group 1, Census Tract 211.05, Houston County, Georgia",1252,1117,135,10.7827476038
3851,1500000US131530211052,131530211052,"Block Group 2, Census Tract 211.05, Houston County, Georgia",3048,2678,370,12.1391076115
3852,1500000US131530211053,131530211053,"Block Group 3, Census Tract 211.05, Houston County, Georgia",1236,849,387,31.3106796117
3853,1500000US131530211054,131530211054,"Block Group 4, Census Tract 211.05, Houston County, Georgia",1225,1225,0,0.0
3854,1500000US131530211071,131530211071,"Block Group 1, Census Tract 211.07, Houston County, Georgia",1213,1112,101,8.3264633141
3855,1500000US131530211072,131530211072,"Block Group 2, Census Tract 211.07, Houston County, Georgia",3231,3067,164,5.07582791705
3856,1500000US131530211073,131530211073,"Block Group 3, Census Tract 211.07, Houston County, Georgia",1619,1503,116,7.16491661519
3857,1500000US131530211074,131530211074,"Block Group 4, Census Tract 211.07, Houston County, Georgia",2623,2403,220,8.38734273732
3858,1500000US131530211081,131530211081,"Block Group 1, Census Tract 211.08, Houston County, Georgia",4507,4442,65,1.44220102063
3859,1500000US131530211082,131530211082,"Block Group 2, Census Tract 211.08, Houston County, Georgia",1682,1576,106,6.30202140309
3860,1500000US131530211131,131530211131,"Block Group 1, Census Tract 211.13, Houston County, Georgia",4957,4644,313,6.31430300585
3861,1500000US131530211132,131530211132,"Block Group 2, Census Tract 211.13, Houston County, Georgia",9813,9557,256,2.60878426577
3862,1500000US131530211133,131530211133,"Block Group 3, Census Tract 211.13, Houston County, Georgia",2471,2401,70,2.8328611898
3863,1500000US131530212011,131530212011,"Block Group 1, Census Tract 212.01, Houston County, Georgia",7160,6632,528,7.37430167598
3864,1500000US131530212012,131530212012,"Block Group 2, Census Tract 212.01, Houston County, Georgia",990,990,0,0.0
3865,1500000US131530212021,131530212021,"Block Group 1, Census Tract 212.02, Houston County, Georgia",1405,1371,34,2.41992882562
3866,1500000US131530212022,131530212022,"Block Group 2, Census Tract 212.02, Houston County, Georgia",1302,1302,0,0.0
3867,1500000US131530212023,131530212023,"Block Group 3, Census Tract 212.02, Houston County, Georgia",3041,2833,208,6.83985531075
3868,1500000US131530212024,131530212024,"Block Group 4, Census Tract 212.02, Houston County, Georgia",546,488,58,10.6227106227
3869,1500000US131530213001,131530213001,"Block Group 1, Census Tract 213, Houston County, Georgia",1377,1316,61,4.42992011619
3870,1500000US131530213002,131530213002,"Block Group 2, Census Tract 213, Houston County, Georgia",650,650,0,0.0
3871,1500000US131530213003,131530213003,"Block Group 3, Census Tract 213, Houston County, Georgia",1017,993,24,2.3598820059
3872,1500000US131530213004,131530213004,"Block Group 4, Census Tract 213, Houston County, Georgia",1498,1498,0,0.0
3873,1500000US131530214001,131530214001,"Block Group 1, Census Tract 214, Houston County, Georgia",1774,1586,188,10.5975197294
3874,1500000US131530214002,131530214002,"Block Group 2, Census Tract 214, Houston County, Georgia",964,917,47,4.8755186722
3875,1500000US131530214003,131530214003,"Block Group 3, Census Tract 214, Houston County, Georgia",1201,1201,0,0.0
3876,1500000US131530214004,131530214004,"Block Group 4, Census Tract 214, Houston County, Georgia",5032,4716,316,6.27980922099
3877,1500000US131530215001,131530215001,"Block Group 1, Census Tract 215, Houston County, Georgia",1088,1088,0,0.0
3878,1500000US131530215002,131530215002,"Block Group 2, Census Tract 215, Houston County, Georgia",1773,1723,50,2.82007896221
3879,1500000US131530215003,131530215003,"Block Group 3, Census Tract 215, Houston County, Georgia",1337,1317,20,1.49588631264
3880,1500000US131559501001,131559501001,"Block Group 1, Census Tract 9501, Irwin County, Georgia",1308,1277,31,2.37003058104
3881,1500000US131559501002,131559501002,"Block Group 2, Census Tract 9501, Irwin County, Georgia",1114,1114,0,0.0
3882,1500000US131559502001,131559502001,"Block Group 1, Census Tract 9502, Irwin County, Georgia",721,721,0,0.0
3883,1500000US131559502002,131559502002,"Block Group 2, Census Tract 9502, Irwin County, Georgia",1279,1261,18,1.40734949179
3884,1500000US131559502003,131559502003,"Block Group 3, Census Tract 9502, Irwin County, Georgia",740,735,5,0.675675675676
3885,1500000US131559502004,131559502004,"Block Group 4, Census Tract 9502, Irwin County, Georgia",1329,1329,0,0.0
3886,1500000US131559502005,131559502005,"Block Group 5, Census Tract 9502, Irwin County, Georgia",2178,2137,41,1.88246097337
3887,1500000US131559502006,131559502006,"Block Group 6, Census Tract 9502, Irwin County, Georgia",739,739,0,0.0
3888,1500000US131570101011,131570101011,"Block Group 1, Census Tract 101.01, Jackson County, Georgia",2809,2809,0,0.0
3889,1500000US131570101012,131570101012,"Block Group 2, Census Tract 101.01, Jackson County, Georgia",2652,2637,15,0.565610859729
3890,1500000US131570101021,131570101021,"Block Group 1, Census Tract 101.02, Jackson County, Georgia",2708,2512,196,7.23781388479
3891,1500000US131570101022,131570101022,"Block Group 2, Census Tract 101.02, Jackson County, Georgia",4241,4021,220,5.18745578873
3892,1500000US131570101031,131570101031,"Block Group 1, Census Tract 101.03, Jackson County, Georgia",3686,3501,185,5.01899077591
3893,1500000US131570101032,131570101032,"Block Group 2, Census Tract 101.03, Jackson County, Georgia",1756,1431,325,18.5079726651
3894,1500000US131570102001,131570102001,"Block Group 1, Census Tract 102, Jackson County, Georgia",2550,2311,239,9.37254901961
3895,1500000US131570102002,131570102002,"Block Group 2, Census Tract 102, Jackson County, Georgia",2438,2410,28,1.14848236259
3896,1500000US131570103001,131570103001,"Block Group 1, Census Tract 103, Jackson County, Georgia",941,933,8,0.850159404888
3897,1500000US131570103002,131570103002,"Block Group 2, Census Tract 103, Jackson County, Georgia",987,987,0,0.0
3898,1500000US131570103003,131570103003,"Block Group 3, Census Tract 103, Jackson County, Georgia",2560,1928,632,24.6875
3899,1500000US131570104001,131570104001,"Block Group 1, Census Tract 104, Jackson County, Georgia",1340,1293,47,3.50746268657
3900,1500000US131570104002,131570104002,"Block Group 2, Census Tract 104, Jackson County, Georgia",1199,1199,0,0.0
3901,1500000US131570104003,131570104003,"Block Group 3, Census Tract 104, Jackson County, Georgia",904,904,0,0.0
3902,1500000US131570104004,131570104004,"Block Group 4, Census Tract 104, Jackson County, Georgia",1269,1179,90,7.09219858156
3903,1500000US131570105001,131570105001,"Block Group 1, Census Tract 105, Jackson County, Georgia",624,369,255,40.8653846154
3904,1500000US131570105002,131570105002,"Block Group 2, Census Tract 105, Jackson County, Georgia",2037,1741,296,14.5311732941
3905,1500000US131570105003,131570105003,"Block Group 3, Census Tract 105, Jackson County, Georgia",2619,2535,84,3.20733104238
3906,1500000US131570106001,131570106001,"Block Group 1, Census Tract 106, Jackson County, Georgia",1804,1804,0,0.0
3907,1500000US131570106002,131570106002,"Block Group 2, Census Tract 106, Jackson County, Georgia",1623,1156,467,28.7738755391
3908,1500000US131570106003,131570106003,"Block Group 3, Census Tract 106, Jackson County, Georgia",1891,1828,63,3.33157059757
3909,1500000US131570106004,131570106004,"Block Group 4, Census Tract 106, Jackson County, Georgia",1849,1849,0,0.0
3910,1500000US131570106005,131570106005,"Block Group 5, Census Tract 106, Jackson County, Georgia",1620,1413,207,12.7777777778
3911,1500000US131570107011,131570107011,"Block Group 1, Census Tract 107.01, Jackson County, Georgia",1268,1253,15,1.18296529968
3912,1500000US131570107012,131570107012,"Block Group 2, Census Tract 107.01, Jackson County, Georgia",966,966,0,0.0
3913,1500000US131570107021,131570107021,"Block Group 1, Census Tract 107.02, Jackson County, Georgia",3021,2721,300,9.93048659384
3914,1500000US131570107022,131570107022,"Block Group 2, Census Tract 107.02, Jackson County, Georgia",3217,3188,29,0.901460988499
3915,1500000US131570107023,131570107023,"Block Group 3, Census Tract 107.02, Jackson County, Georgia",3499,3308,191,5.45870248642
3916,1500000US131570107031,131570107031,"Block Group 1, Census Tract 107.03, Jackson County, Georgia",3342,3108,234,7.00179533214
3917,1500000US131590101001,131590101001,"Block Group 1, Census Tract 101, Jasper County, Georgia",2374,2310,64,2.69587194608
3918,1500000US131590102001,131590102001,"Block Group 1, Census Tract 102, Jasper County, Georgia",2722,2701,21,0.771491550331
3919,1500000US131590105001,131590105001,"Block Group 1, Census Tract 105, Jasper County, Georgia",1154,1073,81,7.01906412478
3920,1500000US131590105002,131590105002,"Block Group 2, Census Tract 105, Jasper County, Georgia",869,869,0,0.0
3921,1500000US131590105003,131590105003,"Block Group 3, Census Tract 105, Jasper County, Georgia",3311,3311,0,0.0
3922,1500000US131590105004,131590105004,"Block Group 4, Census Tract 105, Jasper County, Georgia",1799,1685,114,6.33685380767
3923,1500000US131590105005,131590105005,"Block Group 5, Census Tract 105, Jasper County, Georgia",1364,1103,261,19.1348973607
3924,1500000US131619601001,131619601001,"Block Group 1, Census Tract 9601, Jeff Davis County, Georgia",1746,1698,48,2.74914089347
3925,1500000US131619601002,131619601002,"Block Group 2, Census Tract 9601, Jeff Davis County, Georgia",959,896,63,6.56934306569
3926,1500000US131619601003,131619601003,"Block Group 3, Census Tract 9601, Jeff Davis County, Georgia",1147,823,324,28.2476024412
3927,1500000US131619601004,131619601004,"Block Group 4, Census Tract 9601, Jeff Davis County, Georgia",1181,1024,157,13.2938187976
3928,1500000US131619601005,131619601005,"Block Group 5, Census Tract 9601, Jeff Davis County, Georgia",1478,1271,207,14.0054127199
3929,1500000US131619602001,131619602001,"Block Group 1, Census Tract 9602, Jeff Davis County, Georgia",1399,1399,0,0.0
3930,1500000US131619602002,131619602002,"Block Group 2, Census Tract 9602, Jeff Davis County, Georgia",2311,1987,324,14.0199048031
3931,1500000US131619602003,131619602003,"Block Group 3, Census Tract 9602, Jeff Davis County, Georgia",954,954,0,0.0
3932,1500000US131619602004,131619602004,"Block Group 4, Census Tract 9602, Jeff Davis County, Georgia",1970,1578,392,19.8984771574
3933,1500000US131619603001,131619603001,"Block Group 1, Census Tract 9603, Jeff Davis County, Georgia",1014,872,142,14.0039447732
3934,1500000US131619603002,131619603002,"Block Group 2, Census Tract 9603, Jeff Davis County, Georgia",831,831,0,0.0
3935,1500000US131639601001,131639601001,"Block Group 1, Census Tract 9601, Jefferson County, Georgia",1193,1102,91,7.62782900251
3936,1500000US131639601002,131639601002,"Block Group 2, Census Tract 9601, Jefferson County, Georgia",511,511,0,0.0
3937,1500000US131639601003,131639601003,"Block Group 3, Census Tract 9601, Jefferson County, Georgia",780,734,46,5.89743589744
3938,1500000US131639601004,131639601004,"Block Group 4, Census Tract 9601, Jefferson County, Georgia",1154,1154,0,0.0
3939,1500000US131639601005,131639601005,"Block Group 5, Census Tract 9601, Jefferson County, Georgia",1200,1191,9,0.75
3940,1500000US131639602001,131639602001,"Block Group 1, Census Tract 9602, Jefferson County, Georgia",1192,1168,24,2.01342281879
3941,1500000US131639602002,131639602002,"Block Group 2, Census Tract 9602, Jefferson County, Georgia",996,911,85,8.53413654618
3942,1500000US131639603001,131639603001,"Block Group 1, Census Tract 9603, Jefferson County, Georgia",814,814,0,0.0
3943,1500000US131639603002,131639603002,"Block Group 2, Census Tract 9603, Jefferson County, Georgia",772,764,8,1.03626943005
3944,1500000US131639603003,131639603003,"Block Group 3, Census Tract 9603, Jefferson County, Georgia",1049,1049,0,0.0
3945,1500000US131639603004,131639603004,"Block Group 4, Census Tract 9603, Jefferson County, Georgia",1345,1345,0,0.0
3946,1500000US131639603005,131639603005,"Block Group 5, Census Tract 9603, Jefferson County, Georgia",1199,1162,37,3.08590492077
3947,1500000US131639603006,131639603006,"Block Group 6, Census Tract 9603, Jefferson County, Georgia",574,574,0,0.0
3948,1500000US131639604001,131639604001,"Block Group 1, Census Tract 9604, Jefferson County, Georgia",1165,993,172,14.7639484979
3949,1500000US131639604002,131639604002,"Block Group 2, Census Tract 9604, Jefferson County, Georgia",900,896,4,0.444444444444
3950,1500000US131639604003,131639604003,"Block Group 3, Census Tract 9604, Jefferson County, Georgia",831,764,67,8.06257521059
3951,1500000US131639604004,131639604004,"Block Group 4, Census Tract 9604, Jefferson County, Georgia",699,699,0,0.0
3952,1500000US131659601001,131659601001,"Block Group 1, Census Tract 9601, Jenkins County, Georgia",2029,1623,406,20.0098570724
3953,1500000US131659601002,131659601002,"Block Group 2, Census Tract 9601, Jenkins County, Georgia",1319,1319,0,0.0
3954,1500000US131659601003,131659601003,"Block Group 3, Census Tract 9601, Jenkins County, Georgia",728,728,0,0.0
3955,1500000US131659601004,131659601004,"Block Group 4, Census Tract 9601, Jenkins County, Georgia",449,406,43,9.57683741648
3956,1500000US131659601005,131659601005,"Block Group 5, Census Tract 9601, Jenkins County, Georgia",824,824,0,0.0
3957,1500000US131659601006,131659601006,"Block Group 6, Census Tract 9601, Jenkins County, Georgia",723,685,38,5.25587828492
3958,1500000US131659602001,131659602001,"Block Group 1, Census Tract 9602, Jenkins County, Georgia",1298,1248,50,3.85208012327
3959,1500000US131659602002,131659602002,"Block Group 2, Census Tract 9602, Jenkins County, Georgia",1552,1395,157,10.1159793814
3960,1500000US131679601001,131679601001,"Block Group 1, Census Tract 9601, Johnson County, Georgia",1260,1234,26,2.06349206349
3961,1500000US131679601002,131679601002,"Block Group 2, Census Tract 9601, Johnson County, Georgia",1431,1426,5,0.349406009783
3962,1500000US131679602001,131679602001,"Block Group 1, Census Tract 9602, Johnson County, Georgia",942,939,3,0.31847133758
3963,1500000US131679602002,131679602002,"Block Group 2, Census Tract 9602, Johnson County, Georgia",1183,1183,0,0.0
3964,1500000US131679602003,131679602003,"Block Group 3, Census Tract 9602, Johnson County, Georgia",1732,1732,0,0.0
3965,1500000US131679602004,131679602004,"Block Group 4, Census Tract 9602, Johnson County, Georgia",1473,1473,0,0.0
3966,1500000US131679603001,131679603001,"Block Group 1, Census Tract 9603, Johnson County, Georgia",962,962,0,0.0
3967,1500000US131679603002,131679603002,"Block Group 2, Census Tract 9603, Johnson County, Georgia",811,806,5,0.616522811344
3968,1500000US131690301011,131690301011,"Block Group 1, Census Tract 301.01, Jones County, Georgia",2598,2524,74,2.84834488068
3969,1500000US131690301031,131690301031,"Block Group 1, Census Tract 301.03, Jones County, Georgia",2474,2463,11,0.444624090542
3970,1500000US131690301041,131690301041,"Block Group 1, Census Tract 301.04, Jones County, Georgia",4738,4701,37,0.780920219502
3971,1500000US131690301042,131690301042,"Block Group 2, Census Tract 301.04, Jones County, Georgia",2716,2716,0,0.0
3972,1500000US131690302001,131690302001,"Block Group 1, Census Tract 302, Jones County, Georgia",2151,2151,0,0.0
3973,1500000US131690302002,131690302002,"Block Group 2, Census Tract 302, Jones County, Georgia",1414,1414,0,0.0
3974,1500000US131690303011,131690303011,"Block Group 1, Census Tract 303.01, Jones County, Georgia",2088,2051,37,1.77203065134
3975,1500000US131690303012,131690303012,"Block Group 2, Census Tract 303.01, Jones County, Georgia",4754,4745,9,0.189314261674
3976,1500000US131690303021,131690303021,"Block Group 1, Census Tract 303.02, Jones County, Georgia",938,938,0,0.0
3977,1500000US131690303022,131690303022,"Block Group 2, Census Tract 303.02, Jones County, Georgia",2277,2277,0,0.0
3978,1500000US131690303023,131690303023,"Block Group 3, Census Tract 303.02, Jones County, Georgia",2590,2590,0,0.0
3979,1500000US131719701001,131719701001,"Block Group 1, Census Tract 9701, Lamar County, Georgia",2540,2290,250,9.84251968504
3980,1500000US131719701002,131719701002,"Block Group 2, Census Tract 9701, Lamar County, Georgia",2789,2731,58,2.07959842237
3981,1500000US131719701003,131719701003,"Block Group 3, Census Tract 9701, Lamar County, Georgia",1828,1826,2,0.109409190372
3982,1500000US131719702001,131719702001,"Block Group 1, Census Tract 9702, Lamar County, Georgia",2432,2379,53,2.17927631579
3983,1500000US131719702002,131719702002,"Block Group 2, Census Tract 9702, Lamar County, Georgia",1735,1713,22,1.26801152738
3984,1500000US131719702003,131719702003,"Block Group 3, Census Tract 9702, Lamar County, Georgia",1324,1324,0,0.0
3985,1500000US131719702004,131719702004,"Block Group 4, Census Tract 9702, Lamar County, Georgia",646,646,0,0.0
3986,1500000US131719702005,131719702005,"Block Group 5, Census Tract 9702, Lamar County, Georgia",701,701,0,0.0
3987,1500000US131719703001,131719703001,"Block Group 1, Census Tract 9703, Lamar County, Georgia",1214,1214,0,0.0
3988,1500000US131719703002,131719703002,"Block Group 2, Census Tract 9703, Lamar County, Georgia",1049,1046,3,0.285986653956
3989,1500000US131719703003,131719703003,"Block Group 3, Census Tract 9703, Lamar County, Georgia",854,854,0,0.0
3990,1500000US131719703004,131719703004,"Block Group 4, Census Tract 9703, Lamar County, Georgia",1002,986,16,1.59680638723
3991,1500000US131739501001,131739501001,"Block Group 1, Census Tract 9501, Lanier County, Georgia",712,668,44,6.1797752809
3992,1500000US131739501002,131739501002,"Block Group 2, Census Tract 9501, Lanier County, Georgia",1254,1234,20,1.59489633174
3993,1500000US131739502001,131739502001,"Block Group 1, Census Tract 9502, Lanier County, Georgia",1329,1293,36,2.70880361174
3994,1500000US131739502002,131739502002,"Block Group 2, Census Tract 9502, Lanier County, Georgia",1795,1759,36,2.00557103064
3995,1500000US131739502003,131739502003,"Block Group 3, Census Tract 9502, Lanier County, Georgia",1137,1015,122,10.7299912049
3996,1500000US131739502004,131739502004,"Block Group 4, Census Tract 9502, Lanier County, Georgia",3063,2800,263,8.58635324845
3997,1500000US131739502005,131739502005,"Block Group 5, Census Tract 9502, Lanier County, Georgia",1113,1084,29,2.6055705301
3998,1500000US131759501001,131759501001,"Block Group 1, Census Tract 9501, Laurens County, Georgia",1847,1733,114,6.17217108825
3999,1500000US131759501002,131759501002,"Block Group 2, Census Tract 9501, Laurens County, Georgia",1317,1293,24,1.82232346241
4000,1500000US131759502011,131759502011,"Block Group 1, Census Tract 9502.01, Laurens County, Georgia",1921,1921,0,0.0
4001,1500000US131759502012,131759502012,"Block Group 2, Census Tract 9502.01, Laurens County, Georgia",2750,2750,0,0.0
4002,1500000US131759502021,131759502021,"Block Group 1, Census Tract 9502.02, Laurens County, Georgia",2023,1999,24,1.1863568957
4003,1500000US131759502022,131759502022,"Block Group 2, Census Tract 9502.02, Laurens County, Georgia",2321,2130,191,8.22921154675
4004,1500000US131759503001,131759503001,"Block Group 1, Census Tract 9503, Laurens County, Georgia",1138,1138,0,0.0
4005,1500000US131759503002,131759503002,"Block Group 2, Census Tract 9503, Laurens County, Georgia",551,520,31,5.62613430127
4006,1500000US131759504001,131759504001,"Block Group 1, Census Tract 9504, Laurens County, Georgia",816,816,0,0.0
4007,1500000US131759504002,131759504002,"Block Group 2, Census Tract 9504, Laurens County, Georgia",1269,1263,6,0.472813238771
4008,1500000US131759504003,131759504003,"Block Group 3, Census Tract 9504, Laurens County, Georgia",1373,1373,0,0.0
4009,1500000US131759504004,131759504004,"Block Group 4, Census Tract 9504, Laurens County, Georgia",400,400,0,0.0
4010,1500000US131759505001,131759505001,"Block Group 1, Census Tract 9505, Laurens County, Georgia",701,695,6,0.855920114123
4011,1500000US131759505002,131759505002,"Block Group 2, Census Tract 9505, Laurens County, Georgia",880,847,33,3.75
4012,1500000US131759505003,131759505003,"Block Group 3, Census Tract 9505, Laurens County, Georgia",2394,2394,0,0.0
4013,1500000US131759506001,131759506001,"Block Group 1, Census Tract 9506, Laurens County, Georgia",2146,2089,57,2.65610438024
4014,1500000US131759507001,131759507001,"Block Group 1, Census Tract 9507, Laurens County, Georgia",1737,1737,0,0.0
4015,1500000US131759507002,131759507002,"Block Group 2, Census Tract 9507, Laurens County, Georgia",766,755,11,1.43603133159
4016,1500000US131759508001,131759508001,"Block Group 1, Census Tract 9508, Laurens County, Georgia",1271,1271,0,0.0
4017,1500000US131759508002,131759508002,"Block Group 2, Census Tract 9508, Laurens County, Georgia",654,654,0,0.0
4018,1500000US131759508003,131759508003,"Block Group 3, Census Tract 9508, Laurens County, Georgia",1252,1247,5,0.399361022364
4019,1500000US131759508004,131759508004,"Block Group 4, Census Tract 9508, Laurens County, Georgia",913,875,38,4.16210295728
4020,1500000US131759509001,131759509001,"Block Group 1, Census Tract 9509, Laurens County, Georgia",945,928,17,1.79894179894
4021,1500000US131759509002,131759509002,"Block Group 2, Census Tract 9509, Laurens County, Georgia",1024,1024,0,0.0
4022,1500000US131759509003,131759509003,"Block Group 3, Census Tract 9509, Laurens County, Georgia",721,721,0,0.0
4023,1500000US131759510001,131759510001,"Block Group 1, Census Tract 9510, Laurens County, Georgia",1188,1188,0,0.0
4024,1500000US131759510002,131759510002,"Block Group 2, Census Tract 9510, Laurens County, Georgia",375,375,0,0.0
4025,1500000US131759510003,131759510003,"Block Group 3, Census Tract 9510, Laurens County, Georgia",2250,1961,289,12.8444444444
4026,1500000US131759510004,131759510004,"Block Group 4, Census Tract 9510, Laurens County, Georgia",882,882,0,0.0
4027,1500000US131759510005,131759510005,"Block Group 5, Census Tract 9510, Laurens County, Georgia",954,940,14,1.46750524109
4028,1500000US131759510006,131759510006,"Block Group 6, Census Tract 9510, Laurens County, Georgia",1871,1847,24,1.28273650454
4029,1500000US131759511001,131759511001,"Block Group 1, Census Tract 9511, Laurens County, Georgia",3326,3185,141,4.23932651834
4030,1500000US131759511002,131759511002,"Block Group 2, Census Tract 9511, Laurens County, Georgia",1313,1293,20,1.523229246
4031,1500000US131759514001,131759514001,"Block Group 1, Census Tract 9514, Laurens County, Georgia",983,844,139,14.1403865717
4032,1500000US131759514002,131759514002,"Block Group 2, Census Tract 9514, Laurens County, Georgia",980,965,15,1.5306122449
4033,1500000US131759514003,131759514003,"Block Group 3, Census Tract 9514, Laurens County, Georgia",634,634,0,0.0
4034,1500000US131770201001,131770201001,"Block Group 1, Census Tract 201, Lee County, Georgia",1540,1451,89,5.77922077922
4035,1500000US131770201002,131770201002,"Block Group 2, Census Tract 201, Lee County, Georgia",2017,1989,28,1.38820029747
4036,1500000US131770201003,131770201003,"Block Group 3, Census Tract 201, Lee County, Georgia",2866,2866,0,0.0
4037,1500000US131770202001,131770202001,"Block Group 1, Census Tract 202, Lee County, Georgia",1455,1455,0,0.0
4038,1500000US131770203001,131770203001,"Block Group 1, Census Tract 203, Lee County, Georgia",3521,3414,107,3.03890940074
4039,1500000US131770203002,131770203002,"Block Group 2, Census Tract 203, Lee County, Georgia",1659,1601,58,3.49608197709
4040,1500000US131770203003,131770203003,"Block Group 3, Census Tract 203, Lee County, Georgia",1686,1610,76,4.50771055753
4041,1500000US131770204021,131770204021,"Block Group 1, Census Tract 204.02, Lee County, Georgia",2499,2421,78,3.1212484994
4042,1500000US131770204022,131770204022,"Block Group 2, Census Tract 204.02, Lee County, Georgia",3401,3401,0,0.0
4043,1500000US131770204023,131770204023,"Block Group 3, Census Tract 204.02, Lee County, Georgia",928,928,0,0.0
4044,1500000US131770204024,131770204024,"Block Group 4, Census Tract 204.02, Lee County, Georgia",1400,1389,11,0.785714285714
4045,1500000US131770204031,131770204031,"Block Group 1, Census Tract 204.03, Lee County, Georgia",5103,4945,158,3.09621791103
4046,1500000US131770204032,131770204032,"Block Group 2, Census Tract 204.03, Lee County, Georgia",871,768,103,11.8254879449
4047,1500000US131790101011,131790101011,"Block Group 1, Census Tract 101.01, Liberty County, Georgia",5198,4104,1094,21.0465563678
4048,1500000US131790101012,131790101012,"Block Group 2, Census Tract 101.01, Liberty County, Georgia",1267,1078,189,14.9171270718
4049,1500000US131790101021,131790101021,"Block Group 1, Census Tract 101.02, Liberty County, Georgia",707,614,93,13.1541725601
4050,1500000US131790101022,131790101022,"Block Group 2, Census Tract 101.02, Liberty County, Georgia",1314,1170,144,10.9589041096
4051,1500000US131790101031,131790101031,"Block Group 1, Census Tract 101.03, Liberty County, Georgia",225,206,19,8.44444444444
4052,1500000US131790101032,131790101032,"Block Group 2, Census Tract 101.03, Liberty County, Georgia",1274,1091,183,14.3642072214
4053,1500000US131790102021,131790102021,"Block Group 1, Census Tract 102.02, Liberty County, Georgia",2749,2216,533,19.3888686795
4054,1500000US131790102022,131790102022,"Block Group 2, Census Tract 102.02, Liberty County, Georgia",1456,1424,32,2.1978021978
4055,1500000US131790102041,131790102041,"Block Group 1, Census Tract 102.04, Liberty County, Georgia",539,539,0,0.0
4056,1500000US131790102042,131790102042,"Block Group 2, Census Tract 102.04, Liberty County, Georgia",2302,2023,279,12.1198957428
4057,1500000US131790102051,131790102051,"Block Group 1, Census Tract 102.05, Liberty County, Georgia",3606,3166,440,12.201885746
4058,1500000US131790102052,131790102052,"Block Group 2, Census Tract 102.05, Liberty County, Georgia",2270,2029,241,10.6167400881
4059,1500000US131790102061,131790102061,"Block Group 1, Census Tract 102.06, Liberty County, Georgia",1059,894,165,15.5807365439
4060,1500000US131790102062,131790102062,"Block Group 2, Census Tract 102.06, Liberty County, Georgia",4170,3554,616,14.7721822542
4061,1500000US131790102071,131790102071,"Block Group 1, Census Tract 102.07, Liberty County, Georgia",2677,2410,267,9.97385132611
4062,1500000US131790102072,131790102072,"Block Group 2, Census Tract 102.07, Liberty County, Georgia",2758,2330,428,15.5184916606
4063,1500000US131790102081,131790102081,"Block Group 1, Census Tract 102.08, Liberty County, Georgia",2553,2384,169,6.6196631414
4064,1500000US131790102082,131790102082,"Block Group 2, Census Tract 102.08, Liberty County, Georgia",3591,2926,665,18.5185185185
4065,1500000US131790103001,131790103001,"Block Group 1, Census Tract 103, Liberty County, Georgia",866,780,86,9.93071593533
4066,1500000US131790103002,131790103002,"Block Group 2, Census Tract 103, Liberty County, Georgia",2629,2401,228,8.67249904907
4067,1500000US131790103003,131790103003,"Block Group 3, Census Tract 103, Liberty County, Georgia",1215,978,237,19.5061728395
4068,1500000US131790103004,131790103004,"Block Group 4, Census Tract 103, Liberty County, Georgia",2185,1830,355,16.2471395881
4069,1500000US131790104001,131790104001,"Block Group 1, Census Tract 104, Liberty County, Georgia",2306,2112,194,8.41283607979
4070,1500000US131790104002,131790104002,"Block Group 2, Census Tract 104, Liberty County, Georgia",1863,1670,193,10.3596349973
4071,1500000US131790104003,131790104003,"Block Group 3, Census Tract 104, Liberty County, Georgia",3032,2573,459,15.1385224274
4072,1500000US131790105011,131790105011,"Block Group 1, Census Tract 105.01, Liberty County, Georgia",921,921,0,0.0
4073,1500000US131790105012,131790105012,"Block Group 2, Census Tract 105.01, Liberty County, Georgia",2569,2569,0,0.0
4074,1500000US131790105021,131790105021,"Block Group 1, Census Tract 105.02, Liberty County, Georgia",2840,2701,139,4.89436619718
4075,1500000US131790105022,131790105022,"Block Group 2, Census Tract 105.02, Liberty County, Georgia",2384,2341,43,1.80369127517
4076,1500000US131790106001,131790106001,"Block Group 1, Census Tract 106, Liberty County, Georgia",1066,1047,19,1.78236397749
4077,1500000US131790106002,131790106002,"Block Group 2, Census Tract 106, Liberty County, Georgia",836,832,4,0.478468899522
4078,1500000US131799900000,131799900000,"Block Group 0, Census Tract 9900, Liberty County, Georgia",0,0,0,
4079,1500000US131819701001,131819701001,"Block Group 1, Census Tract 9701, Lincoln County, Georgia",1344,1344,0,0.0
4080,1500000US131819701002,131819701002,"Block Group 2, Census Tract 9701, Lincoln County, Georgia",562,562,0,0.0
4081,1500000US131819701003,131819701003,"Block Group 3, Census Tract 9701, Lincoln County, Georgia",1151,1147,4,0.347523892268
4082,1500000US131819701004,131819701004,"Block Group 4, Census Tract 9701, Lincoln County, Georgia",694,688,6,0.864553314121
4083,1500000US131819702001,131819702001,"Block Group 1, Census Tract 9702, Lincoln County, Georgia",1301,1301,0,0.0
4084,1500000US131819702002,131819702002,"Block Group 2, Census Tract 9702, Lincoln County, Georgia",700,700,0,0.0
4085,1500000US131819702003,131819702003,"Block Group 3, Census Tract 9702, Lincoln County, Georgia",1968,1923,45,2.28658536585
4086,1500000US131839701001,131839701001,"Block Group 1, Census Tract 9701, Long County, Georgia",1957,1776,181,9.24885028104
4087,1500000US131839701002,131839701002,"Block Group 2, Census Tract 9701, Long County, Georgia",4330,3153,1177,27.182448037
4088,1500000US131839701003,131839701003,"Block Group 3, Census Tract 9701, Long County, Georgia",3260,2965,295,9.0490797546
4089,1500000US131839702001,131839702001,"Block Group 1, Census Tract 9702, Long County, Georgia",904,805,99,10.9513274336
4090,1500000US131839702002,131839702002,"Block Group 2, Census Tract 9702, Long County, Georgia",1659,1611,48,2.89330922242
4091,1500000US131839702003,131839702003,"Block Group 3, Census Tract 9702, Long County, Georgia",4478,4334,144,3.21572130415
4092,1500000US131839800001,131839800001,"Block Group 1, Census Tract 9800, Long County, Georgia",0,0,0,
4093,1500000US131850101011,131850101011,"Block Group 1, Census Tract 101.01, Lowndes County, Georgia",1149,1095,54,4.69973890339
4094,1500000US131850101012,131850101012,"Block Group 2, Census Tract 101.01, Lowndes County, Georgia",2938,2814,124,4.22055820286
4095,1500000US131850101021,131850101021,"Block Group 1, Census Tract 101.02, Lowndes County, Georgia",1574,1500,74,4.70139771283
4096,1500000US131850101022,131850101022,"Block Group 2, Census Tract 101.02, Lowndes County, Georgia",1671,1452,219,13.1059245961
4097,1500000US131850101023,131850101023,"Block Group 3, Census Tract 101.02, Lowndes County, Georgia",1183,1170,13,1.0989010989
4098,1500000US131850101024,131850101024,"Block Group 4, Census Tract 101.02, Lowndes County, Georgia",1172,1121,51,4.35153583618
4099,1500000US131850101031,131850101031,"Block Group 1, Census Tract 101.03, Lowndes County, Georgia",2158,1986,172,7.9703429101
4100,1500000US131850101032,131850101032,"Block Group 2, Census Tract 101.03, Lowndes County, Georgia",1264,1231,33,2.61075949367
4101,1500000US131850102011,131850102011,"Block Group 1, Census Tract 102.01, Lowndes County, Georgia",1159,1148,11,0.949094046592
4102,1500000US131850102012,131850102012,"Block Group 2, Census Tract 102.01, Lowndes County, Georgia",2142,2025,117,5.46218487395
4103,1500000US131850102021,131850102021,"Block Group 1, Census Tract 102.02, Lowndes County, Georgia",1362,1162,200,14.684287812
4104,1500000US131850102022,131850102022,"Block Group 2, Census Tract 102.02, Lowndes County, Georgia",1961,1918,43,2.19275879653
4105,1500000US131850102023,131850102023,"Block Group 3, Census Tract 102.02, Lowndes County, Georgia",1927,1927,0,0.0
4106,1500000US131850102024,131850102024,"Block Group 4, Census Tract 102.02, Lowndes County, Georgia",2237,2163,74,3.30800178811
4107,1500000US131850102025,131850102025,"Block Group 5, Census Tract 102.02, Lowndes County, Georgia",3193,3150,43,1.34669589728
4108,1500000US131850102026,131850102026,"Block Group 6, Census Tract 102.02, Lowndes County, Georgia",869,827,42,4.833141542
4109,1500000US131850103011,131850103011,"Block Group 1, Census Tract 103.01, Lowndes County, Georgia",1022,973,49,4.79452054795
4110,1500000US131850103012,131850103012,"Block Group 2, Census Tract 103.01, Lowndes County, Georgia",2446,2366,80,3.27064595258
4111,1500000US131850103013,131850103013,"Block Group 3, Census Tract 103.01, Lowndes County, Georgia",1734,1615,119,6.86274509804
4112,1500000US131850103021,131850103021,"Block Group 1, Census Tract 103.02, Lowndes County, Georgia",1372,1337,35,2.55102040816
4113,1500000US131850103022,131850103022,"Block Group 2, Census Tract 103.02, Lowndes County, Georgia",1247,1197,50,4.00962309543
4114,1500000US131850104011,131850104011,"Block Group 1, Census Tract 104.01, Lowndes County, Georgia",1003,985,18,1.79461615155
4115,1500000US131850104012,131850104012,"Block Group 2, Census Tract 104.01, Lowndes County, Georgia",551,522,29,5.26315789474
4116,1500000US131850104021,131850104021,"Block Group 1, Census Tract 104.02, Lowndes County, Georgia",1072,1040,32,2.98507462687
4117,1500000US131850104022,131850104022,"Block Group 2, Census Tract 104.02, Lowndes County, Georgia",3081,3057,24,0.778967867575
4118,1500000US131850104023,131850104023,"Block Group 3, Census Tract 104.02, Lowndes County, Georgia",3141,3034,107,3.40655842089
4119,1500000US131850105001,131850105001,"Block Group 1, Census Tract 105, Lowndes County, Georgia",1309,1273,36,2.75019098549
4120,1500000US131850105002,131850105002,"Block Group 2, Census Tract 105, Lowndes County, Georgia",1592,1535,57,3.58040201005
4121,1500000US131850105003,131850105003,"Block Group 3, Census Tract 105, Lowndes County, Georgia",1915,1786,129,6.7362924282
4122,1500000US131850106011,131850106011,"Block Group 1, Census Tract 106.01, Lowndes County, Georgia",2925,2603,322,11.0085470085
4123,1500000US131850106012,131850106012,"Block Group 2, Census Tract 106.01, Lowndes County, Georgia",1161,959,202,17.398794143
4124,1500000US131850106013,131850106013,"Block Group 3, Census Tract 106.01, Lowndes County, Georgia",1798,1712,86,4.78309232481
4125,1500000US131850106041,131850106041,"Block Group 1, Census Tract 106.04, Lowndes County, Georgia",492,488,4,0.813008130081
4126,1500000US131850106042,131850106042,"Block Group 2, Census Tract 106.04, Lowndes County, Georgia",2829,2556,273,9.65005302227
4127,1500000US131850106043,131850106043,"Block Group 3, Census Tract 106.04, Lowndes County, Georgia",1886,1727,159,8.43054082715
4128,1500000US131850107001,131850107001,"Block Group 1, Census Tract 107, Lowndes County, Georgia",720,696,24,3.33333333333
4129,1500000US131850107002,131850107002,"Block Group 2, Census Tract 107, Lowndes County, Georgia",1075,1019,56,5.20930232558
4130,1500000US131850107003,131850107003,"Block Group 3, Census Tract 107, Lowndes County, Georgia",2076,2007,69,3.32369942197
4131,1500000US131850108001,131850108001,"Block Group 1, Census Tract 108, Lowndes County, Georgia",2563,2563,0,0.0
4132,1500000US131850108002,131850108002,"Block Group 2, Census Tract 108, Lowndes County, Georgia",2109,1973,136,6.44855381697
4133,1500000US131850108003,131850108003,"Block Group 3, Census Tract 108, Lowndes County, Georgia",886,886,0,0.0
4134,1500000US131850109001,131850109001,"Block Group 1, Census Tract 109, Lowndes County, Georgia",730,730,0,0.0
4135,1500000US131850109002,131850109002,"Block Group 2, Census Tract 109, Lowndes County, Georgia",991,991,0,0.0
4136,1500000US131850110001,131850110001,"Block Group 1, Census Tract 110, Lowndes County, Georgia",2132,1949,183,8.58348968105
4137,1500000US131850110002,131850110002,"Block Group 2, Census Tract 110, Lowndes County, Georgia",1426,1338,88,6.17110799439
4138,1500000US131850111001,131850111001,"Block Group 1, Census Tract 111, Lowndes County, Georgia",879,838,41,4.66439135381
4139,1500000US131850111002,131850111002,"Block Group 2, Census Tract 111, Lowndes County, Georgia",2146,2076,70,3.26188257223
4140,1500000US131850112001,131850112001,"Block Group 1, Census Tract 112, Lowndes County, Georgia",745,634,111,14.8993288591
4141,1500000US131850112002,131850112002,"Block Group 2, Census Tract 112, Lowndes County, Georgia",1556,1221,335,21.529562982
4142,1500000US131850112003,131850112003,"Block Group 3, Census Tract 112, Lowndes County, Georgia",1242,1188,54,4.34782608696
4143,1500000US131850112004,131850112004,"Block Group 4, Census Tract 112, Lowndes County, Georgia",1610,1519,91,5.65217391304
4144,1500000US131850113011,131850113011,"Block Group 1, Census Tract 113.01, Lowndes County, Georgia",2074,1895,179,8.63066538091
4145,1500000US131850113012,131850113012,"Block Group 2, Census Tract 113.01, Lowndes County, Georgia",1393,1298,95,6.81981335248
4146,1500000US131850113013,131850113013,"Block Group 3, Census Tract 113.01, Lowndes County, Georgia",1825,1817,8,0.438356164384
4147,1500000US131850113021,131850113021,"Block Group 1, Census Tract 113.02, Lowndes County, Georgia",1381,1279,102,7.38595220854
4148,1500000US131850113022,131850113022,"Block Group 2, Census Tract 113.02, Lowndes County, Georgia",1260,1260,0,0.0
4149,1500000US131850114011,131850114011,"Block Group 1, Census Tract 114.01, Lowndes County, Georgia",1723,1668,55,3.19210679048
4150,1500000US131850114012,131850114012,"Block Group 2, Census Tract 114.01, Lowndes County, Georgia",692,685,7,1.01156069364
4151,1500000US131850114021,131850114021,"Block Group 1, Census Tract 114.02, Lowndes County, Georgia",953,771,182,19.0975865687
4152,1500000US131850114022,131850114022,"Block Group 2, Census Tract 114.02, Lowndes County, Georgia",1684,1507,177,10.5106888361
4153,1500000US131850114031,131850114031,"Block Group 1, Census Tract 114.03, Lowndes County, Georgia",2392,2392,0,0.0
4154,1500000US131850114032,131850114032,"Block Group 2, Census Tract 114.03, Lowndes County, Georgia",2201,1800,401,18.2189913676
4155,1500000US131850114033,131850114033,"Block Group 3, Census Tract 114.03, Lowndes County, Georgia",2150,2124,26,1.20930232558
4156,1500000US131850114034,131850114034,"Block Group 4, Census Tract 114.03, Lowndes County, Georgia",1724,1685,39,2.26218097448
4157,1500000US131850115001,131850115001,"Block Group 1, Census Tract 115, Lowndes County, Georgia",1200,1179,21,1.75
4158,1500000US131850115002,131850115002,"Block Group 2, Census Tract 115, Lowndes County, Georgia",2119,1968,151,7.12600283152
4159,1500000US131850115003,131850115003,"Block Group 3, Census Tract 115, Lowndes County, Georgia",833,816,17,2.04081632653
4160,1500000US131850116001,131850116001,"Block Group 1, Census Tract 116, Lowndes County, Georgia",2493,2447,46,1.84516646611
4161,1500000US131850116002,131850116002,"Block Group 2, Census Tract 116, Lowndes County, Georgia",1685,1469,216,12.8189910979
4162,1500000US131879601011,131879601011,"Block Group 1, Census Tract 9601.01, Lumpkin County, Georgia",4636,4508,128,2.76100086281
4163,1500000US131879601012,131879601012,"Block Group 2, Census Tract 9601.01, Lumpkin County, Georgia",2520,2336,184,7.30158730159
4164,1500000US131879601021,131879601021,"Block Group 1, Census Tract 9601.02, Lumpkin County, Georgia",780,780,0,0.0
4165,1500000US131879601022,131879601022,"Block Group 2, Census Tract 9601.02, Lumpkin County, Georgia",2766,2681,85,3.0730296457
4166,1500000US131879601023,131879601023,"Block Group 3, Census Tract 9601.02, Lumpkin County, Georgia",2166,2058,108,4.98614958449
4167,1500000US131879602011,131879602011,"Block Group 1, Census Tract 9602.01, Lumpkin County, Georgia",5211,5132,79,1.51602379582
4168,1500000US131879602012,131879602012,"Block Group 2, Census Tract 9602.01, Lumpkin County, Georgia",2569,2446,123,4.78785519657
4169,1500000US131879602013,131879602013,"Block Group 3, Census Tract 9602.01, Lumpkin County, Georgia",2545,2473,72,2.82907662083
4170,1500000US131879602021,131879602021,"Block Group 1, Census Tract 9602.02, Lumpkin County, Georgia",2127,2119,8,0.376116596145
4171,1500000US131879602022,131879602022,"Block Group 2, Census Tract 9602.02, Lumpkin County, Georgia",2122,1899,223,10.5089538172
4172,1500000US131879602023,131879602023,"Block Group 3, Census Tract 9602.02, Lumpkin County, Georgia",1356,938,418,30.8259587021
4173,1500000US131879602024,131879602024,"Block Group 4, Census Tract 9602.02, Lumpkin County, Georgia",2123,2123,0,0.0
4174,1500000US131899501001,131899501001,"Block Group 1, Census Tract 9501, McDuffie County, Georgia",1452,1452,0,0.0
4175,1500000US131899501002,131899501002,"Block Group 2, Census Tract 9501, McDuffie County, Georgia",981,981,0,0.0
4176,1500000US131899502001,131899502001,"Block Group 1, Census Tract 9502, McDuffie County, Georgia",1580,1463,117,7.40506329114
4177,1500000US131899502002,131899502002,"Block Group 2, Census Tract 9502, McDuffie County, Georgia",1485,1445,40,2.6936026936
4178,1500000US131899502003,131899502003,"Block Group 3, Census Tract 9502, McDuffie County, Georgia",1418,1418,0,0.0
4179,1500000US131899502004,131899502004,"Block Group 4, Census Tract 9502, McDuffie County, Georgia",837,837,0,0.0
4180,1500000US131899503001,131899503001,"Block Group 1, Census Tract 9503, McDuffie County, Georgia",1370,1370,0,0.0
4181,1500000US131899503002,131899503002,"Block Group 2, Census Tract 9503, McDuffie County, Georgia",1043,972,71,6.80728667306
4182,1500000US131899503003,131899503003,"Block Group 3, Census Tract 9503, McDuffie County, Georgia",755,755,0,0.0
4183,1500000US131899504001,131899504001,"Block Group 1, Census Tract 9504, McDuffie County, Georgia",1146,1146,0,0.0
4184,1500000US131899504002,131899504002,"Block Group 2, Census Tract 9504, McDuffie County, Georgia",825,825,0,0.0
4185,1500000US131899504003,131899504003,"Block Group 3, Census Tract 9504, McDuffie County, Georgia",924,924,0,0.0
4186,1500000US131899504004,131899504004,"Block Group 4, Census Tract 9504, McDuffie County, Georgia",1152,1064,88,7.63888888889
4187,1500000US131899504005,131899504005,"Block Group 5, Census Tract 9504, McDuffie County, Georgia",1128,1128,0,0.0
4188,1500000US131899505001,131899505001,"Block Group 1, Census Tract 9505, McDuffie County, Georgia",1060,1060,0,0.0
4189,1500000US131899505002,131899505002,"Block Group 2, Census Tract 9505, McDuffie County, Georgia",1341,1314,27,2.01342281879
4190,1500000US131899505003,131899505003,"Block Group 3, Census Tract 9505, McDuffie County, Georgia",2084,1862,222,10.6525911708
4191,1500000US131899505004,131899505004,"Block Group 4, Census Tract 9505, McDuffie County, Georgia",1001,1001,0,0.0
4192,1500000US131911101001,131911101001,"Block Group 1, Census Tract 1101, McIntosh County, Georgia",1576,1576,0,0.0
4193,1500000US131911101002,131911101002,"Block Group 2, Census Tract 1101, McIntosh County, Georgia",1425,1399,26,1.82456140351
4194,1500000US131911101003,131911101003,"Block Group 3, Census Tract 1101, McIntosh County, Georgia",899,899,0,0.0
4195,1500000US131911102001,131911102001,"Block Group 1, Census Tract 1102, McIntosh County, Georgia",2486,2486,0,0.0
4196,1500000US131911102002,131911102002,"Block Group 2, Census Tract 1102, McIntosh County, Georgia",1046,1046,0,0.0
4197,1500000US131911102003,131911102003,"Block Group 3, Census Tract 1102, McIntosh County, Georgia",1209,1180,29,2.39867659222
4198,1500000US131911103001,131911103001,"Block Group 1, Census Tract 1103, McIntosh County, Georgia",1384,1382,2,0.14450867052
4199,1500000US131911103002,131911103002,"Block Group 2, Census Tract 1103, McIntosh County, Georgia",1855,1833,22,1.18598382749
4200,1500000US131911103003,131911103003,"Block Group 3, Census Tract 1103, McIntosh County, Georgia",2127,1967,160,7.5223319229
4201,1500000US131919800001,131919800001,"Block Group 1, Census Tract 9800, McIntosh County, Georgia",0,0,0,
4202,1500000US131919900000,131919900000,"Block Group 0, Census Tract 9900, McIntosh County, Georgia",0,0,0,
4203,1500000US131930001001,131930001001,"Block Group 1, Census Tract 1, Macon County, Georgia",1215,1184,31,2.55144032922
4204,1500000US131930001002,131930001002,"Block Group 2, Census Tract 1, Macon County, Georgia",743,743,0,0.0
4205,1500000US131930002001,131930002001,"Block Group 1, Census Tract 2, Macon County, Georgia",1086,1068,18,1.65745856354
4206,1500000US131930002002,131930002002,"Block Group 2, Census Tract 2, Macon County, Georgia",872,868,4,0.45871559633
4207,1500000US131930003001,131930003001,"Block Group 1, Census Tract 3, Macon County, Georgia",2919,2641,278,9.52380952381
4208,1500000US131930003002,131930003002,"Block Group 2, Census Tract 3, Macon County, Georgia",1153,1150,3,0.260190806592
4209,1500000US131930003003,131930003003,"Block Group 3, Census Tract 3, Macon County, Georgia",880,880,0,0.0
4210,1500000US131930004001,131930004001,"Block Group 1, Census Tract 4, Macon County, Georgia",1258,1089,169,13.4340222576
4211,1500000US131930004002,131930004002,"Block Group 2, Census Tract 4, Macon County, Georgia",592,592,0,0.0
4212,1500000US131930004003,131930004003,"Block Group 3, Census Tract 4, Macon County, Georgia",605,567,38,6.28099173554
4213,1500000US131930004004,131930004004,"Block Group 4, Census Tract 4, Macon County, Georgia",1058,1038,20,1.89035916824
4214,1500000US131930004005,131930004005,"Block Group 5, Census Tract 4, Macon County, Georgia",1082,1082,0,0.0
4215,1500000US131930004006,131930004006,"Block Group 6, Census Tract 4, Macon County, Georgia",582,582,0,0.0
4216,1500000US131950201001,131950201001,"Block Group 1, Census Tract 201, Madison County, Georgia",2201,2201,0,0.0
4217,1500000US131950201002,131950201002,"Block Group 2, Census Tract 201, Madison County, Georgia",1510,1273,237,15.6953642384
4218,1500000US131950201003,131950201003,"Block Group 3, Census Tract 201, Madison County, Georgia",1497,1483,14,0.935203740815
4219,1500000US131950202001,131950202001,"Block Group 1, Census Tract 202, Madison County, Georgia",2271,2227,44,1.93747247908
4220,1500000US131950202002,131950202002,"Block Group 2, Census Tract 202, Madison County, Georgia",2683,2648,35,1.304509877
4221,1500000US131950203001,131950203001,"Block Group 1, Census Tract 203, Madison County, Georgia",2396,2382,14,0.584307178631
4222,1500000US131950203002,131950203002,"Block Group 2, Census Tract 203, Madison County, Georgia",1206,1198,8,0.663349917081
4223,1500000US131950203003,131950203003,"Block Group 3, Census Tract 203, Madison County, Georgia",816,811,5,0.612745098039
4224,1500000US131950204001,131950204001,"Block Group 1, Census Tract 204, Madison County, Georgia",2418,2068,350,14.4747725393
4225,1500000US131950204002,131950204002,"Block Group 2, Census Tract 204, Madison County, Georgia",1477,1270,207,14.0148950575
4226,1500000US131950204003,131950204003,"Block Group 3, Census Tract 204, Madison County, Georgia",1584,1576,8,0.505050505051
4227,1500000US131950205001,131950205001,"Block Group 1, Census Tract 205, Madison County, Georgia",2697,2540,157,5.82128290693
4228,1500000US131950205002,131950205002,"Block Group 2, Census Tract 205, Madison County, Georgia",2201,2141,60,2.72603362108
4229,1500000US131950205003,131950205003,"Block Group 3, Census Tract 205, Madison County, Georgia",1114,981,133,11.9389587074
4230,1500000US131950206001,131950206001,"Block Group 1, Census Tract 206, Madison County, Georgia",1029,1029,0,0.0
4231,1500000US131950206002,131950206002,"Block Group 2, Census Tract 206, Madison County, Georgia",1132,1132,0,0.0
4232,1500000US131979201001,131979201001,"Block Group 1, Census Tract 9201, Marion County, Georgia",2014,2014,0,0.0
4233,1500000US131979201002,131979201002,"Block Group 2, Census Tract 9201, Marion County, Georgia",2140,1972,168,7.85046728972
4234,1500000US131979202001,131979202001,"Block Group 1, Census Tract 9202, Marion County, Georgia",2153,1957,196,9.10357640502
4235,1500000US131979202002,131979202002,"Block Group 2, Census Tract 9202, Marion County, Georgia",1226,1226,0,0.0
4236,1500000US131979202003,131979202003,"Block Group 3, Census Tract 9202, Marion County, Georgia",1206,937,269,22.3051409619
4237,1500000US131999705001,131999705001,"Block Group 1, Census Tract 9705, Meriwether County, Georgia",871,871,0,0.0
4238,1500000US131999705002,131999705002,"Block Group 2, Census Tract 9705, Meriwether County, Georgia",1259,1259,0,0.0
4239,1500000US131999705003,131999705003,"Block Group 3, Census Tract 9705, Meriwether County, Georgia",872,872,0,0.0
4240,1500000US131999705004,131999705004,"Block Group 4, Census Tract 9705, Meriwether County, Georgia",803,803,0,0.0
4241,1500000US131999705005,131999705005,"Block Group 5, Census Tract 9705, Meriwether County, Georgia",775,775,0,0.0
4242,1500000US131999705006,131999705006,"Block Group 6, Census Tract 9705, Meriwether County, Georgia",958,958,0,0.0
4243,1500000US131999706001,131999706001,"Block Group 1, Census Tract 9706, Meriwether County, Georgia",924,911,13,1.40692640693
4244,1500000US131999706002,131999706002,"Block Group 2, Census Tract 9706, Meriwether County, Georgia",1571,1486,85,5.41056651814
4245,1500000US131999706003,131999706003,"Block Group 3, Census Tract 9706, Meriwether County, Georgia",1044,1044,0,0.0
4246,1500000US131999707001,131999707001,"Block Group 1, Census Tract 9707, Meriwether County, Georgia",2311,2277,34,1.4712245781
4247,1500000US131999707002,131999707002,"Block Group 2, Census Tract 9707, Meriwether County, Georgia",1384,1269,115,8.30924855491
4248,1500000US131999707003,131999707003,"Block Group 3, Census Tract 9707, Meriwether County, Georgia",1347,1319,28,2.07869339272
4249,1500000US131999707004,131999707004,"Block Group 4, Census Tract 9707, Meriwether County, Georgia",1538,1476,62,4.03120936281
4250,1500000US131999707005,131999707005,"Block Group 5, Census Tract 9707, Meriwether County, Georgia",684,684,0,0.0
4251,1500000US131999708001,131999708001,"Block Group 1, Census Tract 9708, Meriwether County, Georgia",1201,1201,0,0.0
4252,1500000US131999708002,131999708002,"Block Group 2, Census Tract 9708, Meriwether County, Georgia",593,524,69,11.6357504216
4253,1500000US131999708003,131999708003,"Block Group 3, Census Tract 9708, Meriwether County, Georgia",1012,1012,0,0.0
4254,1500000US131999708004,131999708004,"Block Group 4, Census Tract 9708, Meriwether County, Georgia",449,449,0,0.0
4255,1500000US131999708005,131999708005,"Block Group 5, Census Tract 9708, Meriwether County, Georgia",1267,1241,26,2.05209155485
4256,1500000US131999708006,131999708006,"Block Group 6, Census Tract 9708, Meriwether County, Georgia",434,434,0,0.0
4257,1500000US132019501001,132019501001,"Block Group 1, Census Tract 9501, Miller County, Georgia",1616,1616,0,0.0
4258,1500000US132019502001,132019502001,"Block Group 1, Census Tract 9502, Miller County, Georgia",797,791,6,0.752823086575
4259,1500000US132019502002,132019502002,"Block Group 2, Census Tract 9502, Miller County, Georgia",1133,1133,0,0.0
4260,1500000US132019503001,132019503001,"Block Group 1, Census Tract 9503, Miller County, Georgia",753,753,0,0.0
4261,1500000US132019503002,132019503002,"Block Group 2, Census Tract 9503, Miller County, Georgia",1637,1637,0,0.0
4262,1500000US132050901001,132050901001,"Block Group 1, Census Tract 901, Mitchell County, Georgia",1258,1258,0,0.0
4263,1500000US132050901002,132050901002,"Block Group 2, Census Tract 901, Mitchell County, Georgia",2221,2035,186,8.37460603332
4264,1500000US132050902001,132050902001,"Block Group 1, Census Tract 902, Mitchell County, Georgia",968,959,9,0.929752066116
4265,1500000US132050902002,132050902002,"Block Group 2, Census Tract 902, Mitchell County, Georgia",1320,1201,119,9.01515151515
4266,1500000US132050902003,132050902003,"Block Group 3, Census Tract 902, Mitchell County, Georgia",1082,932,150,13.8632162662
4267,1500000US132050903001,132050903001,"Block Group 1, Census Tract 903, Mitchell County, Georgia",582,582,0,0.0
4268,1500000US132050903002,132050903002,"Block Group 2, Census Tract 903, Mitchell County, Georgia",1435,1170,265,18.4668989547
4269,1500000US132050903003,132050903003,"Block Group 3, Census Tract 903, Mitchell County, Georgia",465,451,14,3.01075268817
4270,1500000US132050904001,132050904001,"Block Group 1, Census Tract 904, Mitchell County, Georgia",1635,1543,92,5.62691131498
4271,1500000US132050904002,132050904002,"Block Group 2, Census Tract 904, Mitchell County, Georgia",3651,3558,93,2.5472473295
4272,1500000US132050904003,132050904003,"Block Group 3, Census Tract 904, Mitchell County, Georgia",939,927,12,1.27795527157
4273,1500000US132050904004,132050904004,"Block Group 4, Census Tract 904, Mitchell County, Georgia",1791,1769,22,1.22836404243
4274,1500000US132050905001,132050905001,"Block Group 1, Census Tract 905, Mitchell County, Georgia",762,762,0,0.0
4275,1500000US132050905002,132050905002,"Block Group 2, Census Tract 905, Mitchell County, Georgia",1038,1038,0,0.0
4276,1500000US132050905003,132050905003,"Block Group 3, Census Tract 905, Mitchell County, Georgia",983,983,0,0.0
4277,1500000US132050905004,132050905004,"Block Group 4, Census Tract 905, Mitchell County, Georgia",1211,1179,32,2.64244426094
4278,1500000US132050905005,132050905005,"Block Group 5, Census Tract 905, Mitchell County, Georgia",1641,1634,7,0.426569165143
4279,1500000US132070501011,132070501011,"Block Group 1, Census Tract 501.01, Monroe County, Georgia",2044,1965,79,3.86497064579
4280,1500000US132070501012,132070501012,"Block Group 2, Census Tract 501.01, Monroe County, Georgia",3332,3210,122,3.66146458583
4281,1500000US132070501013,132070501013,"Block Group 3, Census Tract 501.01, Monroe County, Georgia",600,600,0,0.0
4282,1500000US132070501021,132070501021,"Block Group 1, Census Tract 501.02, Monroe County, Georgia",2502,2410,92,3.67705835332
4283,1500000US132070501022,132070501022,"Block Group 2, Census Tract 501.02, Monroe County, Georgia",1572,1567,5,0.318066157761
4284,1500000US132070502001,132070502001,"Block Group 1, Census Tract 502, Monroe County, Georgia",1360,1286,74,5.44117647059
4285,1500000US132070502002,132070502002,"Block Group 2, Census Tract 502, Monroe County, Georgia",1730,1690,40,2.31213872832
4286,1500000US132070502003,132070502003,"Block Group 3, Census Tract 502, Monroe County, Georgia",2721,2721,0,0.0
4287,1500000US132070503011,132070503011,"Block Group 1, Census Tract 503.01, Monroe County, Georgia",1976,1953,23,1.16396761134
4288,1500000US132070503012,132070503012,"Block Group 2, Census Tract 503.01, Monroe County, Georgia",1278,1274,4,0.312989045383
4289,1500000US132070503013,132070503013,"Block Group 3, Census Tract 503.01, Monroe County, Georgia",1464,1446,18,1.22950819672
4290,1500000US132070503021,132070503021,"Block Group 1, Census Tract 503.02, Monroe County, Georgia",1853,1840,13,0.701565029682
4291,1500000US132070503022,132070503022,"Block Group 2, Census Tract 503.02, Monroe County, Georgia",2393,2288,105,4.38779774342
4292,1500000US132070503023,132070503023,"Block Group 3, Census Tract 503.02, Monroe County, Georgia",2090,2060,30,1.43540669856
4293,1500000US132099501001,132099501001,"Block Group 1, Census Tract 9501, Montgomery County, Georgia",1346,1346,0,0.0
4294,1500000US132099501002,132099501002,"Block Group 2, Census Tract 9501, Montgomery County, Georgia",722,670,52,7.20221606648
4295,1500000US132099502001,132099502001,"Block Group 1, Census Tract 9502, Montgomery County, Georgia",1307,1156,151,11.5531752104
4296,1500000US132099502002,132099502002,"Block Group 2, Census Tract 9502, Montgomery County, Georgia",1823,1627,196,10.7515085025
4297,1500000US132099502003,132099502003,"Block Group 3, Census Tract 9502, Montgomery County, Georgia",1701,1678,23,1.35214579659
4298,1500000US132099503001,132099503001,"Block Group 1, Census Tract 9503, Montgomery County, Georgia",1146,1112,34,2.96684118674
4299,1500000US132099503002,132099503002,"Block Group 2, Census Tract 9503, Montgomery County, Georgia",923,841,82,8.88407367281
4300,1500000US132110101001,132110101001,"Block Group 1, Census Tract 101, Morgan County, Georgia",2817,2641,176,6.24778132765
4301,1500000US132110102001,132110102001,"Block Group 1, Census Tract 102, Morgan County, Georgia",2684,2684,0,0.0
4302,1500000US132110102002,132110102002,"Block Group 2, Census Tract 102, Morgan County, Georgia",1160,1157,3,0.258620689655
4303,1500000US132110103001,132110103001,"Block Group 1, Census Tract 103, Morgan County, Georgia",2310,2213,97,4.19913419913
4304,1500000US132110103002,132110103002,"Block Group 2, Census Tract 103, Morgan County, Georgia",1154,1154,0,0.0
4305,1500000US132110103003,132110103003,"Block Group 3, Census Tract 103, Morgan County, Georgia",2398,2392,6,0.250208507089
4306,1500000US132110103004,132110103004,"Block Group 4, Census Tract 103, Morgan County, Georgia",954,941,13,1.36268343816
4307,1500000US132110104001,132110104001,"Block Group 1, Census Tract 104, Morgan County, Georgia",3004,2859,145,4.82689747004
4308,1500000US132110105001,132110105001,"Block Group 1, Census Tract 105, Morgan County, Georgia",1419,1335,84,5.91966173362
4309,1500000US132130101001,132130101001,"Block Group 1, Census Tract 101, Murray County, Georgia",841,841,0,0.0
4310,1500000US132130101002,132130101002,"Block Group 2, Census Tract 101, Murray County, Georgia",539,539,0,0.0
4311,1500000US132130101003,132130101003,"Block Group 3, Census Tract 101, Murray County, Georgia",956,786,170,17.7824267782
4312,1500000US132130101004,132130101004,"Block Group 4, Census Tract 101, Murray County, Georgia",930,923,7,0.752688172043
4313,1500000US132130102011,132130102011,"Block Group 1, Census Tract 102.01, Murray County, Georgia",1994,1921,73,3.66098294885
4314,1500000US132130102021,132130102021,"Block Group 1, Census Tract 102.02, Murray County, Georgia",3785,3166,619,16.3540290621
4315,1500000US132130102022,132130102022,"Block Group 2, Census Tract 102.02, Murray County, Georgia",1635,1561,74,4.52599388379
4316,1500000US132130102023,132130102023,"Block Group 3, Census Tract 102.02, Murray County, Georgia",2658,1640,1018,38.2994732882
4317,1500000US132130102024,132130102024,"Block Group 4, Census Tract 102.02, Murray County, Georgia",973,642,331,34.0184994861
4318,1500000US132130103001,132130103001,"Block Group 1, Census Tract 103, Murray County, Georgia",553,553,0,0.0
4319,1500000US132130103002,132130103002,"Block Group 2, Census Tract 103, Murray County, Georgia",1607,1580,27,1.68014934661
4320,1500000US132130103003,132130103003,"Block Group 3, Census Tract 103, Murray County, Georgia",1722,1657,65,3.77468060395
4321,1500000US132130104001,132130104001,"Block Group 1, Census Tract 104, Murray County, Georgia",1490,1422,68,4.56375838926
4322,1500000US132130104002,132130104002,"Block Group 2, Census Tract 104, Murray County, Georgia",790,790,0,0.0
4323,1500000US132130104003,132130104003,"Block Group 3, Census Tract 104, Murray County, Georgia",2607,2046,561,21.5189873418
4324,1500000US132130104004,132130104004,"Block Group 4, Census Tract 104, Murray County, Georgia",1198,1143,55,4.59098497496
4325,1500000US132130105001,132130105001,"Block Group 1, Census Tract 105, Murray County, Georgia",640,623,17,2.65625
4326,1500000US132130105002,132130105002,"Block Group 2, Census Tract 105, Murray County, Georgia",2147,1544,603,28.0857009781
4327,1500000US132130105003,132130105003,"Block Group 3, Census Tract 105, Murray County, Georgia",2527,1824,703,27.8195488722
4328,1500000US132130106001,132130106001,"Block Group 1, Census Tract 106, Murray County, Georgia",1454,1325,129,8.87207702889
4329,1500000US132130106002,132130106002,"Block Group 2, Census Tract 106, Murray County, Georgia",1527,1383,144,9.43025540275
4330,1500000US132130106003,132130106003,"Block Group 3, Census Tract 106, Murray County, Georgia",1161,1161,0,0.0
4331,1500000US132130107001,132130107001,"Block Group 1, Census Tract 107, Murray County, Georgia",1905,1731,174,9.13385826772
4332,1500000US132130107002,132130107002,"Block Group 2, Census Tract 107, Murray County, Georgia",1754,1149,605,34.4925883694
4333,1500000US132130107003,132130107003,"Block Group 3, Census Tract 107, Murray County, Georgia",436,436,0,0.0
4334,1500000US132130107004,132130107004,"Block Group 4, Census Tract 107, Murray County, Georgia",1572,1522,50,3.18066157761
4335,1500000US132150002001,132150002001,"Block Group 1, Census Tract 2, Muscogee County, Georgia",1646,1447,199,12.0899149453
4336,1500000US132150002002,132150002002,"Block Group 2, Census Tract 2, Muscogee County, Georgia",1187,1129,58,4.88626790227
4337,1500000US132150003001,132150003001,"Block Group 1, Census Tract 3, Muscogee County, Georgia",774,574,200,25.8397932817
4338,1500000US132150003002,132150003002,"Block Group 2, Census Tract 3, Muscogee County, Georgia",605,369,236,39.0082644628
4339,1500000US132150004001,132150004001,"Block Group 1, Census Tract 4, Muscogee County, Georgia",911,911,0,0.0
4340,1500000US132150004002,132150004002,"Block Group 2, Census Tract 4, Muscogee County, Georgia",1114,1087,27,2.4236983842
4341,1500000US132150004003,132150004003,"Block Group 3, Census Tract 4, Muscogee County, Georgia",736,705,31,4.21195652174
4342,1500000US132150008001,132150008001,"Block Group 1, Census Tract 8, Muscogee County, Georgia",1040,973,67,6.44230769231
4343,1500000US132150008002,132150008002,"Block Group 2, Census Tract 8, Muscogee County, Georgia",1349,1237,112,8.30244625649
4344,1500000US132150009001,132150009001,"Block Group 1, Census Tract 9, Muscogee County, Georgia",1104,1003,101,9.14855072464
4345,1500000US132150009002,132150009002,"Block Group 2, Census Tract 9, Muscogee County, Georgia",1537,1453,84,5.46519193234
4346,1500000US132150010001,132150010001,"Block Group 1, Census Tract 10, Muscogee County, Georgia",1752,1660,92,5.25114155251
4347,1500000US132150010002,132150010002,"Block Group 2, Census Tract 10, Muscogee County, Georgia",1971,1804,167,8.47285641806
4348,1500000US132150010003,132150010003,"Block Group 3, Census Tract 10, Muscogee County, Georgia",700,676,24,3.42857142857
4349,1500000US132150011001,132150011001,"Block Group 1, Census Tract 11, Muscogee County, Georgia",1700,1636,64,3.76470588235
4350,1500000US132150011002,132150011002,"Block Group 2, Census Tract 11, Muscogee County, Georgia",938,938,0,0.0
4351,1500000US132150012001,132150012001,"Block Group 1, Census Tract 12, Muscogee County, Georgia",1184,1111,73,6.16554054054
4352,1500000US132150012002,132150012002,"Block Group 2, Census Tract 12, Muscogee County, Georgia",1071,1049,22,2.05415499533
4353,1500000US132150012003,132150012003,"Block Group 3, Census Tract 12, Muscogee County, Georgia",1153,1143,10,0.867302688638
4354,1500000US132150014001,132150014001,"Block Group 1, Census Tract 14, Muscogee County, Georgia",1004,956,48,4.78087649402
4355,1500000US132150014002,132150014002,"Block Group 2, Census Tract 14, Muscogee County, Georgia",814,768,46,5.65110565111
4356,1500000US132150016001,132150016001,"Block Group 1, Census Tract 16, Muscogee County, Georgia",1395,1319,76,5.44802867384
4357,1500000US132150016002,132150016002,"Block Group 2, Census Tract 16, Muscogee County, Georgia",971,962,9,0.926879505664
4358,1500000US132150018001,132150018001,"Block Group 1, Census Tract 18, Muscogee County, Georgia",1202,1114,88,7.32113144759
4359,1500000US132150020001,132150020001,"Block Group 1, Census Tract 20, Muscogee County, Georgia",2587,2478,109,4.21337456513
4360,1500000US132150020002,132150020002,"Block Group 2, Census Tract 20, Muscogee County, Georgia",988,980,8,0.80971659919
4361,1500000US132150021001,132150021001,"Block Group 1, Census Tract 21, Muscogee County, Georgia",807,749,58,7.18711276332
4362,1500000US132150021002,132150021002,"Block Group 2, Census Tract 21, Muscogee County, Georgia",1740,1650,90,5.1724137931
4363,1500000US132150022001,132150022001,"Block Group 1, Census Tract 22, Muscogee County, Georgia",990,990,0,0.0
4364,1500000US132150022002,132150022002,"Block Group 2, Census Tract 22, Muscogee County, Georgia",835,835,0,0.0
4365,1500000US132150022003,132150022003,"Block Group 3, Census Tract 22, Muscogee County, Georgia",342,342,0,0.0
4366,1500000US132150022004,132150022004,"Block Group 4, Census Tract 22, Muscogee County, Georgia",1185,1153,32,2.70042194093
4367,1500000US132150023001,132150023001,"Block Group 1, Census Tract 23, Muscogee County, Georgia",1461,1374,87,5.95482546201
4368,1500000US132150024001,132150024001,"Block Group 1, Census Tract 24, Muscogee County, Georgia",1515,1477,38,2.50825082508
4369,1500000US132150025001,132150025001,"Block Group 1, Census Tract 25, Muscogee County, Georgia",1299,1258,41,3.15627405697
4370,1500000US132150025002,132150025002,"Block Group 2, Census Tract 25, Muscogee County, Georgia",582,529,53,9.10652920962
4371,1500000US132150027001,132150027001,"Block Group 1, Census Tract 27, Muscogee County, Georgia",2187,2187,0,0.0
4372,1500000US132150028001,132150028001,"Block Group 1, Census Tract 28, Muscogee County, Georgia",840,763,77,9.16666666667
4373,1500000US132150028002,132150028002,"Block Group 2, Census Tract 28, Muscogee County, Georgia",1017,1003,14,1.37659783677
4374,1500000US132150029011,132150029011,"Block Group 1, Census Tract 29.01, Muscogee County, Georgia",803,803,0,0.0
4375,1500000US132150029012,132150029012,"Block Group 2, Census Tract 29.01, Muscogee County, Georgia",2069,1864,205,9.9081681972
4376,1500000US132150029021,132150029021,"Block Group 1, Census Tract 29.02, Muscogee County, Georgia",1409,1343,66,4.68417317246
4377,1500000US132150029022,132150029022,"Block Group 2, Census Tract 29.02, Muscogee County, Georgia",955,940,15,1.57068062827
4378,1500000US132150030001,132150030001,"Block Group 1, Census Tract 30, Muscogee County, Georgia",444,287,157,35.3603603604
4379,1500000US132150030002,132150030002,"Block Group 2, Census Tract 30, Muscogee County, Georgia",1469,1445,24,1.63376446562
4380,1500000US132150030003,132150030003,"Block Group 3, Census Tract 30, Muscogee County, Georgia",687,687,0,0.0
4381,1500000US132150032001,132150032001,"Block Group 1, Census Tract 32, Muscogee County, Georgia",340,340,0,0.0
4382,1500000US132150032002,132150032002,"Block Group 2, Census Tract 32, Muscogee County, Georgia",732,732,0,0.0
4383,1500000US132150032003,132150032003,"Block Group 3, Census Tract 32, Muscogee County, Georgia",699,525,174,24.8927038627
4384,1500000US132150033011,132150033011,"Block Group 1, Census Tract 33.01, Muscogee County, Georgia",1428,1405,23,1.6106442577
4385,1500000US132150033021,132150033021,"Block Group 1, Census Tract 33.02, Muscogee County, Georgia",825,756,69,8.36363636364
4386,1500000US132150033022,132150033022,"Block Group 2, Census Tract 33.02, Muscogee County, Georgia",962,924,38,3.9501039501
4387,1500000US132150033023,132150033023,"Block Group 3, Census Tract 33.02, Muscogee County, Georgia",887,887,0,0.0
4388,1500000US132150034001,132150034001,"Block Group 1, Census Tract 34, Muscogee County, Georgia",716,706,10,1.39664804469
4389,1500000US132150034002,132150034002,"Block Group 2, Census Tract 34, Muscogee County, Georgia",1609,1343,266,16.532007458
4390,1500000US132150101041,132150101041,"Block Group 1, Census Tract 101.04, Muscogee County, Georgia",1655,1531,124,7.49244712991
4391,1500000US132150101042,132150101042,"Block Group 2, Census Tract 101.04, Muscogee County, Georgia",3004,2613,391,13.0159786951
4392,1500000US132150101043,132150101043,"Block Group 3, Census Tract 101.04, Muscogee County, Georgia",1918,1807,111,5.78727841502
4393,1500000US132150101061,132150101061,"Block Group 1, Census Tract 101.06, Muscogee County, Georgia",698,686,12,1.71919770774
4394,1500000US132150101062,132150101062,"Block Group 2, Census Tract 101.06, Muscogee County, Georgia",1875,1763,112,5.97333333333
4395,1500000US132150101063,132150101063,"Block Group 3, Census Tract 101.06, Muscogee County, Georgia",2937,2508,429,14.606741573
4396,1500000US132150101071,132150101071,"Block Group 1, Census Tract 101.07, Muscogee County, Georgia",3299,3224,75,2.27341618672
4397,1500000US132150101072,132150101072,"Block Group 2, Census Tract 101.07, Muscogee County, Georgia",4456,3968,488,10.9515260323
4398,1500000US132150102011,132150102011,"Block Group 1, Census Tract 102.01, Muscogee County, Georgia",4448,3998,450,10.1169064748
4399,1500000US132150102012,132150102012,"Block Group 2, Census Tract 102.01, Muscogee County, Georgia",2314,2284,30,1.29645635264
4400,1500000US132150102031,132150102031,"Block Group 1, Census Tract 102.03, Muscogee County, Georgia",3742,3459,283,7.56280064137
4401,1500000US132150102032,132150102032,"Block Group 2, Census Tract 102.03, Muscogee County, Georgia",5076,4679,397,7.82111899133
4402,1500000US132150102041,132150102041,"Block Group 1, Census Tract 102.04, Muscogee County, Georgia",2241,2051,190,8.47835787595
4403,1500000US132150102042,132150102042,"Block Group 2, Census Tract 102.04, Muscogee County, Georgia",1536,1431,105,6.8359375
4404,1500000US132150102043,132150102043,"Block Group 3, Census Tract 102.04, Muscogee County, Georgia",2891,2657,234,8.09408509166
4405,1500000US132150102051,132150102051,"Block Group 1, Census Tract 102.05, Muscogee County, Georgia",1523,1388,135,8.86408404465
4406,1500000US132150102052,132150102052,"Block Group 2, Census Tract 102.05, Muscogee County, Georgia",1981,1914,67,3.38213023725
4407,1500000US132150103011,132150103011,"Block Group 1, Census Tract 103.01, Muscogee County, Georgia",2529,2491,38,1.50257018584
4408,1500000US132150103021,132150103021,"Block Group 1, Census Tract 103.02, Muscogee County, Georgia",1702,1702,0,0.0
4409,1500000US132150103022,132150103022,"Block Group 2, Census Tract 103.02, Muscogee County, Georgia",2733,2523,210,7.68386388584
4410,1500000US132150103023,132150103023,"Block Group 3, Census Tract 103.02, Muscogee County, Georgia",2521,2385,136,5.39468464895
4411,1500000US132150104011,132150104011,"Block Group 1, Census Tract 104.01, Muscogee County, Georgia",2165,2072,93,4.29561200924
4412,1500000US132150104012,132150104012,"Block Group 2, Census Tract 104.01, Muscogee County, Georgia",2936,2371,565,19.2438692098
4413,1500000US132150104013,132150104013,"Block Group 3, Census Tract 104.01, Muscogee County, Georgia",1545,1462,83,5.37216828479
4414,1500000US132150104021,132150104021,"Block Group 1, Census Tract 104.02, Muscogee County, Georgia",1097,894,203,18.5050136737
4415,1500000US132150104022,132150104022,"Block Group 2, Census Tract 104.02, Muscogee County, Georgia",1430,1350,80,5.59440559441
4416,1500000US132150104023,132150104023,"Block Group 3, Census Tract 104.02, Muscogee County, Georgia",1699,1581,118,6.94526191878
4417,1500000US132150105011,132150105011,"Block Group 1, Census Tract 105.01, Muscogee County, Georgia",1128,1088,40,3.54609929078
4418,1500000US132150105012,132150105012,"Block Group 2, Census Tract 105.01, Muscogee County, Georgia",1772,1624,148,8.35214446953
4419,1500000US132150105013,132150105013,"Block Group 3, Census Tract 105.01, Muscogee County, Georgia",1598,1576,22,1.37672090113
4420,1500000US132150105014,132150105014,"Block Group 4, Census Tract 105.01, Muscogee County, Georgia",1533,1500,33,2.15264187867
4421,1500000US132150105021,132150105021,"Block Group 1, Census Tract 105.02, Muscogee County, Georgia",1598,1444,154,9.63704630788
4422,1500000US132150106021,132150106021,"Block Group 1, Census Tract 106.02, Muscogee County, Georgia",2280,2088,192,8.42105263158
4423,1500000US132150106022,132150106022,"Block Group 2, Census Tract 106.02, Muscogee County, Georgia",493,456,37,7.50507099391
4424,1500000US132150106023,132150106023,"Block Group 3, Census Tract 106.02, Muscogee County, Georgia",2615,2485,130,4.97131931166
4425,1500000US132150106051,132150106051,"Block Group 1, Census Tract 106.05, Muscogee County, Georgia",2190,1990,200,9.13242009132
4426,1500000US132150106052,132150106052,"Block Group 2, Census Tract 106.05, Muscogee County, Georgia",2307,2254,53,2.29735587343
4427,1500000US132150106061,132150106061,"Block Group 1, Census Tract 106.06, Muscogee County, Georgia",2406,2268,138,5.73566084788
4428,1500000US132150106071,132150106071,"Block Group 1, Census Tract 106.07, Muscogee County, Georgia",1292,1292,0,0.0
4429,1500000US132150106072,132150106072,"Block Group 2, Census Tract 106.07, Muscogee County, Georgia",2002,1956,46,2.2977022977
4430,1500000US132150106073,132150106073,"Block Group 3, Census Tract 106.07, Muscogee County, Georgia",2674,2663,11,0.411368735976
4431,1500000US132150106081,132150106081,"Block Group 1, Census Tract 106.08, Muscogee County, Georgia",2373,2314,59,2.48630425622
4432,1500000US132150106082,132150106082,"Block Group 2, Census Tract 106.08, Muscogee County, Georgia",2211,2161,50,2.26142017187
4433,1500000US132150107011,132150107011,"Block Group 1, Census Tract 107.01, Muscogee County, Georgia",2091,2044,47,2.24772835964
4434,1500000US132150107012,132150107012,"Block Group 2, Census Tract 107.01, Muscogee County, Georgia",2170,1903,267,12.3041474654
4435,1500000US132150107013,132150107013,"Block Group 3, Census Tract 107.01, Muscogee County, Georgia",1876,1817,59,3.14498933902
4436,1500000US132150107021,132150107021,"Block Group 1, Census Tract 107.02, Muscogee County, Georgia",769,702,67,8.71261378414
4437,1500000US132150107022,132150107022,"Block Group 2, Census Tract 107.02, Muscogee County, Georgia",2328,2276,52,2.23367697595
4438,1500000US132150107023,132150107023,"Block Group 3, Census Tract 107.02, Muscogee County, Georgia",1828,1783,45,2.46170678337
4439,1500000US132150107031,132150107031,"Block Group 1, Census Tract 107.03, Muscogee County, Georgia",1782,1710,72,4.0404040404
4440,1500000US132150107032,132150107032,"Block Group 2, Census Tract 107.03, Muscogee County, Georgia",2271,2271,0,0.0
4441,1500000US132150107033,132150107033,"Block Group 3, Census Tract 107.03, Muscogee County, Georgia",1151,1151,0,0.0
4442,1500000US132150107034,132150107034,"Block Group 4, Census Tract 107.03, Muscogee County, Georgia",945,925,20,2.1164021164
4443,1500000US132150108011,132150108011,"Block Group 1, Census Tract 108.01, Muscogee County, Georgia",308,296,12,3.8961038961
4444,1500000US132150108012,132150108012,"Block Group 2, Census Tract 108.01, Muscogee County, Georgia",1288,1057,231,17.9347826087
4445,1500000US132150108021,132150108021,"Block Group 1, Census Tract 108.02, Muscogee County, Georgia",2390,2012,378,15.8158995816
4446,1500000US132150108022,132150108022,"Block Group 2, Census Tract 108.02, Muscogee County, Georgia",6767,5290,1477,21.8265110093
4447,1500000US132150108023,132150108023,"Block Group 3, Census Tract 108.02, Muscogee County, Georgia",1017,813,204,20.0589970501
4448,1500000US132150111001,132150111001,"Block Group 1, Census Tract 111, Muscogee County, Georgia",1470,1405,65,4.42176870748
4449,1500000US132150111002,132150111002,"Block Group 2, Census Tract 111, Muscogee County, Georgia",567,567,0,0.0
4450,1500000US132150112001,132150112001,"Block Group 1, Census Tract 112, Muscogee County, Georgia",1191,1137,54,4.53400503778
4451,1500000US132150112002,132150112002,"Block Group 2, Census Tract 112, Muscogee County, Georgia",1041,983,58,5.57156580211
4452,1500000US132150114001,132150114001,"Block Group 1, Census Tract 114, Muscogee County, Georgia",1535,1414,121,7.88273615635
4453,1500000US132150114002,132150114002,"Block Group 2, Census Tract 114, Muscogee County, Georgia",732,633,99,13.5245901639
4454,1500000US132150115001,132150115001,"Block Group 1, Census Tract 115, Muscogee County, Georgia",1027,694,333,32.4245374878
4455,1500000US132150115002,132150115002,"Block Group 2, Census Tract 115, Muscogee County, Georgia",488,488,0,0.0
4456,1500000US132150115003,132150115003,"Block Group 3, Census Tract 115, Muscogee County, Georgia",1657,1385,272,16.4152082076
4457,1500000US132150115004,132150115004,"Block Group 4, Census Tract 115, Muscogee County, Georgia",1241,1078,163,13.1345688961
4458,1500000US132150115005,132150115005,"Block Group 5, Census Tract 115, Muscogee County, Georgia",1127,677,450,39.9290150843
4459,1500000US132150115006,132150115006,"Block Group 6, Census Tract 115, Muscogee County, Georgia",538,492,46,8.55018587361
4460,1500000US132171001001,132171001001,"Block Group 1, Census Tract 1001, Newton County, Georgia",2455,2435,20,0.81466395112
4461,1500000US132171001002,132171001002,"Block Group 2, Census Tract 1001, Newton County, Georgia",3098,3053,45,1.45255003228
4462,1500000US132171001003,132171001003,"Block Group 3, Census Tract 1001, Newton County, Georgia",2795,2795,0,0.0
4463,1500000US132171001004,132171001004,"Block Group 4, Census Tract 1001, Newton County, Georgia",3070,2958,112,3.64820846906
4464,1500000US132171002011,132171002011,"Block Group 1, Census Tract 1002.01, Newton County, Georgia",1971,1971,0,0.0
4465,1500000US132171002012,132171002012,"Block Group 2, Census Tract 1002.01, Newton County, Georgia",1269,1201,68,5.3585500394
4466,1500000US132171002013,132171002013,"Block Group 3, Census Tract 1002.01, Newton County, Georgia",2814,2791,23,0.817341862118
4467,1500000US132171002021,132171002021,"Block Group 1, Census Tract 1002.02, Newton County, Georgia",2888,2862,26,0.90027700831
4468,1500000US132171002022,132171002022,"Block Group 2, Census Tract 1002.02, Newton County, Georgia",2158,2081,77,3.56811862836
4469,1500000US132171003001,132171003001,"Block Group 1, Census Tract 1003, Newton County, Georgia",2498,2110,388,15.5324259408
4470,1500000US132171003002,132171003002,"Block Group 2, Census Tract 1003, Newton County, Georgia",3125,2846,279,8.928
4471,1500000US132171003003,132171003003,"Block Group 3, Census Tract 1003, Newton County, Georgia",2442,2310,132,5.40540540541
4472,1500000US132171003004,132171003004,"Block Group 4, Census Tract 1003, Newton County, Georgia",1103,1103,0,0.0
4473,1500000US132171004001,132171004001,"Block Group 1, Census Tract 1004, Newton County, Georgia",2406,2207,199,8.27098919368
4474,1500000US132171004002,132171004002,"Block Group 2, Census Tract 1004, Newton County, Georgia",1171,1157,14,1.19555935098
4475,1500000US132171005011,132171005011,"Block Group 1, Census Tract 1005.01, Newton County, Georgia",5602,4918,684,12.2099250268
4476,1500000US132171005012,132171005012,"Block Group 2, Census Tract 1005.01, Newton County, Georgia",8924,8794,130,1.45674585388
4477,1500000US132171005013,132171005013,"Block Group 3, Census Tract 1005.01, Newton County, Georgia",978,836,142,14.5194274029
4478,1500000US132171005021,132171005021,"Block Group 1, Census Tract 1005.02, Newton County, Georgia",5362,5108,254,4.7370384185
4479,1500000US132171005022,132171005022,"Block Group 2, Census Tract 1005.02, Newton County, Georgia",3012,2634,378,12.5498007968
4480,1500000US132171006001,132171006001,"Block Group 1, Census Tract 1006, Newton County, Georgia",3640,3551,89,2.44505494505
4481,1500000US132171006002,132171006002,"Block Group 2, Census Tract 1006, Newton County, Georgia",1944,1781,163,8.38477366255
4482,1500000US132171007001,132171007001,"Block Group 1, Census Tract 1007, Newton County, Georgia",980,980,0,0.0
4483,1500000US132171007002,132171007002,"Block Group 2, Census Tract 1007, Newton County, Georgia",2435,2206,229,9.4045174538
4484,1500000US132171007003,132171007003,"Block Group 3, Census Tract 1007, Newton County, Georgia",2724,2636,88,3.23054331865
4485,1500000US132171008001,132171008001,"Block Group 1, Census Tract 1008, Newton County, Georgia",3847,3663,184,4.78294775149
4486,1500000US132171008002,132171008002,"Block Group 2, Census Tract 1008, Newton County, Georgia",5899,5899,0,0.0
4487,1500000US132171009011,132171009011,"Block Group 1, Census Tract 1009.01, Newton County, Georgia",4170,3943,227,5.44364508393
4488,1500000US132171009012,132171009012,"Block Group 2, Census Tract 1009.01, Newton County, Georgia",3445,3445,0,0.0
4489,1500000US132171009013,132171009013,"Block Group 3, Census Tract 1009.01, Newton County, Georgia",2419,2419,0,0.0
4490,1500000US132171009021,132171009021,"Block Group 1, Census Tract 1009.02, Newton County, Georgia",2960,2899,61,2.06081081081
4491,1500000US132171009022,132171009022,"Block Group 2, Census Tract 1009.02, Newton County, Georgia",2906,2384,522,17.9628355127
4492,1500000US132171009031,132171009031,"Block Group 1, Census Tract 1009.03, Newton County, Georgia",4924,4465,459,9.32168968318
4493,1500000US132171009032,132171009032,"Block Group 2, Census Tract 1009.03, Newton County, Georgia",1211,1181,30,2.47729149463
4494,1500000US132190301001,132190301001,"Block Group 1, Census Tract 301, Oconee County, Georgia",3854,3769,85,2.20550077841
4495,1500000US132190301002,132190301002,"Block Group 2, Census Tract 301, Oconee County, Georgia",4170,3866,304,7.29016786571
4496,1500000US132190301003,132190301003,"Block Group 3, Census Tract 301, Oconee County, Georgia",2061,1806,255,12.3726346434
4497,1500000US132190301004,132190301004,"Block Group 4, Census Tract 301, Oconee County, Georgia",1496,1485,11,0.735294117647
4498,1500000US132190302001,132190302001,"Block Group 1, Census Tract 302, Oconee County, Georgia",2637,2343,294,11.149032992
4499,1500000US132190302002,132190302002,"Block Group 2, Census Tract 302, Oconee County, Georgia",2876,2783,93,3.23365785814
4500,1500000US132190303001,132190303001,"Block Group 1, Census Tract 303, Oconee County, Georgia",3031,2866,165,5.44374793797
4501,1500000US132190303002,132190303002,"Block Group 2, Census Tract 303, Oconee County, Georgia",2141,2104,37,1.72816440915
4502,1500000US132190304001,132190304001,"Block Group 1, Census Tract 304, Oconee County, Georgia",1855,1792,63,3.39622641509
4503,1500000US132190304002,132190304002,"Block Group 2, Census Tract 304, Oconee County, Georgia",2160,2160,0,0.0
4504,1500000US132190304003,132190304003,"Block Group 3, Census Tract 304, Oconee County, Georgia",3227,3122,105,3.25379609544
4505,1500000US132190305001,132190305001,"Block Group 1, Census Tract 305, Oconee County, Georgia",2118,2080,38,1.79414542021
4506,1500000US132190306001,132190306001,"Block Group 1, Census Tract 306, Oconee County, Georgia",1923,1768,155,8.0603224129
4507,1500000US132190306002,132190306002,"Block Group 2, Census Tract 306, Oconee County, Georgia",851,851,0,0.0
4508,1500000US132219601001,132219601001,"Block Group 1, Census Tract 9601, Oglethorpe County, Georgia",816,775,41,5.02450980392
4509,1500000US132219601002,132219601002,"Block Group 2, Census Tract 9601, Oglethorpe County, Georgia",927,927,0,0.0
4510,1500000US132219602011,132219602011,"Block Group 1, Census Tract 9602.01, Oglethorpe County, Georgia",1879,1763,116,6.17349654071
4511,1500000US132219602012,132219602012,"Block Group 2, Census Tract 9602.01, Oglethorpe County, Georgia",1359,1352,7,0.515084621045
4512,1500000US132219602013,132219602013,"Block Group 3, Census Tract 9602.01, Oglethorpe County, Georgia",3459,3259,200,5.78201792426
4513,1500000US132219602021,132219602021,"Block Group 1, Census Tract 9602.02, Oglethorpe County, Georgia",1635,1542,93,5.6880733945
4514,1500000US132219602022,132219602022,"Block Group 2, Census Tract 9602.02, Oglethorpe County, Georgia",1051,1036,15,1.42721217888
4515,1500000US132219602023,132219602023,"Block Group 3, Census Tract 9602.02, Oglethorpe County, Georgia",1879,1850,29,1.54337413518
4516,1500000US132219603001,132219603001,"Block Group 1, Census Tract 9603, Oglethorpe County, Georgia",1683,1606,77,4.57516339869
4517,1500000US132231201011,132231201011,"Block Group 1, Census Tract 1201.01, Paulding County, Georgia",5869,5869,0,0.0
4518,1500000US132231201012,132231201012,"Block Group 2, Census Tract 1201.01, Paulding County, Georgia",4608,4359,249,5.40364583333
4519,1500000US132231201013,132231201013,"Block Group 3, Census Tract 1201.01, Paulding County, Georgia",1419,1389,30,2.11416490486
4520,1500000US132231201021,132231201021,"Block Group 1, Census Tract 1201.02, Paulding County, Georgia",5931,5227,704,11.8698364525
4521,1500000US132231201022,132231201022,"Block Group 2, Census Tract 1201.02, Paulding County, Georgia",5993,5697,296,4.93909561155
4522,1500000US132231201031,132231201031,"Block Group 1, Census Tract 1201.03, Paulding County, Georgia",2665,2391,274,10.2814258912
4523,1500000US132231201032,132231201032,"Block Group 2, Census Tract 1201.03, Paulding County, Georgia",6987,6844,143,2.04665807929
4524,1500000US132231201041,132231201041,"Block Group 1, Census Tract 1201.04, Paulding County, Georgia",2367,2349,18,0.760456273764
4525,1500000US132231202021,132231202021,"Block Group 1, Census Tract 1202.02, Paulding County, Georgia",5187,5105,82,1.58087526509
4526,1500000US132231202022,132231202022,"Block Group 2, Census Tract 1202.02, Paulding County, Georgia",2557,2272,285,11.1458740712
4527,1500000US132231202031,132231202031,"Block Group 1, Census Tract 1202.03, Paulding County, Georgia",2437,2356,81,3.32375871974
4528,1500000US132231202032,132231202032,"Block Group 2, Census Tract 1202.03, Paulding County, Georgia",2621,2576,45,1.71690194582
4529,1500000US132231202041,132231202041,"Block Group 1, Census Tract 1202.04, Paulding County, Georgia",3950,3837,113,2.86075949367
4530,1500000US132231202042,132231202042,"Block Group 2, Census Tract 1202.04, Paulding County, Georgia",2711,2623,88,3.24603467355
4531,1500000US132231203011,132231203011,"Block Group 1, Census Tract 1203.01, Paulding County, Georgia",3743,3592,151,4.03419716805
4532,1500000US132231203012,132231203012,"Block Group 2, Census Tract 1203.01, Paulding County, Georgia",1546,1383,163,10.5433376455
4533,1500000US132231203021,132231203021,"Block Group 1, Census Tract 1203.02, Paulding County, Georgia",2286,2137,149,6.51793525809
4534,1500000US132231203022,132231203022,"Block Group 2, Census Tract 1203.02, Paulding County, Georgia",3949,3860,89,2.25373512282
4535,1500000US132231203023,132231203023,"Block Group 3, Census Tract 1203.02, Paulding County, Georgia",4031,3445,586,14.5373356487
4536,1500000US132231203024,132231203024,"Block Group 4, Census Tract 1203.02, Paulding County, Georgia",3747,2576,1171,31.2516680011
4537,1500000US132231203031,132231203031,"Block Group 1, Census Tract 1203.03, Paulding County, Georgia",1833,1797,36,1.96399345336
4538,1500000US132231204001,132231204001,"Block Group 1, Census Tract 1204, Paulding County, Georgia",7050,6897,153,2.17021276596
4539,1500000US132231204002,132231204002,"Block Group 2, Census Tract 1204, Paulding County, Georgia",5743,5654,89,1.54971269371
4540,1500000US132231204003,132231204003,"Block Group 3, Census Tract 1204, Paulding County, Georgia",1775,1696,79,4.45070422535
4541,1500000US132231204004,132231204004,"Block Group 4, Census Tract 1204, Paulding County, Georgia",3735,3735,0,0.0
4542,1500000US132231205011,132231205011,"Block Group 1, Census Tract 1205.01, Paulding County, Georgia",3706,3109,597,16.1090124123
4543,1500000US132231205012,132231205012,"Block Group 2, Census Tract 1205.01, Paulding County, Georgia",2506,2460,46,1.83559457302
4544,1500000US132231205021,132231205021,"Block Group 1, Census Tract 1205.02, Paulding County, Georgia",1589,1589,0,0.0
4545,1500000US132231205022,132231205022,"Block Group 2, Census Tract 1205.02, Paulding County, Georgia",1459,1373,86,5.89444825223
4546,1500000US132231205023,132231205023,"Block Group 3, Census Tract 1205.02, Paulding County, Georgia",2899,2704,195,6.7264573991
4547,1500000US132231205024,132231205024,"Block Group 4, Census Tract 1205.02, Paulding County, Georgia",1675,1675,0,0.0
4548,1500000US132231205025,132231205025,"Block Group 5, Census Tract 1205.02, Paulding County, Georgia",1401,1167,234,16.7023554604
4549,1500000US132231205031,132231205031,"Block Group 1, Census Tract 1205.03, Paulding County, Georgia",3938,3851,87,2.2092432707
4550,1500000US132231205032,132231205032,"Block Group 2, Census Tract 1205.03, Paulding County, Georgia",1318,1292,26,1.97268588771
4551,1500000US132231206011,132231206011,"Block Group 1, Census Tract 1206.01, Paulding County, Georgia",2504,2089,415,16.5734824281
4552,1500000US132231206012,132231206012,"Block Group 2, Census Tract 1206.01, Paulding County, Georgia",1888,1814,74,3.91949152542
4553,1500000US132231206021,132231206021,"Block Group 1, Census Tract 1206.02, Paulding County, Georgia",1035,949,86,8.30917874396
4554,1500000US132231206022,132231206022,"Block Group 2, Census Tract 1206.02, Paulding County, Georgia",3506,3427,79,2.25328009127
4555,1500000US132231206023,132231206023,"Block Group 3, Census Tract 1206.02, Paulding County, Georgia",1904,1880,24,1.26050420168
4556,1500000US132231206024,132231206024,"Block Group 4, Census Tract 1206.02, Paulding County, Georgia",3272,3051,221,6.75427872861
4557,1500000US132231206031,132231206031,"Block Group 1, Census Tract 1206.03, Paulding County, Georgia",3578,3321,257,7.18278367803
4558,1500000US132231206032,132231206032,"Block Group 2, Census Tract 1206.03, Paulding County, Georgia",2622,2458,164,6.25476735317
4559,1500000US132231206041,132231206041,"Block Group 1, Census Tract 1206.04, Paulding County, Georgia",2501,2476,25,0.999600159936
4560,1500000US132231206042,132231206042,"Block Group 2, Census Tract 1206.04, Paulding County, Georgia",3142,2893,249,7.92488860598
4561,1500000US132231206051,132231206051,"Block Group 1, Census Tract 1206.05, Paulding County, Georgia",4715,4625,90,1.90880169671
4562,1500000US132231206052,132231206052,"Block Group 2, Census Tract 1206.05, Paulding County, Georgia",1502,1448,54,3.59520639148
4563,1500000US132250401011,132250401011,"Block Group 1, Census Tract 401.01, Peach County, Georgia",1695,1695,0,0.0
4564,1500000US132250401021,132250401021,"Block Group 1, Census Tract 401.02, Peach County, Georgia",3609,3452,157,4.35023552231
4565,1500000US132250401022,132250401022,"Block Group 2, Census Tract 401.02, Peach County, Georgia",1682,1682,0,0.0
4566,1500000US132250401023,132250401023,"Block Group 3, Census Tract 401.02, Peach County, Georgia",3420,3420,0,0.0
4567,1500000US132250401024,132250401024,"Block Group 4, Census Tract 401.02, Peach County, Georgia",1303,1303,0,0.0
4568,1500000US132250402001,132250402001,"Block Group 1, Census Tract 402, Peach County, Georgia",2304,1944,360,15.625
4569,1500000US132250402002,132250402002,"Block Group 2, Census Tract 402, Peach County, Georgia",2262,1651,611,27.0114942529
4570,1500000US132250403011,132250403011,"Block Group 1, Census Tract 403.01, Peach County, Georgia",1624,1275,349,21.4901477833
4571,1500000US132250403012,132250403012,"Block Group 2, Census Tract 403.01, Peach County, Georgia",1021,831,190,18.6092066601
4572,1500000US132250403021,132250403021,"Block Group 1, Census Tract 403.02, Peach County, Georgia",2115,1942,173,8.17966903073
4573,1500000US132250404001,132250404001,"Block Group 1, Census Tract 404, Peach County, Georgia",4285,4175,110,2.56709451575
4574,1500000US132250404002,132250404002,"Block Group 2, Census Tract 404, Peach County, Georgia",1766,1766,0,0.0
4575,1500000US132270501001,132270501001,"Block Group 1, Census Tract 501, Pickens County, Georgia",2017,1867,150,7.43678730788
4576,1500000US132270501002,132270501002,"Block Group 2, Census Tract 501, Pickens County, Georgia",1747,1747,0,0.0
4577,1500000US132270501003,132270501003,"Block Group 3, Census Tract 501, Pickens County, Georgia",1355,1355,0,0.0
4578,1500000US132270502001,132270502001,"Block Group 1, Census Tract 502, Pickens County, Georgia",1462,1462,0,0.0
4579,1500000US132270502002,132270502002,"Block Group 2, Census Tract 502, Pickens County, Georgia",2056,1994,62,3.01556420233
4580,1500000US132270502003,132270502003,"Block Group 3, Census Tract 502, Pickens County, Georgia",997,730,267,26.7803410231
4581,1500000US132270502004,132270502004,"Block Group 4, Census Tract 502, Pickens County, Georgia",1751,1595,156,8.90919474586
4582,1500000US132270503001,132270503001,"Block Group 1, Census Tract 503, Pickens County, Georgia",1761,1728,33,1.87393526405
4583,1500000US132270503002,132270503002,"Block Group 2, Census Tract 503, Pickens County, Georgia",2516,2516,0,0.0
4584,1500000US132270504001,132270504001,"Block Group 1, Census Tract 504, Pickens County, Georgia",1943,1909,34,1.74987133299
4585,1500000US132270504002,132270504002,"Block Group 2, Census Tract 504, Pickens County, Georgia",2014,2002,12,0.595829195631
4586,1500000US132270505001,132270505001,"Block Group 1, Census Tract 505, Pickens County, Georgia",1694,1569,125,7.37898465171
4587,1500000US132270505002,132270505002,"Block Group 2, Census Tract 505, Pickens County, Georgia",2686,2671,15,0.558451228593
4588,1500000US132270506001,132270506001,"Block Group 1, Census Tract 506, Pickens County, Georgia",1750,1750,0,0.0
4589,1500000US132270506002,132270506002,"Block Group 2, Census Tract 506, Pickens County, Georgia",518,518,0,0.0
4590,1500000US132270506003,132270506003,"Block Group 3, Census Tract 506, Pickens County, Georgia",1741,1741,0,0.0
4591,1500000US132270506004,132270506004,"Block Group 4, Census Tract 506, Pickens County, Georgia",1732,1672,60,3.46420323326
4592,1500000US132299601001,132299601001,"Block Group 1, Census Tract 9601, Pierce County, Georgia",1349,1235,114,8.45070422535
4593,1500000US132299601002,132299601002,"Block Group 2, Census Tract 9601, Pierce County, Georgia",1283,1257,26,2.02650038971
4594,1500000US132299602001,132299602001,"Block Group 1, Census Tract 9602, Pierce County, Georgia",988,824,164,16.5991902834
4595,1500000US132299602002,132299602002,"Block Group 2, Census Tract 9602, Pierce County, Georgia",899,680,219,24.3604004449
4596,1500000US132299603001,132299603001,"Block Group 1, Census Tract 9603, Pierce County, Georgia",2194,2099,95,4.32999088423
4597,1500000US132299603002,132299603002,"Block Group 2, Census Tract 9603, Pierce County, Georgia",1424,1268,156,10.9550561798
4598,1500000US132299603003,132299603003,"Block Group 3, Census Tract 9603, Pierce County, Georgia",1512,1512,0,0.0
4599,1500000US132299603004,132299603004,"Block Group 4, Census Tract 9603, Pierce County, Georgia",1492,1468,24,1.60857908847
4600,1500000US132299604001,132299604001,"Block Group 1, Census Tract 9604, Pierce County, Georgia",1696,1595,101,5.95518867925
4601,1500000US132299604002,132299604002,"Block Group 2, Census Tract 9604, Pierce County, Georgia",1581,1563,18,1.1385199241
4602,1500000US132299604003,132299604003,"Block Group 3, Census Tract 9604, Pierce County, Georgia",1383,1383,0,0.0
4603,1500000US132299604004,132299604004,"Block Group 4, Census Tract 9604, Pierce County, Georgia",3133,3080,53,1.69166932652
4604,1500000US132310101001,132310101001,"Block Group 1, Census Tract 101, Pike County, Georgia",2486,2463,23,0.925181013677
4605,1500000US132310101002,132310101002,"Block Group 2, Census Tract 101, Pike County, Georgia",2290,2265,25,1.09170305677
4606,1500000US132310101003,132310101003,"Block Group 3, Census Tract 101, Pike County, Georgia",2157,2119,38,1.76170607325
4607,1500000US132310102001,132310102001,"Block Group 1, Census Tract 102, Pike County, Georgia",3516,3459,57,1.62116040956
4608,1500000US132310103001,132310103001,"Block Group 1, Census Tract 103, Pike County, Georgia",1531,1483,48,3.13520574788
4609,1500000US132310103002,132310103002,"Block Group 2, Census Tract 103, Pike County, Georgia",2594,2568,26,1.00231303007
4610,1500000US132310104001,132310104001,"Block Group 1, Census Tract 104, Pike County, Georgia",1386,1378,8,0.577200577201
4611,1500000US132310104002,132310104002,"Block Group 2, Census Tract 104, Pike County, Georgia",1852,1827,25,1.34989200864
4612,1500000US132330101001,132330101001,"Block Group 1, Census Tract 101, Polk County, Georgia",1342,1322,20,1.49031296572
4613,1500000US132330101002,132330101002,"Block Group 2, Census Tract 101, Polk County, Georgia",852,849,3,0.352112676056
4614,1500000US132330101003,132330101003,"Block Group 3, Census Tract 101, Polk County, Georgia",1510,1289,221,14.6357615894
4615,1500000US132330101004,132330101004,"Block Group 4, Census Tract 101, Polk County, Georgia",1265,1265,0,0.0
4616,1500000US132330102001,132330102001,"Block Group 1, Census Tract 102, Polk County, Georgia",1679,1520,159,9.46992257296
4617,1500000US132330102002,132330102002,"Block Group 2, Census Tract 102, Polk County, Georgia",1810,1759,51,2.81767955801
4618,1500000US132330102003,132330102003,"Block Group 3, Census Tract 102, Polk County, Georgia",1887,1156,731,38.7387387387
4619,1500000US132330102004,132330102004,"Block Group 4, Census Tract 102, Polk County, Georgia",1415,1327,88,6.21908127208
4620,1500000US132330102005,132330102005,"Block Group 5, Census Tract 102, Polk County, Georgia",1126,721,405,35.9680284192
4621,1500000US132330103001,132330103001,"Block Group 1, Census Tract 103, Polk County, Georgia",1428,1289,139,9.73389355742
4622,1500000US132330103002,132330103002,"Block Group 2, Census Tract 103, Polk County, Georgia",1318,1201,117,8.87708649469
4623,1500000US132330103003,132330103003,"Block Group 3, Census Tract 103, Polk County, Georgia",2245,1050,1195,53.2293986637
4624,1500000US132330104001,132330104001,"Block Group 1, Census Tract 104, Polk County, Georgia",1341,1295,46,3.4302759135
4625,1500000US132330104002,132330104002,"Block Group 2, Census Tract 104, Polk County, Georgia",1101,1095,6,0.544959128065
4626,1500000US132330104003,132330104003,"Block Group 3, Census Tract 104, Polk County, Georgia",1351,877,474,35.0851221318
4627,1500000US132330104004,132330104004,"Block Group 4, Census Tract 104, Polk County, Georgia",1072,923,149,13.8992537313
4628,1500000US132330104005,132330104005,"Block Group 5, Census Tract 104, Polk County, Georgia",1355,934,421,31.0701107011
4629,1500000US132330105001,132330105001,"Block Group 1, Census Tract 105, Polk County, Georgia",1517,1507,10,0.659195781147
4630,1500000US132330105002,132330105002,"Block Group 2, Census Tract 105, Polk County, Georgia",1065,1006,59,5.53990610329
4631,1500000US132330105003,132330105003,"Block Group 3, Census Tract 105, Polk County, Georgia",539,210,329,61.038961039
4632,1500000US132330105004,132330105004,"Block Group 4, Census Tract 105, Polk County, Georgia",1005,751,254,25.2736318408
4633,1500000US132330105005,132330105005,"Block Group 5, Census Tract 105, Polk County, Georgia",711,484,227,31.9268635724
4634,1500000US132330105006,132330105006,"Block Group 6, Census Tract 105, Polk County, Georgia",873,873,0,0.0
4635,1500000US132330106001,132330106001,"Block Group 1, Census Tract 106, Polk County, Georgia",1194,1128,66,5.52763819095
4636,1500000US132330106002,132330106002,"Block Group 2, Census Tract 106, Polk County, Georgia",1988,1988,0,0.0
4637,1500000US132330106003,132330106003,"Block Group 3, Census Tract 106, Polk County, Georgia",1455,1455,0,0.0
4638,1500000US132330106004,132330106004,"Block Group 4, Census Tract 106, Polk County, Georgia",1279,1279,0,0.0
4639,1500000US132330107001,132330107001,"Block Group 1, Census Tract 107, Polk County, Georgia",1585,1560,25,1.57728706625
4640,1500000US132330107002,132330107002,"Block Group 2, Census Tract 107, Polk County, Georgia",954,898,56,5.87002096436
4641,1500000US132330107003,132330107003,"Block Group 3, Census Tract 107, Polk County, Georgia",930,930,0,0.0
4642,1500000US132330107004,132330107004,"Block Group 4, Census Tract 107, Polk County, Georgia",1053,1053,0,0.0
4643,1500000US132330107005,132330107005,"Block Group 5, Census Tract 107, Polk County, Georgia",970,970,0,0.0
4644,1500000US132359501001,132359501001,"Block Group 1, Census Tract 9501, Pulaski County, Georgia",2222,2049,173,7.78577857786
4645,1500000US132359501002,132359501002,"Block Group 2, Census Tract 9501, Pulaski County, Georgia",767,734,33,4.30247718383
4646,1500000US132359502001,132359502001,"Block Group 1, Census Tract 9502, Pulaski County, Georgia",1390,1390,0,0.0
4647,1500000US132359502002,132359502002,"Block Group 2, Census Tract 9502, Pulaski County, Georgia",702,702,0,0.0
4648,1500000US132359502003,132359502003,"Block Group 3, Census Tract 9502, Pulaski County, Georgia",941,941,0,0.0
4649,1500000US132359502004,132359502004,"Block Group 4, Census Tract 9502, Pulaski County, Georgia",1016,1016,0,0.0
4650,1500000US132359502005,132359502005,"Block Group 5, Census Tract 9502, Pulaski County, Georgia",1192,1192,0,0.0
4651,1500000US132359502006,132359502006,"Block Group 6, Census Tract 9502, Pulaski County, Georgia",1906,1584,322,16.8940188877
4652,1500000US132359503001,132359503001,"Block Group 1, Census Tract 9503, Pulaski County, Georgia",1454,1441,13,0.894085281981
4653,1500000US132379601011,132379601011,"Block Group 1, Census Tract 9601.01, Putnam County, Georgia",1047,1047,0,0.0
4654,1500000US132379601012,132379601012,"Block Group 2, Census Tract 9601.01, Putnam County, Georgia",764,647,117,15.3141361257
4655,1500000US132379601013,132379601013,"Block Group 3, Census Tract 9601.01, Putnam County, Georgia",1402,1402,0,0.0
4656,1500000US132379601021,132379601021,"Block Group 1, Census Tract 9601.02, Putnam County, Georgia",2615,2526,89,3.4034416826
4657,1500000US132379601022,132379601022,"Block Group 2, Census Tract 9601.02, Putnam County, Georgia",2881,2417,464,16.105518917
4658,1500000US132379602011,132379602011,"Block Group 1, Census Tract 9602.01, Putnam County, Georgia",1147,1003,144,12.5544899738
4659,1500000US132379602021,132379602021,"Block Group 1, Census Tract 9602.02, Putnam County, Georgia",942,739,203,21.5498938429
4660,1500000US132379602022,132379602022,"Block Group 2, Census Tract 9602.02, Putnam County, Georgia",2008,2006,2,0.0996015936255
4661,1500000US132379602023,132379602023,"Block Group 3, Census Tract 9602.02, Putnam County, Georgia",910,910,0,0.0
4662,1500000US132379602024,132379602024,"Block Group 4, Census Tract 9602.02, Putnam County, Georgia",1024,1024,0,0.0
4663,1500000US132379602025,132379602025,"Block Group 5, Census Tract 9602.02, Putnam County, Georgia",1105,762,343,31.0407239819
4664,1500000US132379602026,132379602026,"Block Group 6, Census Tract 9602.02, Putnam County, Georgia",555,555,0,0.0
4665,1500000US132379602027,132379602027,"Block Group 7, Census Tract 9602.02, Putnam County, Georgia",582,582,0,0.0
4666,1500000US132379603001,132379603001,"Block Group 1, Census Tract 9603, Putnam County, Georgia",1355,1324,31,2.28782287823
4667,1500000US132379603002,132379603002,"Block Group 2, Census Tract 9603, Putnam County, Georgia",715,697,18,2.51748251748
4668,1500000US132379603003,132379603003,"Block Group 3, Census Tract 9603, Putnam County, Georgia",581,581,0,0.0
4669,1500000US132379603004,132379603004,"Block Group 4, Census Tract 9603, Putnam County, Georgia",1614,1614,0,0.0
4670,1500000US132399603001,132399603001,"Block Group 1, Census Tract 9603, Quitman County, Georgia",1181,1181,0,0.0
4671,1500000US132399603002,132399603002,"Block Group 2, Census Tract 9603, Quitman County, Georgia",1145,1145,0,0.0
4672,1500000US132419701001,132419701001,"Block Group 1, Census Tract 9701, Rabun County, Georgia",510,510,0,0.0
4673,1500000US132419701002,132419701002,"Block Group 2, Census Tract 9701, Rabun County, Georgia",2209,1707,502,22.7252150294
4674,1500000US132419701003,132419701003,"Block Group 3, Census Tract 9701, Rabun County, Georgia",1648,1616,32,1.94174757282
4675,1500000US132419701004,132419701004,"Block Group 4, Census Tract 9701, Rabun County, Georgia",1369,1244,125,9.130752374
4676,1500000US132419702011,132419702011,"Block Group 1, Census Tract 9702.01, Rabun County, Georgia",1866,1659,207,11.0932475884
4677,1500000US132419702012,132419702012,"Block Group 2, Census Tract 9702.01, Rabun County, Georgia",470,470,0,0.0
4678,1500000US132419702013,132419702013,"Block Group 3, Census Tract 9702.01, Rabun County, Georgia",833,800,33,3.96158463385
4679,1500000US132419702021,132419702021,"Block Group 1, Census Tract 9702.02, Rabun County, Georgia",1158,1158,0,0.0
4680,1500000US132419702022,132419702022,"Block Group 2, Census Tract 9702.02, Rabun County, Georgia",1335,1033,302,22.6217228464
4681,1500000US132419703011,132419703011,"Block Group 1, Census Tract 9703.01, Rabun County, Georgia",484,474,10,2.06611570248
4682,1500000US132419703012,132419703012,"Block Group 2, Census Tract 9703.01, Rabun County, Georgia",671,671,0,0.0
4683,1500000US132419703013,132419703013,"Block Group 3, Census Tract 9703.01, Rabun County, Georgia",2018,1996,22,1.09018830525
4684,1500000US132419703021,132419703021,"Block Group 1, Census Tract 9703.02, Rabun County, Georgia",1695,1610,85,5.01474926254
4685,1500000US132437901001,132437901001,"Block Group 1, Census Tract 7901, Randolph County, Georgia",1162,1131,31,2.6678141136
4686,1500000US132437901002,132437901002,"Block Group 2, Census Tract 7901, Randolph County, Georgia",615,615,0,0.0
4687,1500000US132437902001,132437902001,"Block Group 1, Census Tract 7902, Randolph County, Georgia",839,839,0,0.0
4688,1500000US132437902002,132437902002,"Block Group 2, Census Tract 7902, Randolph County, Georgia",1207,1174,33,2.73405136703
4689,1500000US132437902003,132437902003,"Block Group 3, Census Tract 7902, Randolph County, Georgia",1115,1115,0,0.0
4690,1500000US132437902004,132437902004,"Block Group 4, Census Tract 7902, Randolph County, Georgia",1885,1859,26,1.37931034483
4691,1500000US132437902005,132437902005,"Block Group 5, Census Tract 7902, Randolph County, Georgia",492,492,0,0.0
4692,1500000US132450001001,132450001001,"Block Group 1, Census Tract 1, Richmond County, Georgia",709,709,0,0.0
4693,1500000US132450001002,132450001002,"Block Group 2, Census Tract 1, Richmond County, Georgia",1337,1257,80,5.98354525056
4694,1500000US132450001003,132450001003,"Block Group 3, Census Tract 1, Richmond County, Georgia",687,677,10,1.45560407569
4695,1500000US132450001004,132450001004,"Block Group 4, Census Tract 1, Richmond County, Georgia",579,579,0,0.0
4696,1500000US132450001005,132450001005,"Block Group 5, Census Tract 1, Richmond County, Georgia",616,593,23,3.73376623377
4697,1500000US132450002001,132450002001,"Block Group 1, Census Tract 2, Richmond County, Georgia",966,946,20,2.07039337474
4698,1500000US132450002002,132450002002,"Block Group 2, Census Tract 2, Richmond County, Georgia",619,619,0,0.0
4699,1500000US132450002003,132450002003,"Block Group 3, Census Tract 2, Richmond County, Georgia",750,694,56,7.46666666667
4700,1500000US132450003001,132450003001,"Block Group 1, Census Tract 3, Richmond County, Georgia",383,383,0,0.0
4701,1500000US132450003002,132450003002,"Block Group 2, Census Tract 3, Richmond County, Georgia",586,576,10,1.70648464164
4702,1500000US132450006001,132450006001,"Block Group 1, Census Tract 6, Richmond County, Georgia",645,623,22,3.41085271318
4703,1500000US132450006002,132450006002,"Block Group 2, Census Tract 6, Richmond County, Georgia",1308,1296,12,0.917431192661
4704,1500000US132450006003,132450006003,"Block Group 3, Census Tract 6, Richmond County, Georgia",557,557,0,0.0
4705,1500000US132450007001,132450007001,"Block Group 1, Census Tract 7, Richmond County, Georgia",577,577,0,0.0
4706,1500000US132450007002,132450007002,"Block Group 2, Census Tract 7, Richmond County, Georgia",438,429,9,2.05479452055
4707,1500000US132450009001,132450009001,"Block Group 1, Census Tract 9, Richmond County, Georgia",616,616,0,0.0
4708,1500000US132450009002,132450009002,"Block Group 2, Census Tract 9, Richmond County, Georgia",126,122,4,3.1746031746
4709,1500000US132450009003,132450009003,"Block Group 3, Census Tract 9, Richmond County, Georgia",499,499,0,0.0
4710,1500000US132450010001,132450010001,"Block Group 1, Census Tract 10, Richmond County, Georgia",645,573,72,11.1627906977
4711,1500000US132450010002,132450010002,"Block Group 2, Census Tract 10, Richmond County, Georgia",585,541,44,7.52136752137
4712,1500000US132450010003,132450010003,"Block Group 3, Census Tract 10, Richmond County, Georgia",779,779,0,0.0
4713,1500000US132450010004,132450010004,"Block Group 4, Census Tract 10, Richmond County, Georgia",857,822,35,4.08401400233
4714,1500000US132450011001,132450011001,"Block Group 1, Census Tract 11, Richmond County, Georgia",1103,1077,26,2.35720761559
4715,1500000US132450011002,132450011002,"Block Group 2, Census Tract 11, Richmond County, Georgia",744,724,20,2.68817204301
4716,1500000US132450012001,132450012001,"Block Group 1, Census Tract 12, Richmond County, Georgia",395,395,0,0.0
4717,1500000US132450012002,132450012002,"Block Group 2, Census Tract 12, Richmond County, Georgia",678,671,7,1.03244837758
4718,1500000US132450012003,132450012003,"Block Group 3, Census Tract 12, Richmond County, Georgia",852,852,0,0.0
4719,1500000US132450012004,132450012004,"Block Group 4, Census Tract 12, Richmond County, Georgia",326,318,8,2.45398773006
4720,1500000US132450012005,132450012005,"Block Group 5, Census Tract 12, Richmond County, Georgia",1404,1404,0,0.0
4721,1500000US132450012006,132450012006,"Block Group 6, Census Tract 12, Richmond County, Georgia",652,645,7,1.0736196319
4722,1500000US132450013001,132450013001,"Block Group 1, Census Tract 13, Richmond County, Georgia",798,798,0,0.0
4723,1500000US132450013002,132450013002,"Block Group 2, Census Tract 13, Richmond County, Georgia",781,716,65,8.32266325224
4724,1500000US132450014001,132450014001,"Block Group 1, Census Tract 14, Richmond County, Georgia",428,413,15,3.5046728972
4725,1500000US132450014002,132450014002,"Block Group 2, Census Tract 14, Richmond County, Georgia",641,629,12,1.872074883
4726,1500000US132450014003,132450014003,"Block Group 3, Census Tract 14, Richmond County, Georgia",801,791,10,1.24843945069
4727,1500000US132450015001,132450015001,"Block Group 1, Census Tract 15, Richmond County, Georgia",197,197,0,0.0
4728,1500000US132450015002,132450015002,"Block Group 2, Census Tract 15, Richmond County, Georgia",580,580,0,0.0
4729,1500000US132450016011,132450016011,"Block Group 1, Census Tract 16.01, Richmond County, Georgia",2016,2016,0,0.0
4730,1500000US132450016012,132450016012,"Block Group 2, Census Tract 16.01, Richmond County, Georgia",1674,1674,0,0.0
4731,1500000US132450016013,132450016013,"Block Group 3, Census Tract 16.01, Richmond County, Georgia",368,321,47,12.7717391304
4732,1500000US132450016021,132450016021,"Block Group 1, Census Tract 16.02, Richmond County, Georgia",1916,1853,63,3.28810020877
4733,1500000US132450016022,132450016022,"Block Group 2, Census Tract 16.02, Richmond County, Georgia",921,921,0,0.0
4734,1500000US132450016023,132450016023,"Block Group 3, Census Tract 16.02, Richmond County, Georgia",1129,1121,8,0.708591674048
4735,1500000US132450101011,132450101011,"Block Group 1, Census Tract 101.01, Richmond County, Georgia",1835,1711,124,6.75749318801
4736,1500000US132450101012,132450101012,"Block Group 2, Census Tract 101.01, Richmond County, Georgia",1616,1354,262,16.2128712871
4737,1500000US132450101041,132450101041,"Block Group 1, Census Tract 101.04, Richmond County, Georgia",2013,1980,33,1.6393442623
4738,1500000US132450101042,132450101042,"Block Group 2, Census Tract 101.04, Richmond County, Georgia",887,860,27,3.04396843292
4739,1500000US132450101043,132450101043,"Block Group 3, Census Tract 101.04, Richmond County, Georgia",1077,1022,55,5.10677808728
4740,1500000US132450101051,132450101051,"Block Group 1, Census Tract 101.05, Richmond County, Georgia",887,840,47,5.29875986471
4741,1500000US132450101052,132450101052,"Block Group 2, Census Tract 101.05, Richmond County, Georgia",2227,2176,51,2.29007633588
4742,1500000US132450101053,132450101053,"Block Group 3, Census Tract 101.05, Richmond County, Georgia",1792,1689,103,5.74776785714
4743,1500000US132450101061,132450101061,"Block Group 1, Census Tract 101.06, Richmond County, Georgia",836,836,0,0.0
4744,1500000US132450101062,132450101062,"Block Group 2, Census Tract 101.06, Richmond County, Georgia",2133,2049,84,3.93811533052
4745,1500000US132450101063,132450101063,"Block Group 3, Census Tract 101.06, Richmond County, Georgia",2051,2024,27,1.31643100926
4746,1500000US132450101071,132450101071,"Block Group 1, Census Tract 101.07, Richmond County, Georgia",1247,1157,90,7.21732157177
4747,1500000US132450101072,132450101072,"Block Group 2, Census Tract 101.07, Richmond County, Georgia",1215,1207,8,0.658436213992
4748,1500000US132450102011,132450102011,"Block Group 1, Census Tract 102.01, Richmond County, Georgia",1694,1656,38,2.24321133412
4749,1500000US132450102012,132450102012,"Block Group 2, Census Tract 102.01, Richmond County, Georgia",686,682,4,0.583090379009
4750,1500000US132450102013,132450102013,"Block Group 3, Census Tract 102.01, Richmond County, Georgia",2115,2094,21,0.992907801418
4751,1500000US132450102031,132450102031,"Block Group 1, Census Tract 102.03, Richmond County, Georgia",1371,1345,26,1.89642596645
4752,1500000US132450102032,132450102032,"Block Group 2, Census Tract 102.03, Richmond County, Georgia",1673,1673,0,0.0
4753,1500000US132450102033,132450102033,"Block Group 3, Census Tract 102.03, Richmond County, Georgia",1113,1031,82,7.367475292
4754,1500000US132450102041,132450102041,"Block Group 1, Census Tract 102.04, Richmond County, Georgia",6518,6055,463,7.10340595275
4755,1500000US132450102042,132450102042,"Block Group 2, Census Tract 102.04, Richmond County, Georgia",992,992,0,0.0
4756,1500000US132450102043,132450102043,"Block Group 3, Census Tract 102.04, Richmond County, Georgia",3542,3228,314,8.86504799548
4757,1500000US132450102044,132450102044,"Block Group 4, Census Tract 102.04, Richmond County, Georgia",3229,2580,649,20.0991018891
4758,1500000US132450103001,132450103001,"Block Group 1, Census Tract 103, Richmond County, Georgia",1462,1344,118,8.07113543092
4759,1500000US132450103002,132450103002,"Block Group 2, Census Tract 103, Richmond County, Georgia",529,529,0,0.0
4760,1500000US132450103003,132450103003,"Block Group 3, Census Tract 103, Richmond County, Georgia",2224,2188,36,1.61870503597
4761,1500000US132450103004,132450103004,"Block Group 4, Census Tract 103, Richmond County, Georgia",502,409,93,18.5258964143
4762,1500000US132450103005,132450103005,"Block Group 5, Census Tract 103, Richmond County, Georgia",638,498,140,21.9435736677
4763,1500000US132450104001,132450104001,"Block Group 1, Census Tract 104, Richmond County, Georgia",964,964,0,0.0
4764,1500000US132450104002,132450104002,"Block Group 2, Census Tract 104, Richmond County, Georgia",863,833,30,3.47624565469
4765,1500000US132450104003,132450104003,"Block Group 3, Census Tract 104, Richmond County, Georgia",732,732,0,0.0
4766,1500000US132450104004,132450104004,"Block Group 4, Census Tract 104, Richmond County, Georgia",712,687,25,3.51123595506
4767,1500000US132450104005,132450104005,"Block Group 5, Census Tract 104, Richmond County, Georgia",1037,987,50,4.82160077146
4768,1500000US132450105041,132450105041,"Block Group 1, Census Tract 105.04, Richmond County, Georgia",2156,2129,27,1.25231910946
4769,1500000US132450105042,132450105042,"Block Group 2, Census Tract 105.04, Richmond County, Georgia",2789,2560,229,8.21082825385
4770,1500000US132450105043,132450105043,"Block Group 3, Census Tract 105.04, Richmond County, Georgia",810,810,0,0.0
4771,1500000US132450105044,132450105044,"Block Group 4, Census Tract 105.04, Richmond County, Georgia",1424,1398,26,1.82584269663
4772,1500000US132450105061,132450105061,"Block Group 1, Census Tract 105.06, Richmond County, Georgia",1748,1748,0,0.0
4773,1500000US132450105062,132450105062,"Block Group 2, Census Tract 105.06, Richmond County, Georgia",1199,1154,45,3.75312760634
4774,1500000US132450105063,132450105063,"Block Group 3, Census Tract 105.06, Richmond County, Georgia",1971,1844,127,6.4434297311
4775,1500000US132450105071,132450105071,"Block Group 1, Census Tract 105.07, Richmond County, Georgia",1422,1422,0,0.0
4776,1500000US132450105072,132450105072,"Block Group 2, Census Tract 105.07, Richmond County, Georgia",959,915,44,4.58811261731
4777,1500000US132450105073,132450105073,"Block Group 3, Census Tract 105.07, Richmond County, Georgia",2899,2841,58,2.00068989307
4778,1500000US132450105074,132450105074,"Block Group 4, Census Tract 105.07, Richmond County, Georgia",394,369,25,6.34517766497
4779,1500000US132450105081,132450105081,"Block Group 1, Census Tract 105.08, Richmond County, Georgia",3036,2942,94,3.09617918314
4780,1500000US132450105082,132450105082,"Block Group 2, Census Tract 105.08, Richmond County, Georgia",1264,1235,29,2.29430379747
4781,1500000US132450105091,132450105091,"Block Group 1, Census Tract 105.09, Richmond County, Georgia",1144,1133,11,0.961538461538
4782,1500000US132450105092,132450105092,"Block Group 2, Census Tract 105.09, Richmond County, Georgia",2939,2893,46,1.56515821708
4783,1500000US132450105101,132450105101,"Block Group 1, Census Tract 105.10, Richmond County, Georgia",1063,1056,7,0.65851364064
4784,1500000US132450105102,132450105102,"Block Group 2, Census Tract 105.10, Richmond County, Georgia",357,343,14,3.92156862745
4785,1500000US132450105103,132450105103,"Block Group 3, Census Tract 105.10, Richmond County, Georgia",2213,2198,15,0.677812923633
4786,1500000US132450105104,132450105104,"Block Group 4, Census Tract 105.10, Richmond County, Georgia",1311,1311,0,0.0
4787,1500000US132450105111,132450105111,"Block Group 1, Census Tract 105.11, Richmond County, Georgia",3021,2954,67,2.21780867262
4788,1500000US132450105112,132450105112,"Block Group 2, Census Tract 105.11, Richmond County, Georgia",1451,1431,20,1.3783597519
4789,1500000US132450105121,132450105121,"Block Group 1, Census Tract 105.12, Richmond County, Georgia",1417,1417,0,0.0
4790,1500000US132450105122,132450105122,"Block Group 2, Census Tract 105.12, Richmond County, Georgia",1540,1532,8,0.519480519481
4791,1500000US132450105123,132450105123,"Block Group 3, Census Tract 105.12, Richmond County, Georgia",1568,1468,100,6.37755102041
4792,1500000US132450105131,132450105131,"Block Group 1, Census Tract 105.13, Richmond County, Georgia",1999,1984,15,0.750375187594
4793,1500000US132450105132,132450105132,"Block Group 2, Census Tract 105.13, Richmond County, Georgia",1097,1038,59,5.37830446673
4794,1500000US132450106001,132450106001,"Block Group 1, Census Tract 106, Richmond County, Georgia",859,823,36,4.19091967404
4795,1500000US132450106002,132450106002,"Block Group 2, Census Tract 106, Richmond County, Georgia",841,788,53,6.30202140309
4796,1500000US132450106003,132450106003,"Block Group 3, Census Tract 106, Richmond County, Georgia",1813,1796,17,0.937672366244
4797,1500000US132450106004,132450106004,"Block Group 4, Census Tract 106, Richmond County, Georgia",848,848,0,0.0
4798,1500000US132450107061,132450107061,"Block Group 1, Census Tract 107.06, Richmond County, Georgia",1828,1816,12,0.656455142232
4799,1500000US132450107062,132450107062,"Block Group 2, Census Tract 107.06, Richmond County, Georgia",2105,1855,250,11.8764845606
4800,1500000US132450107063,132450107063,"Block Group 3, Census Tract 107.06, Richmond County, Georgia",1305,1296,9,0.689655172414
4801,1500000US132450107071,132450107071,"Block Group 1, Census Tract 107.07, Richmond County, Georgia",2436,2339,97,3.98193760263
4802,1500000US132450107072,132450107072,"Block Group 2, Census Tract 107.07, Richmond County, Georgia",470,470,0,0.0
4803,1500000US132450107081,132450107081,"Block Group 1, Census Tract 107.08, Richmond County, Georgia",2038,1675,363,17.8115799804
4804,1500000US132450107082,132450107082,"Block Group 2, Census Tract 107.08, Richmond County, Georgia",1492,1443,49,3.28418230563
4805,1500000US132450107083,132450107083,"Block Group 3, Census Tract 107.08, Richmond County, Georgia",2155,1982,173,8.02784222738
4806,1500000US132450107091,132450107091,"Block Group 1, Census Tract 107.09, Richmond County, Georgia",3390,3311,79,2.33038348083
4807,1500000US132450107092,132450107092,"Block Group 2, Census Tract 107.09, Richmond County, Georgia",2693,2608,85,3.15633122911
4808,1500000US132450107101,132450107101,"Block Group 1, Census Tract 107.10, Richmond County, Georgia",1623,1571,52,3.20394331485
4809,1500000US132450107102,132450107102,"Block Group 2, Census Tract 107.10, Richmond County, Georgia",1321,1289,32,2.42240726722
4810,1500000US132450107103,132450107103,"Block Group 3, Census Tract 107.10, Richmond County, Georgia",3101,3049,52,1.67687842631
4811,1500000US132450107111,132450107111,"Block Group 1, Census Tract 107.11, Richmond County, Georgia",1253,1152,101,8.06065442937
4812,1500000US132450107112,132450107112,"Block Group 2, Census Tract 107.11, Richmond County, Georgia",1660,1600,60,3.61445783133
4813,1500000US132450107121,132450107121,"Block Group 1, Census Tract 107.12, Richmond County, Georgia",2286,2216,70,3.06211723535
4814,1500000US132450107122,132450107122,"Block Group 2, Census Tract 107.12, Richmond County, Georgia",3407,3330,77,2.2600528324
4815,1500000US132450107123,132450107123,"Block Group 3, Census Tract 107.12, Richmond County, Georgia",3036,2924,112,3.68906455863
4816,1500000US132450108001,132450108001,"Block Group 1, Census Tract 108, Richmond County, Georgia",1075,904,171,15.9069767442
4817,1500000US132450108002,132450108002,"Block Group 2, Census Tract 108, Richmond County, Georgia",3123,2554,569,18.2196605828
4818,1500000US132450108003,132450108003,"Block Group 3, Census Tract 108, Richmond County, Georgia",2563,2151,412,16.0749122123
4819,1500000US132450108004,132450108004,"Block Group 4, Census Tract 108, Richmond County, Georgia",1311,1089,222,16.9336384439
4820,1500000US132450109031,132450109031,"Block Group 1, Census Tract 109.03, Richmond County, Georgia",2244,2124,120,5.34759358289
4821,1500000US132450109032,132450109032,"Block Group 2, Census Tract 109.03, Richmond County, Georgia",2972,2774,198,6.66218034993
4822,1500000US132450109041,132450109041,"Block Group 1, Census Tract 109.04, Richmond County, Georgia",884,884,0,0.0
4823,1500000US132450109042,132450109042,"Block Group 2, Census Tract 109.04, Richmond County, Georgia",2542,2517,25,0.983477576711
4824,1500000US132450109051,132450109051,"Block Group 1, Census Tract 109.05, Richmond County, Georgia",1172,1172,0,0.0
4825,1500000US132450109052,132450109052,"Block Group 2, Census Tract 109.05, Richmond County, Georgia",2102,2073,29,1.37963843958
4826,1500000US132450109053,132450109053,"Block Group 3, Census Tract 109.05, Richmond County, Georgia",1845,1828,17,0.921409214092
4827,1500000US132450109061,132450109061,"Block Group 1, Census Tract 109.06, Richmond County, Georgia",863,863,0,0.0
4828,1500000US132450109062,132450109062,"Block Group 2, Census Tract 109.06, Richmond County, Georgia",3056,2315,741,24.247382199
4829,1500000US132450109063,132450109063,"Block Group 3, Census Tract 109.06, Richmond County, Georgia",3274,3242,32,0.977397678681
4830,1500000US132450110001,132450110001,"Block Group 1, Census Tract 110, Richmond County, Georgia",528,485,43,8.14393939394
4831,1500000US132450110002,132450110002,"Block Group 2, Census Tract 110, Richmond County, Georgia",906,868,38,4.19426048565
4832,1500000US132470601011,132470601011,"Block Group 1, Census Tract 601.01, Rockdale County, Georgia",833,822,11,1.32052821128
4833,1500000US132470601012,132470601012,"Block Group 2, Census Tract 601.01, Rockdale County, Georgia",1016,955,61,6.00393700787
4834,1500000US132470601013,132470601013,"Block Group 3, Census Tract 601.01, Rockdale County, Georgia",1424,1227,197,13.8342696629
4835,1500000US132470601021,132470601021,"Block Group 1, Census Tract 601.02, Rockdale County, Georgia",1122,1122,0,0.0
4836,1500000US132470601022,132470601022,"Block Group 2, Census Tract 601.02, Rockdale County, Georgia",852,852,0,0.0
4837,1500000US132470601023,132470601023,"Block Group 3, Census Tract 601.02, Rockdale County, Georgia",3281,3058,223,6.79670832063
4838,1500000US132470602011,132470602011,"Block Group 1, Census Tract 602.01, Rockdale County, Georgia",2819,348,2471,87.6551968783
4839,1500000US132470602012,132470602012,"Block Group 2, Census Tract 602.01, Rockdale County, Georgia",1646,1646,0,0.0
4840,1500000US132470602013,132470602013,"Block Group 3, Census Tract 602.01, Rockdale County, Georgia",635,635,0,0.0
4841,1500000US132470602021,132470602021,"Block Group 1, Census Tract 602.02, Rockdale County, Georgia",2471,2395,76,3.07567786321
4842,1500000US132470602022,132470602022,"Block Group 2, Census Tract 602.02, Rockdale County, Georgia",2444,2263,181,7.40589198036
4843,1500000US132470602023,132470602023,"Block Group 3, Census Tract 602.02, Rockdale County, Georgia",1916,1905,11,0.574112734864
4844,1500000US132470602024,132470602024,"Block Group 4, Census Tract 602.02, Rockdale County, Georgia",3016,2952,64,2.12201591512
4845,1500000US132470603041,132470603041,"Block Group 1, Census Tract 603.04, Rockdale County, Georgia",638,541,97,15.2037617555
4846,1500000US132470603042,132470603042,"Block Group 2, Census Tract 603.04, Rockdale County, Georgia",1318,1295,23,1.74506828528
4847,1500000US132470603043,132470603043,"Block Group 3, Census Tract 603.04, Rockdale County, Georgia",1915,1780,135,7.04960835509
4848,1500000US132470603044,132470603044,"Block Group 4, Census Tract 603.04, Rockdale County, Georgia",1330,1247,83,6.24060150376
4849,1500000US132470603051,132470603051,"Block Group 1, Census Tract 603.05, Rockdale County, Georgia",1035,736,299,28.8888888889
4850,1500000US132470603052,132470603052,"Block Group 2, Census Tract 603.05, Rockdale County, Georgia",1941,1366,575,29.6239052035
4851,1500000US132470603053,132470603053,"Block Group 3, Census Tract 603.05, Rockdale County, Georgia",2358,2034,324,13.7404580153
4852,1500000US132470603061,132470603061,"Block Group 1, Census Tract 603.06, Rockdale County, Georgia",3097,3069,28,0.904100742654
4853,1500000US132470603071,132470603071,"Block Group 1, Census Tract 603.07, Rockdale County, Georgia",2477,2244,233,9.40654016956
4854,1500000US132470603072,132470603072,"Block Group 2, Census Tract 603.07, Rockdale County, Georgia",2329,2252,77,3.30613997424
4855,1500000US132470603073,132470603073,"Block Group 3, Census Tract 603.07, Rockdale County, Georgia",4276,4060,216,5.05144995323
4856,1500000US132470603074,132470603074,"Block Group 4, Census Tract 603.07, Rockdale County, Georgia",1301,1301,0,0.0
4857,1500000US132470603081,132470603081,"Block Group 1, Census Tract 603.08, Rockdale County, Georgia",3842,3685,157,4.08641332639
4858,1500000US132470603082,132470603082,"Block Group 2, Census Tract 603.08, Rockdale County, Georgia",2006,1804,202,10.0697906281
4859,1500000US132470603083,132470603083,"Block Group 3, Census Tract 603.08, Rockdale County, Georgia",2666,1654,1012,37.9594898725
4860,1500000US132470603091,132470603091,"Block Group 1, Census Tract 603.09, Rockdale County, Georgia",1067,893,174,16.3074039363
4861,1500000US132470603092,132470603092,"Block Group 2, Census Tract 603.09, Rockdale County, Georgia",1827,1742,85,4.65243568692
4862,1500000US132470603093,132470603093,"Block Group 3, Census Tract 603.09, Rockdale County, Georgia",2403,2241,162,6.74157303371
4863,1500000US132470604031,132470604031,"Block Group 1, Census Tract 604.03, Rockdale County, Georgia",1911,1864,47,2.45944531659
4864,1500000US132470604032,132470604032,"Block Group 2, Census Tract 604.03, Rockdale County, Georgia",561,561,0,0.0
4865,1500000US132470604033,132470604033,"Block Group 3, Census Tract 604.03, Rockdale County, Georgia",1030,951,79,7.66990291262
4866,1500000US132470604041,132470604041,"Block Group 1, Census Tract 604.04, Rockdale County, Georgia",2696,2455,241,8.93916913947
4867,1500000US132470604042,132470604042,"Block Group 2, Census Tract 604.04, Rockdale County, Georgia",1386,1277,109,7.86435786436
4868,1500000US132470604043,132470604043,"Block Group 3, Census Tract 604.04, Rockdale County, Georgia",1923,1923,0,0.0
4869,1500000US132470604051,132470604051,"Block Group 1, Census Tract 604.05, Rockdale County, Georgia",2850,2785,65,2.28070175439
4870,1500000US132470604052,132470604052,"Block Group 2, Census Tract 604.05, Rockdale County, Georgia",2995,2781,214,7.14524207012
4871,1500000US132470604053,132470604053,"Block Group 3, Census Tract 604.05, Rockdale County, Georgia",1369,1369,0,0.0
4872,1500000US132470604061,132470604061,"Block Group 1, Census Tract 604.06, Rockdale County, Georgia",1139,1058,81,7.11150131694
4873,1500000US132470604062,132470604062,"Block Group 2, Census Tract 604.06, Rockdale County, Georgia",2772,2384,388,13.9971139971
4874,1500000US132470604063,132470604063,"Block Group 3, Census Tract 604.06, Rockdale County, Georgia",1752,1740,12,0.684931506849
4875,1500000US132470604071,132470604071,"Block Group 1, Census Tract 604.07, Rockdale County, Georgia",1281,1203,78,6.08899297424
4876,1500000US132470604072,132470604072,"Block Group 2, Census Tract 604.07, Rockdale County, Georgia",1177,1081,96,8.15632965166
4877,1500000US132470604073,132470604073,"Block Group 3, Census Tract 604.07, Rockdale County, Georgia",758,728,30,3.95778364116
4878,1500000US132499601001,132499601001,"Block Group 1, Census Tract 9601, Schley County, Georgia",1280,1236,44,3.4375
4879,1500000US132499601002,132499601002,"Block Group 2, Census Tract 9601, Schley County, Georgia",1690,1554,136,8.04733727811
4880,1500000US132499602001,132499602001,"Block Group 1, Census Tract 9602, Schley County, Georgia",2104,2058,46,2.18631178707
4881,1500000US132519702001,132519702001,"Block Group 1, Census Tract 9702, Screven County, Georgia",1146,1142,4,0.349040139616
4882,1500000US132519702002,132519702002,"Block Group 2, Census Tract 9702, Screven County, Georgia",789,789,0,0.0
4883,1500000US132519703001,132519703001,"Block Group 1, Census Tract 9703, Screven County, Georgia",964,913,51,5.29045643154
4884,1500000US132519703002,132519703002,"Block Group 2, Census Tract 9703, Screven County, Georgia",1124,1124,0,0.0
4885,1500000US132519703003,132519703003,"Block Group 3, Census Tract 9703, Screven County, Georgia",847,845,2,0.236127508855
4886,1500000US132519703004,132519703004,"Block Group 4, Census Tract 9703, Screven County, Georgia",373,373,0,0.0
4887,1500000US132519704001,132519704001,"Block Group 1, Census Tract 9704, Screven County, Georgia",993,980,13,1.30916414904
4888,1500000US132519704002,132519704002,"Block Group 2, Census Tract 9704, Screven County, Georgia",1556,1499,57,3.66323907455
4889,1500000US132519704003,132519704003,"Block Group 3, Census Tract 9704, Screven County, Georgia",888,888,0,0.0
4890,1500000US132519704004,132519704004,"Block Group 4, Census Tract 9704, Screven County, Georgia",1103,1030,73,6.61831368994
4891,1500000US132519705001,132519705001,"Block Group 1, Census Tract 9705, Screven County, Georgia",1702,1699,3,0.176263219741
4892,1500000US132519705002,132519705002,"Block Group 2, Census Tract 9705, Screven County, Georgia",995,987,8,0.804020100503
4893,1500000US132519706001,132519706001,"Block Group 1, Census Tract 9706, Screven County, Georgia",1044,1042,2,0.191570881226
4894,1500000US132519706002,132519706002,"Block Group 2, Census Tract 9706, Screven County, Georgia",682,664,18,2.63929618768
4895,1500000US132532001001,132532001001,"Block Group 1, Census Tract 2001, Seminole County, Georgia",831,780,51,6.13718411552
4896,1500000US132532001002,132532001002,"Block Group 2, Census Tract 2001, Seminole County, Georgia",835,769,66,7.90419161677
4897,1500000US132532001003,132532001003,"Block Group 3, Census Tract 2001, Seminole County, Georgia",837,811,26,3.10633213859
4898,1500000US132532002001,132532002001,"Block Group 1, Census Tract 2002, Seminole County, Georgia",1871,1840,31,1.65686798503
4899,1500000US132532002002,132532002002,"Block Group 2, Census Tract 2002, Seminole County, Georgia",965,950,15,1.55440414508
4900,1500000US132532002003,132532002003,"Block Group 3, Census Tract 2002, Seminole County, Georgia",907,901,6,0.661521499449
4901,1500000US132532003001,132532003001,"Block Group 1, Census Tract 2003, Seminole County, Georgia",1023,966,57,5.57184750733
4902,1500000US132532003002,132532003002,"Block Group 2, Census Tract 2003, Seminole County, Georgia",390,390,0,0.0
4903,1500000US132532003003,132532003003,"Block Group 3, Census Tract 2003, Seminole County, Georgia",1110,1110,0,0.0
4904,1500000US132551601001,132551601001,"Block Group 1, Census Tract 1601, Spalding County, Georgia",3022,3021,1,0.0330906684315
4905,1500000US132551601002,132551601002,"Block Group 2, Census Tract 1601, Spalding County, Georgia",956,848,108,11.2970711297
4906,1500000US132551601003,132551601003,"Block Group 3, Census Tract 1601, Spalding County, Georgia",1810,1269,541,29.8895027624
4907,1500000US132551602001,132551602001,"Block Group 1, Census Tract 1602, Spalding County, Georgia",1567,1457,110,7.01978302489
4908,1500000US132551602002,132551602002,"Block Group 2, Census Tract 1602, Spalding County, Georgia",1660,1660,0,0.0
4909,1500000US132551602003,132551602003,"Block Group 3, Census Tract 1602, Spalding County, Georgia",3051,2899,152,4.98197312357
4910,1500000US132551603001,132551603001,"Block Group 1, Census Tract 1603, Spalding County, Georgia",1488,1325,163,10.9543010753
4911,1500000US132551603002,132551603002,"Block Group 2, Census Tract 1603, Spalding County, Georgia",1730,1730,0,0.0
4912,1500000US132551604001,132551604001,"Block Group 1, Census Tract 1604, Spalding County, Georgia",1927,1927,0,0.0
4913,1500000US132551604002,132551604002,"Block Group 2, Census Tract 1604, Spalding County, Georgia",1246,1225,21,1.68539325843
4914,1500000US132551604003,132551604003,"Block Group 3, Census Tract 1604, Spalding County, Georgia",914,914,0,0.0
4915,1500000US132551604004,132551604004,"Block Group 4, Census Tract 1604, Spalding County, Georgia",327,119,208,63.6085626911
4916,1500000US132551604005,132551604005,"Block Group 5, Census Tract 1604, Spalding County, Georgia",1079,1079,0,0.0
4917,1500000US132551605001,132551605001,"Block Group 1, Census Tract 1605, Spalding County, Georgia",3637,3579,58,1.59472092384
4918,1500000US132551605002,132551605002,"Block Group 2, Census Tract 1605, Spalding County, Georgia",2835,2651,184,6.49029982363
4919,1500000US132551606001,132551606001,"Block Group 1, Census Tract 1606, Spalding County, Georgia",1480,1439,41,2.77027027027
4920,1500000US132551606002,132551606002,"Block Group 2, Census Tract 1606, Spalding County, Georgia",2416,2388,28,1.15894039735
4921,1500000US132551607001,132551607001,"Block Group 1, Census Tract 1607, Spalding County, Georgia",2428,2428,0,0.0
4922,1500000US132551607002,132551607002,"Block Group 2, Census Tract 1607, Spalding County, Georgia",1677,1639,38,2.26595110316
4923,1500000US132551607003,132551607003,"Block Group 3, Census Tract 1607, Spalding County, Georgia",3306,3177,129,3.90199637024
4924,1500000US132551608001,132551608001,"Block Group 1, Census Tract 1608, Spalding County, Georgia",1559,1459,100,6.41436818473
4925,1500000US132551608002,132551608002,"Block Group 2, Census Tract 1608, Spalding County, Georgia",1385,1065,320,23.1046931408
4926,1500000US132551608003,132551608003,"Block Group 3, Census Tract 1608, Spalding County, Georgia",1929,1884,45,2.33281493002
4927,1500000US132551609001,132551609001,"Block Group 1, Census Tract 1609, Spalding County, Georgia",725,725,0,0.0
4928,1500000US132551609002,132551609002,"Block Group 2, Census Tract 1609, Spalding County, Georgia",1230,1230,0,0.0
4929,1500000US132551609003,132551609003,"Block Group 3, Census Tract 1609, Spalding County, Georgia",746,672,74,9.91957104558
4930,1500000US132551610001,132551610001,"Block Group 1, Census Tract 1610, Spalding County, Georgia",1002,1002,0,0.0
4931,1500000US132551610002,132551610002,"Block Group 2, Census Tract 1610, Spalding County, Georgia",1323,1292,31,2.34315948602
4932,1500000US132551610003,132551610003,"Block Group 3, Census Tract 1610, Spalding County, Georgia",2831,2774,57,2.01342281879
4933,1500000US132551611001,132551611001,"Block Group 1, Census Tract 1611, Spalding County, Georgia",1173,1063,110,9.37766410912
4934,1500000US132551611002,132551611002,"Block Group 2, Census Tract 1611, Spalding County, Georgia",2756,2684,72,2.61248185776
4935,1500000US132551612001,132551612001,"Block Group 1, Census Tract 1612, Spalding County, Georgia",2568,2451,117,4.55607476636
4936,1500000US132551612002,132551612002,"Block Group 2, Census Tract 1612, Spalding County, Georgia",617,617,0,0.0
4937,1500000US132551612003,132551612003,"Block Group 3, Census Tract 1612, Spalding County, Georgia",1170,1170,0,0.0
4938,1500000US132551612004,132551612004,"Block Group 4, Census Tract 1612, Spalding County, Georgia",4303,4303,0,0.0
4939,1500000US132579701001,132579701001,"Block Group 1, Census Tract 9701, Stephens County, Georgia",1336,1336,0,0.0
4940,1500000US132579701002,132579701002,"Block Group 2, Census Tract 9701, Stephens County, Georgia",1547,1480,67,4.33096315449
4941,1500000US132579701003,132579701003,"Block Group 3, Census Tract 9701, Stephens County, Georgia",930,906,24,2.58064516129
4942,1500000US132579701004,132579701004,"Block Group 4, Census Tract 9701, Stephens County, Georgia",1364,1364,0,0.0
4943,1500000US132579701005,132579701005,"Block Group 5, Census Tract 9701, Stephens County, Georgia",1564,1491,73,4.66751918159
4944,1500000US132579702001,132579702001,"Block Group 1, Census Tract 9702, Stephens County, Georgia",2406,2287,119,4.9459684123
4945,1500000US132579702002,132579702002,"Block Group 2, Census Tract 9702, Stephens County, Georgia",1945,1945,0,0.0
4946,1500000US132579702003,132579702003,"Block Group 3, Census Tract 9702, Stephens County, Georgia",1794,1736,58,3.23299888517
4947,1500000US132579703011,132579703011,"Block Group 1, Census Tract 9703.01, Stephens County, Georgia",348,348,0,0.0
4948,1500000US132579703012,132579703012,"Block Group 2, Census Tract 9703.01, Stephens County, Georgia",1015,788,227,22.3645320197
4949,1500000US132579703013,132579703013,"Block Group 3, Census Tract 9703.01, Stephens County, Georgia",555,555,0,0.0
4950,1500000US132579703014,132579703014,"Block Group 4, Census Tract 9703.01, Stephens County, Georgia",1093,1001,92,8.41720036597
4951,1500000US132579703021,132579703021,"Block Group 1, Census Tract 9703.02, Stephens County, Georgia",1212,1167,45,3.71287128713
4952,1500000US132579703022,132579703022,"Block Group 2, Census Tract 9703.02, Stephens County, Georgia",1517,1517,0,0.0
4953,1500000US132579704001,132579704001,"Block Group 1, Census Tract 9704, Stephens County, Georgia",1879,1840,39,2.07557211283
4954,1500000US132579704002,132579704002,"Block Group 2, Census Tract 9704, Stephens County, Georgia",1505,1505,0,0.0
4955,1500000US132579704003,132579704003,"Block Group 3, Census Tract 9704, Stephens County, Georgia",1962,1962,0,0.0
4956,1500000US132579704004,132579704004,"Block Group 4, Census Tract 9704, Stephens County, Georgia",1648,1648,0,0.0
4957,1500000US132599501001,132599501001,"Block Group 1, Census Tract 9501, Stewart County, Georgia",1310,1294,16,1.2213740458
4958,1500000US132599501002,132599501002,"Block Group 2, Census Tract 9501, Stewart County, Georgia",791,791,0,0.0
4959,1500000US132599504001,132599504001,"Block Group 1, Census Tract 9504, Stewart County, Georgia",597,591,6,1.00502512563
4960,1500000US132599504002,132599504002,"Block Group 2, Census Tract 9504, Stewart County, Georgia",2446,1191,1255,51.308258381
4961,1500000US132599504003,132599504003,"Block Group 3, Census Tract 9504, Stewart County, Georgia",724,724,0,0.0
4962,1500000US132619501001,132619501001,"Block Group 1, Census Tract 9501, Sumter County, Georgia",1245,1219,26,2.08835341365
4963,1500000US132619502001,132619502001,"Block Group 1, Census Tract 9502, Sumter County, Georgia",1678,1528,150,8.93921334923
4964,1500000US132619502002,132619502002,"Block Group 2, Census Tract 9502, Sumter County, Georgia",1015,1007,8,0.788177339901
4965,1500000US132619502003,132619502003,"Block Group 3, Census Tract 9502, Sumter County, Georgia",1343,1343,0,0.0
4966,1500000US132619502004,132619502004,"Block Group 4, Census Tract 9502, Sumter County, Georgia",1059,1059,0,0.0
4967,1500000US132619503001,132619503001,"Block Group 1, Census Tract 9503, Sumter County, Georgia",1801,1787,14,0.777345918934
4968,1500000US132619503002,132619503002,"Block Group 2, Census Tract 9503, Sumter County, Georgia",1269,1246,23,1.81245074862
4969,1500000US132619503003,132619503003,"Block Group 3, Census Tract 9503, Sumter County, Georgia",533,533,0,0.0
4970,1500000US132619503004,132619503004,"Block Group 4, Census Tract 9503, Sumter County, Georgia",1100,1100,0,0.0
4971,1500000US132619503005,132619503005,"Block Group 5, Census Tract 9503, Sumter County, Georgia",2520,2500,20,0.793650793651
4972,1500000US132619504001,132619504001,"Block Group 1, Census Tract 9504, Sumter County, Georgia",853,843,10,1.17233294256
4973,1500000US132619504002,132619504002,"Block Group 2, Census Tract 9504, Sumter County, Georgia",968,895,73,7.54132231405
4974,1500000US132619504003,132619504003,"Block Group 3, Census Tract 9504, Sumter County, Georgia",899,899,0,0.0
4975,1500000US132619505001,132619505001,"Block Group 1, Census Tract 9505, Sumter County, Georgia",979,970,9,0.919305413687
4976,1500000US132619505002,132619505002,"Block Group 2, Census Tract 9505, Sumter County, Georgia",1092,986,106,9.70695970696
4977,1500000US132619505003,132619505003,"Block Group 3, Census Tract 9505, Sumter County, Georgia",1357,1194,163,12.0117907148
4978,1500000US132619506001,132619506001,"Block Group 1, Census Tract 9506, Sumter County, Georgia",514,514,0,0.0
4979,1500000US132619506002,132619506002,"Block Group 2, Census Tract 9506, Sumter County, Georgia",796,784,12,1.50753768844
4980,1500000US132619506003,132619506003,"Block Group 3, Census Tract 9506, Sumter County, Georgia",832,743,89,10.6971153846
4981,1500000US132619507001,132619507001,"Block Group 1, Census Tract 9507, Sumter County, Georgia",1770,1649,121,6.83615819209
4982,1500000US132619507002,132619507002,"Block Group 2, Census Tract 9507, Sumter County, Georgia",1783,1471,312,17.4985978688
4983,1500000US132619507003,132619507003,"Block Group 3, Census Tract 9507, Sumter County, Georgia",1498,1186,312,20.8277703605
4984,1500000US132619507004,132619507004,"Block Group 4, Census Tract 9507, Sumter County, Georgia",1698,1680,18,1.06007067138
4985,1500000US132619508001,132619508001,"Block Group 1, Census Tract 9508, Sumter County, Georgia",927,853,74,7.98274002157
4986,1500000US132619508002,132619508002,"Block Group 2, Census Tract 9508, Sumter County, Georgia",931,859,72,7.73361976369
4987,1500000US132619508003,132619508003,"Block Group 3, Census Tract 9508, Sumter County, Georgia",969,930,39,4.02476780186
4988,1500000US132639601001,132639601001,"Block Group 1, Census Tract 9601, Talbot County, Georgia",774,774,0,0.0
4989,1500000US132639601002,132639601002,"Block Group 2, Census Tract 9601, Talbot County, Georgia",1665,1665,0,0.0
4990,1500000US132639602001,132639602001,"Block Group 1, Census Tract 9602, Talbot County, Georgia",961,954,7,0.728407908429
4991,1500000US132639602002,132639602002,"Block Group 2, Census Tract 9602, Talbot County, Georgia",1429,1360,69,4.82855143457
4992,1500000US132639603001,132639603001,"Block Group 1, Census Tract 9603, Talbot County, Georgia",514,514,0,0.0
4993,1500000US132639603002,132639603002,"Block Group 2, Census Tract 9603, Talbot County, Georgia",1147,1097,50,4.35919790759
4994,1500000US132650102001,132650102001,"Block Group 1, Census Tract 102, Taliaferro County, Georgia",672,670,2,0.297619047619
4995,1500000US132650102002,132650102002,"Block Group 2, Census Tract 102, Taliaferro County, Georgia",616,584,32,5.19480519481
4996,1500000US132650102003,132650102003,"Block Group 3, Census Tract 102, Taliaferro County, Georgia",433,429,4,0.923787528868
4997,1500000US132679501001,132679501001,"Block Group 1, Census Tract 9501, Tattnall County, Georgia",1012,843,169,16.6996047431
4998,1500000US132679501002,132679501002,"Block Group 2, Census Tract 9501, Tattnall County, Georgia",549,549,0,0.0
4999,1500000US132679501003,132679501003,"Block Group 3, Census Tract 9501, Tattnall County, Georgia",988,967,21,2.12550607287
5000,1500000US132679501004,132679501004,"Block Group 4, Census Tract 9501, Tattnall County, Georgia",908,860,48,5.28634361233
5001,1500000US132679502011,132679502011,"Block Group 1, Census Tract 9502.01, Tattnall County, Georgia",1814,1779,35,1.92943770673
5002,1500000US132679502012,132679502012,"Block Group 2, Census Tract 9502.01, Tattnall County, Georgia",2741,2595,146,5.32652316673
5003,1500000US132679502021,132679502021,"Block Group 1, Census Tract 9502.02, Tattnall County, Georgia",4273,4024,249,5.82728761994
5004,1500000US132679502022,132679502022,"Block Group 2, Census Tract 9502.02, Tattnall County, Georgia",3220,1684,1536,47.701863354
5005,1500000US132679503001,132679503001,"Block Group 1, Census Tract 9503, Tattnall County, Georgia",3108,2851,257,8.26898326898
5006,1500000US132679503002,132679503002,"Block Group 2, Census Tract 9503, Tattnall County, Georgia",1122,1016,106,9.44741532977
5007,1500000US132679503003,132679503003,"Block Group 3, Census Tract 9503, Tattnall County, Georgia",1272,1193,79,6.2106918239
5008,1500000US132679503004,132679503004,"Block Group 4, Census Tract 9503, Tattnall County, Georgia",408,408,0,0.0
5009,1500000US132679504001,132679504001,"Block Group 1, Census Tract 9504, Tattnall County, Georgia",816,816,0,0.0
5010,1500000US132679504002,132679504002,"Block Group 2, Census Tract 9504, Tattnall County, Georgia",716,716,0,0.0
5011,1500000US132679504003,132679504003,"Block Group 3, Census Tract 9504, Tattnall County, Georgia",386,386,0,0.0
5012,1500000US132679504004,132679504004,"Block Group 4, Census Tract 9504, Tattnall County, Georgia",1969,1910,59,2.99644489589
5013,1500000US132699501001,132699501001,"Block Group 1, Census Tract 9501, Taylor County, Georgia",1556,1556,0,0.0
5014,1500000US132699502001,132699502001,"Block Group 1, Census Tract 9502, Taylor County, Georgia",1080,1078,2,0.185185185185
5015,1500000US132699502002,132699502002,"Block Group 2, Census Tract 9502, Taylor County, Georgia",1268,1148,120,9.46372239748
5016,1500000US132699503001,132699503001,"Block Group 1, Census Tract 9503, Taylor County, Georgia",1588,1588,0,0.0
5017,1500000US132699503002,132699503002,"Block Group 2, Census Tract 9503, Taylor County, Georgia",1058,1058,0,0.0
5018,1500000US132699503003,132699503003,"Block Group 3, Census Tract 9503, Taylor County, Georgia",918,849,69,7.51633986928
5019,1500000US132699503004,132699503004,"Block Group 4, Census Tract 9503, Taylor County, Georgia",933,933,0,0.0
5020,1500000US132719501001,132719501001,"Block Group 1, Census Tract 9501, Telfair County, Georgia",2163,2163,0,0.0
5021,1500000US132719501002,132719501002,"Block Group 2, Census Tract 9501, Telfair County, Georgia",2908,2700,208,7.15268225585
5022,1500000US132719501003,132719501003,"Block Group 3, Census Tract 9501, Telfair County, Georgia",1428,1428,0,0.0
5023,1500000US132719501004,132719501004,"Block Group 4, Census Tract 9501, Telfair County, Georgia",1101,997,104,9.4459582198
5024,1500000US132719501005,132719501005,"Block Group 5, Census Tract 9501, Telfair County, Georgia",3905,2152,1753,44.8911651729
5025,1500000US132719502001,132719502001,"Block Group 1, Census Tract 9502, Telfair County, Georgia",743,743,0,0.0
5026,1500000US132719502002,132719502002,"Block Group 2, Census Tract 9502, Telfair County, Georgia",1041,974,67,6.43611911623
5027,1500000US132719505001,132719505001,"Block Group 1, Census Tract 9505, Telfair County, Georgia",1098,1098,0,0.0
5028,1500000US132719505002,132719505002,"Block Group 2, Census Tract 9505, Telfair County, Georgia",926,787,139,15.0107991361
5029,1500000US132719505003,132719505003,"Block Group 3, Census Tract 9505, Telfair County, Georgia",1103,1103,0,0.0
5030,1500000US132731202001,132731202001,"Block Group 1, Census Tract 1202, Terrell County, Georgia",679,676,3,0.441826215022
5031,1500000US132731202002,132731202002,"Block Group 2, Census Tract 1202, Terrell County, Georgia",911,901,10,1.09769484083
5032,1500000US132731203001,132731203001,"Block Group 1, Census Tract 1203, Terrell County, Georgia",673,673,0,0.0
5033,1500000US132731203002,132731203002,"Block Group 2, Census Tract 1203, Terrell County, Georgia",1132,1132,0,0.0
5034,1500000US132731203003,132731203003,"Block Group 3, Census Tract 1203, Terrell County, Georgia",703,703,0,0.0
5035,1500000US132731203004,132731203004,"Block Group 4, Census Tract 1203, Terrell County, Georgia",464,464,0,0.0
5036,1500000US132731204001,132731204001,"Block Group 1, Census Tract 1204, Terrell County, Georgia",1367,1362,5,0.365764447696
5037,1500000US132731204002,132731204002,"Block Group 2, Census Tract 1204, Terrell County, Georgia",687,687,0,0.0
5038,1500000US132731204003,132731204003,"Block Group 3, Census Tract 1204, Terrell County, Georgia",960,960,0,0.0
5039,1500000US132731205001,132731205001,"Block Group 1, Census Tract 1205, Terrell County, Georgia",1637,1433,204,12.4618204032
5040,1500000US132759601001,132759601001,"Block Group 1, Census Tract 9601, Thomas County, Georgia",574,516,58,10.1045296167
5041,1500000US132759601002,132759601002,"Block Group 2, Census Tract 9601, Thomas County, Georgia",638,526,112,17.5548589342
5042,1500000US132759602001,132759602001,"Block Group 1, Census Tract 9602, Thomas County, Georgia",2668,2655,13,0.487256371814
5043,1500000US132759602002,132759602002,"Block Group 2, Census Tract 9602, Thomas County, Georgia",1286,1221,65,5.05443234837
5044,1500000US132759603001,132759603001,"Block Group 1, Census Tract 9603, Thomas County, Georgia",1194,1109,85,7.1189279732
5045,1500000US132759603002,132759603002,"Block Group 2, Census Tract 9603, Thomas County, Georgia",1045,1040,5,0.478468899522
5046,1500000US132759604001,132759604001,"Block Group 1, Census Tract 9604, Thomas County, Georgia",863,841,22,2.54924681344
5047,1500000US132759604002,132759604002,"Block Group 2, Census Tract 9604, Thomas County, Georgia",1288,1260,28,2.17391304348
5048,1500000US132759605001,132759605001,"Block Group 1, Census Tract 9605, Thomas County, Georgia",3228,3178,50,1.54894671623
5049,1500000US132759605002,132759605002,"Block Group 2, Census Tract 9605, Thomas County, Georgia",1531,1531,0,0.0
5050,1500000US132759605003,132759605003,"Block Group 3, Census Tract 9605, Thomas County, Georgia",2060,1997,63,3.05825242718
5051,1500000US132759606001,132759606001,"Block Group 1, Census Tract 9606, Thomas County, Georgia",1643,1597,46,2.79975654291
5052,1500000US132759606002,132759606002,"Block Group 2, Census Tract 9606, Thomas County, Georgia",1017,1017,0,0.0
5053,1500000US132759606003,132759606003,"Block Group 3, Census Tract 9606, Thomas County, Georgia",368,368,0,0.0
5054,1500000US132759606004,132759606004,"Block Group 4, Census Tract 9606, Thomas County, Georgia",1684,1644,40,2.37529691211
5055,1500000US132759606005,132759606005,"Block Group 5, Census Tract 9606, Thomas County, Georgia",856,856,0,0.0
5056,1500000US132759607001,132759607001,"Block Group 1, Census Tract 9607, Thomas County, Georgia",1970,1970,0,0.0
5057,1500000US132759607002,132759607002,"Block Group 2, Census Tract 9607, Thomas County, Georgia",1539,1539,0,0.0
5058,1500000US132759607003,132759607003,"Block Group 3, Census Tract 9607, Thomas County, Georgia",1312,1164,148,11.2804878049
5059,1500000US132759607004,132759607004,"Block Group 4, Census Tract 9607, Thomas County, Georgia",911,911,0,0.0
5060,1500000US132759607005,132759607005,"Block Group 5, Census Tract 9607, Thomas County, Georgia",781,725,56,7.17029449424
5061,1500000US132759607006,132759607006,"Block Group 6, Census Tract 9607, Thomas County, Georgia",366,366,0,0.0
5062,1500000US132759608001,132759608001,"Block Group 1, Census Tract 9608, Thomas County, Georgia",932,788,144,15.4506437768
5063,1500000US132759608002,132759608002,"Block Group 2, Census Tract 9608, Thomas County, Georgia",1457,1457,0,0.0
5064,1500000US132759608003,132759608003,"Block Group 3, Census Tract 9608, Thomas County, Georgia",564,564,0,0.0
5065,1500000US132759608004,132759608004,"Block Group 4, Census Tract 9608, Thomas County, Georgia",851,851,0,0.0
5066,1500000US132759608005,132759608005,"Block Group 5, Census Tract 9608, Thomas County, Georgia",1695,1691,4,0.23598820059
5067,1500000US132759609001,132759609001,"Block Group 1, Census Tract 9609, Thomas County, Georgia",860,848,12,1.39534883721
5068,1500000US132759609002,132759609002,"Block Group 2, Census Tract 9609, Thomas County, Georgia",1883,1862,21,1.11524163569
5069,1500000US132759609003,132759609003,"Block Group 3, Census Tract 9609, Thomas County, Georgia",934,934,0,0.0
5070,1500000US132759610001,132759610001,"Block Group 1, Census Tract 9610, Thomas County, Georgia",1984,1920,64,3.22580645161
5071,1500000US132759610002,132759610002,"Block Group 2, Census Tract 9610, Thomas County, Georgia",970,659,311,32.0618556701
5072,1500000US132759610003,132759610003,"Block Group 3, Census Tract 9610, Thomas County, Georgia",1047,1047,0,0.0
5073,1500000US132759611001,132759611001,"Block Group 1, Census Tract 9611, Thomas County, Georgia",892,790,102,11.4349775785
5074,1500000US132759611002,132759611002,"Block Group 2, Census Tract 9611, Thomas County, Georgia",1072,1025,47,4.38432835821
5075,1500000US132759611003,132759611003,"Block Group 3, Census Tract 9611, Thomas County, Georgia",861,861,0,0.0
5076,1500000US132779601001,132779601001,"Block Group 1, Census Tract 9601, Tift County, Georgia",1346,917,429,31.8722139673
5077,1500000US132779601002,132779601002,"Block Group 2, Census Tract 9601, Tift County, Georgia",1157,1157,0,0.0
5078,1500000US132779602001,132779602001,"Block Group 1, Census Tract 9602, Tift County, Georgia",1419,1324,95,6.69485553206
5079,1500000US132779602002,132779602002,"Block Group 2, Census Tract 9602, Tift County, Georgia",1565,1473,92,5.8785942492
5080,1500000US132779603001,132779603001,"Block Group 1, Census Tract 9603, Tift County, Georgia",512,512,0,0.0
5081,1500000US132779603002,132779603002,"Block Group 2, Census Tract 9603, Tift County, Georgia",998,998,0,0.0
5082,1500000US132779603003,132779603003,"Block Group 3, Census Tract 9603, Tift County, Georgia",4345,4294,51,1.17376294591
5083,1500000US132779603004,132779603004,"Block Group 4, Census Tract 9603, Tift County, Georgia",687,687,0,0.0
5084,1500000US132779603005,132779603005,"Block Group 5, Census Tract 9603, Tift County, Georgia",849,673,176,20.7302709069
5085,1500000US132779603006,132779603006,"Block Group 6, Census Tract 9603, Tift County, Georgia",492,431,61,12.3983739837
5086,1500000US132779604001,132779604001,"Block Group 1, Census Tract 9604, Tift County, Georgia",304,235,69,22.6973684211
5087,1500000US132779604002,132779604002,"Block Group 2, Census Tract 9604, Tift County, Georgia",944,944,0,0.0
5088,1500000US132779604003,132779604003,"Block Group 3, Census Tract 9604, Tift County, Georgia",2353,1955,398,16.9145771356
5089,1500000US132779604004,132779604004,"Block Group 4, Census Tract 9604, Tift County, Georgia",982,982,0,0.0
5090,1500000US132779604005,132779604005,"Block Group 5, Census Tract 9604, Tift County, Georgia",401,390,11,2.74314214464
5091,1500000US132779604006,132779604006,"Block Group 6, Census Tract 9604, Tift County, Georgia",1201,1053,148,12.3230641132
5092,1500000US132779605001,132779605001,"Block Group 1, Census Tract 9605, Tift County, Georgia",2766,2738,28,1.01229211858
5093,1500000US132779605002,132779605002,"Block Group 2, Census Tract 9605, Tift County, Georgia",1775,1768,7,0.394366197183
5094,1500000US132779606001,132779606001,"Block Group 1, Census Tract 9606, Tift County, Georgia",1278,1045,233,18.2316118936
5095,1500000US132779606002,132779606002,"Block Group 2, Census Tract 9606, Tift County, Georgia",2892,2825,67,2.31673582296
5096,1500000US132779606003,132779606003,"Block Group 3, Census Tract 9606, Tift County, Georgia",1011,1011,0,0.0
5097,1500000US132779606004,132779606004,"Block Group 4, Census Tract 9606, Tift County, Georgia",639,639,0,0.0
5098,1500000US132779607001,132779607001,"Block Group 1, Census Tract 9607, Tift County, Georgia",1016,957,59,5.80708661417
5099,1500000US132779607002,132779607002,"Block Group 2, Census Tract 9607, Tift County, Georgia",2639,1326,1313,49.7536945813
5100,1500000US132779607003,132779607003,"Block Group 3, Census Tract 9607, Tift County, Georgia",383,383,0,0.0
5101,1500000US132779607004,132779607004,"Block Group 4, Census Tract 9607, Tift County, Georgia",805,805,0,0.0
5102,1500000US132779608001,132779608001,"Block Group 1, Census Tract 9608, Tift County, Georgia",1238,830,408,32.9563812601
5103,1500000US132779608002,132779608002,"Block Group 2, Census Tract 9608, Tift County, Georgia",1333,744,589,44.1860465116
5104,1500000US132779609001,132779609001,"Block Group 1, Census Tract 9609, Tift County, Georgia",840,825,15,1.78571428571
5105,1500000US132779609002,132779609002,"Block Group 2, Census Tract 9609, Tift County, Georgia",1221,1056,165,13.5135135135
5106,1500000US132779609003,132779609003,"Block Group 3, Census Tract 9609, Tift County, Georgia",1396,1396,0,0.0
5107,1500000US132799701001,132799701001,"Block Group 1, Census Tract 9701, Toombs County, Georgia",2339,1709,630,26.9345874305
5108,1500000US132799701002,132799701002,"Block Group 2, Census Tract 9701, Toombs County, Georgia",898,767,131,14.5879732739
5109,1500000US132799701003,132799701003,"Block Group 3, Census Tract 9701, Toombs County, Georgia",1068,957,111,10.393258427
5110,1500000US132799701004,132799701004,"Block Group 4, Census Tract 9701, Toombs County, Georgia",1174,1003,171,14.5655877342
5111,1500000US132799702001,132799702001,"Block Group 1, Census Tract 9702, Toombs County, Georgia",1568,1568,0,0.0
5112,1500000US132799702002,132799702002,"Block Group 2, Census Tract 9702, Toombs County, Georgia",964,964,0,0.0
5113,1500000US132799702003,132799702003,"Block Group 3, Census Tract 9702, Toombs County, Georgia",976,698,278,28.4836065574
5114,1500000US132799702004,132799702004,"Block Group 4, Census Tract 9702, Toombs County, Georgia",765,765,0,0.0
5115,1500000US132799702005,132799702005,"Block Group 5, Census Tract 9702, Toombs County, Georgia",466,466,0,0.0
5116,1500000US132799703001,132799703001,"Block Group 1, Census Tract 9703, Toombs County, Georgia",1219,1080,139,11.4027891715
5117,1500000US132799703002,132799703002,"Block Group 2, Census Tract 9703, Toombs County, Georgia",1425,1347,78,5.47368421053
5118,1500000US132799703003,132799703003,"Block Group 3, Census Tract 9703, Toombs County, Georgia",1237,1087,150,12.1261115602
5119,1500000US132799703004,132799703004,"Block Group 4, Census Tract 9703, Toombs County, Georgia",683,683,0,0.0
5120,1500000US132799703005,132799703005,"Block Group 5, Census Tract 9703, Toombs County, Georgia",1751,1407,344,19.6459166191
5121,1500000US132799704001,132799704001,"Block Group 1, Census Tract 9704, Toombs County, Georgia",689,689,0,0.0
5122,1500000US132799704002,132799704002,"Block Group 2, Census Tract 9704, Toombs County, Georgia",525,479,46,8.7619047619
5123,1500000US132799704003,132799704003,"Block Group 3, Census Tract 9704, Toombs County, Georgia",1155,1155,0,0.0
5124,1500000US132799704004,132799704004,"Block Group 4, Census Tract 9704, Toombs County, Georgia",1800,1618,182,10.1111111111
5125,1500000US132799705001,132799705001,"Block Group 1, Census Tract 9705, Toombs County, Georgia",398,308,90,22.6130653266
5126,1500000US132799705002,132799705002,"Block Group 2, Census Tract 9705, Toombs County, Georgia",1674,1385,289,17.2640382318
5127,1500000US132799705003,132799705003,"Block Group 3, Census Tract 9705, Toombs County, Georgia",1512,1324,188,12.4338624339
5128,1500000US132799706001,132799706001,"Block Group 1, Census Tract 9706, Toombs County, Georgia",1012,919,93,9.18972332016
5129,1500000US132799706002,132799706002,"Block Group 2, Census Tract 9706, Toombs County, Georgia",1338,1243,95,7.10014947683
5130,1500000US132799706003,132799706003,"Block Group 3, Census Tract 9706, Toombs County, Georgia",574,489,85,14.8083623693
5131,1500000US132819601001,132819601001,"Block Group 1, Census Tract 9601, Towns County, Georgia",1822,1800,22,1.20746432492
5132,1500000US132819601002,132819601002,"Block Group 2, Census Tract 9601, Towns County, Georgia",1294,1271,23,1.77743431221
5133,1500000US132819601003,132819601003,"Block Group 3, Census Tract 9601, Towns County, Georgia",1333,1299,34,2.55063765941
5134,1500000US132819602001,132819602001,"Block Group 1, Census Tract 9602, Towns County, Georgia",1249,1152,97,7.76621297038
5135,1500000US132819602002,132819602002,"Block Group 2, Census Tract 9602, Towns County, Georgia",1463,1463,0,0.0
5136,1500000US132819603001,132819603001,"Block Group 1, Census Tract 9603, Towns County, Georgia",1227,1227,0,0.0
5137,1500000US132819603002,132819603002,"Block Group 2, Census Tract 9603, Towns County, Georgia",1191,1168,23,1.93115029387
5138,1500000US132819603003,132819603003,"Block Group 3, Census Tract 9603, Towns County, Georgia",1221,1160,61,4.9959049959
5139,1500000US132839601001,132839601001,"Block Group 1, Census Tract 9601, Treutlen County, Georgia",582,532,50,8.5910652921
5140,1500000US132839601002,132839601002,"Block Group 2, Census Tract 9601, Treutlen County, Georgia",559,559,0,0.0
5141,1500000US132839602001,132839602001,"Block Group 1, Census Tract 9602, Treutlen County, Georgia",970,970,0,0.0
5142,1500000US132839602002,132839602002,"Block Group 2, Census Tract 9602, Treutlen County, Georgia",921,921,0,0.0
5143,1500000US132839602003,132839602003,"Block Group 3, Census Tract 9602, Treutlen County, Georgia",1432,1432,0,0.0
5144,1500000US132839602004,132839602004,"Block Group 4, Census Tract 9602, Treutlen County, Georgia",666,666,0,0.0
5145,1500000US132839602005,132839602005,"Block Group 5, Census Tract 9602, Treutlen County, Georgia",1632,1603,29,1.77696078431
5146,1500000US132859601001,132859601001,"Block Group 1, Census Tract 9601, Troup County, Georgia",1349,1339,10,0.741289844329
5147,1500000US132859601002,132859601002,"Block Group 2, Census Tract 9601, Troup County, Georgia",1310,1310,0,0.0
5148,1500000US132859601003,132859601003,"Block Group 3, Census Tract 9601, Troup County, Georgia",1224,1211,13,1.06209150327
5149,1500000US132859601004,132859601004,"Block Group 4, Census Tract 9601, Troup County, Georgia",2211,2206,5,0.226142017187
5150,1500000US132859602011,132859602011,"Block Group 1, Census Tract 9602.01, Troup County, Georgia",3046,2989,57,1.87130663165
5151,1500000US132859602021,132859602021,"Block Group 1, Census Tract 9602.02, Troup County, Georgia",2346,2309,37,1.57715260017
5152,1500000US132859603001,132859603001,"Block Group 1, Census Tract 9603, Troup County, Georgia",830,790,40,4.81927710843
5153,1500000US132859603002,132859603002,"Block Group 2, Census Tract 9603, Troup County, Georgia",1171,1078,93,7.94192997438
5154,1500000US132859603003,132859603003,"Block Group 3, Census Tract 9603, Troup County, Georgia",1851,1851,0,0.0
5155,1500000US132859604001,132859604001,"Block Group 1, Census Tract 9604, Troup County, Georgia",812,811,1,0.12315270936
5156,1500000US132859604002,132859604002,"Block Group 2, Census Tract 9604, Troup County, Georgia",1852,1831,21,1.13390928726
5157,1500000US132859604003,132859604003,"Block Group 3, Census Tract 9604, Troup County, Georgia",3021,3000,21,0.695134061569
5158,1500000US132859605011,132859605011,"Block Group 1, Census Tract 9605.01, Troup County, Georgia",1402,1393,9,0.641940085592
5159,1500000US132859605012,132859605012,"Block Group 2, Census Tract 9605.01, Troup County, Georgia",651,642,9,1.38248847926
5160,1500000US132859605013,132859605013,"Block Group 3, Census Tract 9605.01, Troup County, Georgia",1272,1049,223,17.5314465409
5161,1500000US132859605014,132859605014,"Block Group 4, Census Tract 9605.01, Troup County, Georgia",1379,1202,177,12.8353879623
5162,1500000US132859605021,132859605021,"Block Group 1, Census Tract 9605.02, Troup County, Georgia",2493,2328,165,6.61853188929
5163,1500000US132859605022,132859605022,"Block Group 2, Census Tract 9605.02, Troup County, Georgia",4974,4643,331,6.65460394049
5164,1500000US132859606001,132859606001,"Block Group 1, Census Tract 9606, Troup County, Georgia",1602,1564,38,2.3720349563
5165,1500000US132859606002,132859606002,"Block Group 2, Census Tract 9606, Troup County, Georgia",1640,1574,66,4.0243902439
5166,1500000US132859606003,132859606003,"Block Group 3, Census Tract 9606, Troup County, Georgia",922,912,10,1.08459869848
5167,1500000US132859606004,132859606004,"Block Group 4, Census Tract 9606, Troup County, Georgia",1651,1647,4,0.242277407632
5168,1500000US132859607001,132859607001,"Block Group 1, Census Tract 9607, Troup County, Georgia",1750,1614,136,7.77142857143
5169,1500000US132859607002,132859607002,"Block Group 2, Census Tract 9607, Troup County, Georgia",1792,1733,59,3.29241071429
5170,1500000US132859607003,132859607003,"Block Group 3, Census Tract 9607, Troup County, Georgia",1372,1372,0,0.0
5171,1500000US132859607004,132859607004,"Block Group 4, Census Tract 9607, Troup County, Georgia",1340,1086,254,18.9552238806
5172,1500000US132859608001,132859608001,"Block Group 1, Census Tract 9608, Troup County, Georgia",1262,1226,36,2.85261489699
5173,1500000US132859608002,132859608002,"Block Group 2, Census Tract 9608, Troup County, Georgia",1170,1042,128,10.9401709402
5174,1500000US132859608003,132859608003,"Block Group 3, Census Tract 9608, Troup County, Georgia",1029,1027,2,0.19436345967
5175,1500000US132859609011,132859609011,"Block Group 1, Census Tract 9609.01, Troup County, Georgia",882,853,29,3.28798185941
5176,1500000US132859609012,132859609012,"Block Group 2, Census Tract 9609.01, Troup County, Georgia",1635,1440,195,11.9266055046
5177,1500000US132859609013,132859609013,"Block Group 3, Census Tract 9609.01, Troup County, Georgia",1935,1757,178,9.19896640827
5178,1500000US132859609021,132859609021,"Block Group 1, Census Tract 9609.02, Troup County, Georgia",2192,2192,0,0.0
5179,1500000US132859609022,132859609022,"Block Group 2, Census Tract 9609.02, Troup County, Georgia",2849,2833,16,0.561600561601
5180,1500000US132859609023,132859609023,"Block Group 3, Census Tract 9609.02, Troup County, Georgia",1686,1655,31,1.83867141163
5181,1500000US132859610001,132859610001,"Block Group 1, Census Tract 9610, Troup County, Georgia",2005,1984,21,1.04738154613
5182,1500000US132859610002,132859610002,"Block Group 2, Census Tract 9610, Troup County, Georgia",1671,1657,14,0.837821663674
5183,1500000US132859610003,132859610003,"Block Group 3, Census Tract 9610, Troup County, Georgia",1084,1084,0,0.0
5184,1500000US132859610004,132859610004,"Block Group 4, Census Tract 9610, Troup County, Georgia",1448,1431,17,1.17403314917
5185,1500000US132859611001,132859611001,"Block Group 1, Census Tract 9611, Troup County, Georgia",1353,1314,39,2.88248337029
5186,1500000US132859611002,132859611002,"Block Group 2, Census Tract 9611, Troup County, Georgia",1403,1403,0,0.0
5187,1500000US132879702001,132879702001,"Block Group 1, Census Tract 9702, Turner County, Georgia",887,873,14,1.57835400225
5188,1500000US132879702002,132879702002,"Block Group 2, Census Tract 9702, Turner County, Georgia",1013,1013,0,0.0
5189,1500000US132879702003,132879702003,"Block Group 3, Census Tract 9702, Turner County, Georgia",1005,1005,0,0.0
5190,1500000US132879702004,132879702004,"Block Group 4, Census Tract 9702, Turner County, Georgia",1563,1563,0,0.0
5191,1500000US132879702005,132879702005,"Block Group 5, Census Tract 9702, Turner County, Georgia",876,607,269,30.7077625571
5192,1500000US132879703001,132879703001,"Block Group 1, Census Tract 9703, Turner County, Georgia",1096,1069,27,2.46350364964
5193,1500000US132879703002,132879703002,"Block Group 2, Census Tract 9703, Turner County, Georgia",499,499,0,0.0
5194,1500000US132879703003,132879703003,"Block Group 3, Census Tract 9703, Turner County, Georgia",686,654,32,4.66472303207
5195,1500000US132879703004,132879703004,"Block Group 4, Census Tract 9703, Turner County, Georgia",713,699,14,1.96353436185
5196,1500000US132890601001,132890601001,"Block Group 1, Census Tract 601, Twiggs County, Georgia",1019,1019,0,0.0
5197,1500000US132890601002,132890601002,"Block Group 2, Census Tract 601, Twiggs County, Georgia",1479,1474,5,0.338066260987
5198,1500000US132890601003,132890601003,"Block Group 3, Census Tract 601, Twiggs County, Georgia",512,512,0,0.0
5199,1500000US132890601004,132890601004,"Block Group 4, Census Tract 601, Twiggs County, Georgia",2048,2048,0,0.0
5200,1500000US132890602001,132890602001,"Block Group 1, Census Tract 602, Twiggs County, Georgia",1108,1108,0,0.0
5201,1500000US132890602002,132890602002,"Block Group 2, Census Tract 602, Twiggs County, Georgia",1209,1209,0,0.0
5202,1500000US132890602003,132890602003,"Block Group 3, Census Tract 602, Twiggs County, Georgia",725,725,0,0.0
5203,1500000US132890602004,132890602004,"Block Group 4, Census Tract 602, Twiggs County, Georgia",409,409,0,0.0
5204,1500000US132910001011,132910001011,"Block Group 1, Census Tract 1.01, Union County, Georgia",2652,2652,0,0.0
5205,1500000US132910001021,132910001021,"Block Group 1, Census Tract 1.02, Union County, Georgia",1922,1922,0,0.0
5206,1500000US132910001022,132910001022,"Block Group 2, Census Tract 1.02, Union County, Georgia",1023,1023,0,0.0
5207,1500000US132910001023,132910001023,"Block Group 3, Census Tract 1.02, Union County, Georgia",2164,2164,0,0.0
5208,1500000US132910002011,132910002011,"Block Group 1, Census Tract 2.01, Union County, Georgia",958,923,35,3.65344467641
5209,1500000US132910002012,132910002012,"Block Group 2, Census Tract 2.01, Union County, Georgia",1839,1810,29,1.5769439913
5210,1500000US132910002031,132910002031,"Block Group 1, Census Tract 2.03, Union County, Georgia",1526,1379,147,9.63302752294
5211,1500000US132910002032,132910002032,"Block Group 2, Census Tract 2.03, Union County, Georgia",752,739,13,1.72872340426
5212,1500000US132910002041,132910002041,"Block Group 1, Census Tract 2.04, Union County, Georgia",735,735,0,0.0
5213,1500000US132910002042,132910002042,"Block Group 2, Census Tract 2.04, Union County, Georgia",2375,2309,66,2.77894736842
5214,1500000US132910002051,132910002051,"Block Group 1, Census Tract 2.05, Union County, Georgia",1104,1104,0,0.0
5215,1500000US132910002052,132910002052,"Block Group 2, Census Tract 2.05, Union County, Georgia",2400,2313,87,3.625
5216,1500000US132910002053,132910002053,"Block Group 3, Census Tract 2.05, Union County, Georgia",1116,1116,0,0.0
5217,1500000US132910002054,132910002054,"Block Group 4, Census Tract 2.05, Union County, Georgia",1159,915,244,21.0526315789
5218,1500000US132930101001,132930101001,"Block Group 1, Census Tract 101, Upson County, Georgia",1928,1870,58,3.00829875519
5219,1500000US132930101002,132930101002,"Block Group 2, Census Tract 101, Upson County, Georgia",1045,1045,0,0.0
5220,1500000US132930102011,132930102011,"Block Group 1, Census Tract 102.01, Upson County, Georgia",1645,1645,0,0.0
5221,1500000US132930102012,132930102012,"Block Group 2, Census Tract 102.01, Upson County, Georgia",2116,1814,302,14.2722117202
5222,1500000US132930102013,132930102013,"Block Group 3, Census Tract 102.01, Upson County, Georgia",1618,1375,243,15.0185414091
5223,1500000US132930102021,132930102021,"Block Group 1, Census Tract 102.02, Upson County, Georgia",1228,1228,0,0.0
5224,1500000US132930102022,132930102022,"Block Group 2, Census Tract 102.02, Upson County, Georgia",1410,1410,0,0.0
5225,1500000US132930103001,132930103001,"Block Group 1, Census Tract 103, Upson County, Georgia",1835,1835,0,0.0
5226,1500000US132930103002,132930103002,"Block Group 2, Census Tract 103, Upson County, Georgia",1290,1290,0,0.0
5227,1500000US132930104001,132930104001,"Block Group 1, Census Tract 104, Upson County, Georgia",1137,1137,0,0.0
5228,1500000US132930104002,132930104002,"Block Group 2, Census Tract 104, Upson County, Georgia",1562,1562,0,0.0
5229,1500000US132930104003,132930104003,"Block Group 3, Census Tract 104, Upson County, Georgia",1115,1115,0,0.0
5230,1500000US132930104004,132930104004,"Block Group 4, Census Tract 104, Upson County, Georgia",1104,1104,0,0.0
5231,1500000US132930104005,132930104005,"Block Group 5, Census Tract 104, Upson County, Georgia",494,494,0,0.0
5232,1500000US132930104006,132930104006,"Block Group 6, Census Tract 104, Upson County, Georgia",489,489,0,0.0
5233,1500000US132930105001,132930105001,"Block Group 1, Census Tract 105, Upson County, Georgia",1683,1683,0,0.0
5234,1500000US132930105002,132930105002,"Block Group 2, Census Tract 105, Upson County, Georgia",1341,1341,0,0.0
5235,1500000US132930105003,132930105003,"Block Group 3, Census Tract 105, Upson County, Georgia",498,498,0,0.0
5236,1500000US132930105004,132930105004,"Block Group 4, Census Tract 105, Upson County, Georgia",571,571,0,0.0
5237,1500000US132930105005,132930105005,"Block Group 5, Census Tract 105, Upson County, Georgia",1232,1204,28,2.27272727273
5238,1500000US132930106001,132930106001,"Block Group 1, Census Tract 106, Upson County, Georgia",1187,1187,0,0.0
5239,1500000US132950201001,132950201001,"Block Group 1, Census Tract 201, Walker County, Georgia",909,909,0,0.0
5240,1500000US132950201002,132950201002,"Block Group 2, Census Tract 201, Walker County, Georgia",1701,1671,30,1.76366843034
5241,1500000US132950201003,132950201003,"Block Group 3, Census Tract 201, Walker County, Georgia",951,873,78,8.20189274448
5242,1500000US132950201004,132950201004,"Block Group 4, Census Tract 201, Walker County, Georgia",830,802,28,3.3734939759
5243,1500000US132950201005,132950201005,"Block Group 5, Census Tract 201, Walker County, Georgia",1099,1099,0,0.0
5244,1500000US132950201006,132950201006,"Block Group 6, Census Tract 201, Walker County, Georgia",1207,1207,0,0.0
5245,1500000US132950202001,132950202001,"Block Group 1, Census Tract 202, Walker County, Georgia",2389,2331,58,2.42779405609
5246,1500000US132950202002,132950202002,"Block Group 2, Census Tract 202, Walker County, Georgia",1646,1640,6,0.364520048603
5247,1500000US132950203011,132950203011,"Block Group 1, Census Tract 203.01, Walker County, Georgia",2046,1733,313,15.2981427175
5248,1500000US132950203012,132950203012,"Block Group 2, Census Tract 203.01, Walker County, Georgia",999,999,0,0.0
5249,1500000US132950203013,132950203013,"Block Group 3, Census Tract 203.01, Walker County, Georgia",981,966,15,1.52905198777
5250,1500000US132950203014,132950203014,"Block Group 4, Census Tract 203.01, Walker County, Georgia",693,693,0,0.0
5251,1500000US132950203021,132950203021,"Block Group 1, Census Tract 203.02, Walker County, Georgia",915,781,134,14.6448087432
5252,1500000US132950203022,132950203022,"Block Group 2, Census Tract 203.02, Walker County, Georgia",454,422,32,7.04845814978
5253,1500000US132950203023,132950203023,"Block Group 3, Census Tract 203.02, Walker County, Georgia",675,675,0,0.0
5254,1500000US132950203024,132950203024,"Block Group 4, Census Tract 203.02, Walker County, Georgia",784,728,56,7.14285714286
5255,1500000US132950203025,132950203025,"Block Group 5, Census Tract 203.02, Walker County, Georgia",2262,2262,0,0.0
5256,1500000US132950204001,132950204001,"Block Group 1, Census Tract 204, Walker County, Georgia",740,725,15,2.02702702703
5257,1500000US132950204002,132950204002,"Block Group 2, Census Tract 204, Walker County, Georgia",924,916,8,0.865800865801
5258,1500000US132950204003,132950204003,"Block Group 3, Census Tract 204, Walker County, Georgia",1549,1549,0,0.0
5259,1500000US132950205011,132950205011,"Block Group 1, Census Tract 205.01, Walker County, Georgia",1636,1626,10,0.611246943765
5260,1500000US132950205012,132950205012,"Block Group 2, Census Tract 205.01, Walker County, Georgia",2429,2412,17,0.699876492384
5261,1500000US132950205013,132950205013,"Block Group 3, Census Tract 205.01, Walker County, Georgia",4089,4089,0,0.0
5262,1500000US132950205021,132950205021,"Block Group 1, Census Tract 205.02, Walker County, Georgia",1317,1317,0,0.0
5263,1500000US132950205022,132950205022,"Block Group 2, Census Tract 205.02, Walker County, Georgia",3221,3193,28,0.869295249922
5264,1500000US132950205023,132950205023,"Block Group 3, Census Tract 205.02, Walker County, Georgia",2008,2008,0,0.0
5265,1500000US132950206011,132950206011,"Block Group 1, Census Tract 206.01, Walker County, Georgia",2355,2355,0,0.0
5266,1500000US132950206012,132950206012,"Block Group 2, Census Tract 206.01, Walker County, Georgia",2350,2266,84,3.57446808511
5267,1500000US132950206013,132950206013,"Block Group 3, Census Tract 206.01, Walker County, Georgia",2118,1882,236,11.1425873466
5268,1500000US132950206021,132950206021,"Block Group 1, Census Tract 206.02, Walker County, Georgia",2481,2477,4,0.161225312374
5269,1500000US132950206022,132950206022,"Block Group 2, Census Tract 206.02, Walker County, Georgia",1907,1878,29,1.52071316203
5270,1500000US132950207001,132950207001,"Block Group 1, Census Tract 207, Walker County, Georgia",1882,1844,38,2.01912858661
5271,1500000US132950207002,132950207002,"Block Group 2, Census Tract 207, Walker County, Georgia",1124,1124,0,0.0
5272,1500000US132950207003,132950207003,"Block Group 3, Census Tract 207, Walker County, Georgia",827,824,3,0.362756952842
5273,1500000US132950207004,132950207004,"Block Group 4, Census Tract 207, Walker County, Georgia",689,689,0,0.0
5274,1500000US132950207005,132950207005,"Block Group 5, Census Tract 207, Walker County, Georgia",2099,2099,0,0.0
5275,1500000US132950207006,132950207006,"Block Group 6, Census Tract 207, Walker County, Georgia",689,689,0,0.0
5276,1500000US132950208001,132950208001,"Block Group 1, Census Tract 208, Walker County, Georgia",1141,1132,9,0.788781770377
5277,1500000US132950208002,132950208002,"Block Group 2, Census Tract 208, Walker County, Georgia",958,958,0,0.0
5278,1500000US132950208003,132950208003,"Block Group 3, Census Tract 208, Walker County, Georgia",1112,1112,0,0.0
5279,1500000US132950209011,132950209011,"Block Group 1, Census Tract 209.01, Walker County, Georgia",2904,2904,0,0.0
5280,1500000US132950209012,132950209012,"Block Group 2, Census Tract 209.01, Walker County, Georgia",1944,1944,0,0.0
5281,1500000US132950209013,132950209013,"Block Group 3, Census Tract 209.01, Walker County, Georgia",673,673,0,0.0
5282,1500000US132950209014,132950209014,"Block Group 4, Census Tract 209.01, Walker County, Georgia",746,746,0,0.0
5283,1500000US132950209021,132950209021,"Block Group 1, Census Tract 209.02, Walker County, Georgia",660,644,16,2.42424242424
5284,1500000US132950209022,132950209022,"Block Group 2, Census Tract 209.02, Walker County, Georgia",1172,1169,3,0.255972696246
5285,1500000US132971101001,132971101001,"Block Group 1, Census Tract 1101, Walton County, Georgia",2813,2813,0,0.0
5286,1500000US132971101002,132971101002,"Block Group 2, Census Tract 1101, Walton County, Georgia",1868,1836,32,1.7130620985
5287,1500000US132971101003,132971101003,"Block Group 3, Census Tract 1101, Walton County, Georgia",4191,4083,108,2.57695060845
5288,1500000US132971102001,132971102001,"Block Group 1, Census Tract 1102, Walton County, Georgia",1670,1670,0,0.0
5289,1500000US132971102002,132971102002,"Block Group 2, Census Tract 1102, Walton County, Georgia",2555,2509,46,1.80039138943
5290,1500000US132971103001,132971103001,"Block Group 1, Census Tract 1103, Walton County, Georgia",1822,1772,50,2.74423710209
5291,1500000US132971103002,132971103002,"Block Group 2, Census Tract 1103, Walton County, Georgia",3869,3754,115,2.97234427501
5292,1500000US132971103003,132971103003,"Block Group 3, Census Tract 1103, Walton County, Georgia",1243,1132,111,8.93000804505
5293,1500000US132971104001,132971104001,"Block Group 1, Census Tract 1104, Walton County, Georgia",2501,2484,17,0.679728108756
5294,1500000US132971104002,132971104002,"Block Group 2, Census Tract 1104, Walton County, Georgia",2198,2198,0,0.0
5295,1500000US132971104003,132971104003,"Block Group 3, Census Tract 1104, Walton County, Georgia",1951,1904,47,2.40902101486
5296,1500000US132971105031,132971105031,"Block Group 1, Census Tract 1105.03, Walton County, Georgia",3466,3285,181,5.22215810733
5297,1500000US132971105041,132971105041,"Block Group 1, Census Tract 1105.04, Walton County, Georgia",2085,1987,98,4.70023980815
5298,1500000US132971105042,132971105042,"Block Group 2, Census Tract 1105.04, Walton County, Georgia",2857,2484,373,13.0556527826
5299,1500000US132971105051,132971105051,"Block Group 1, Census Tract 1105.05, Walton County, Georgia",4223,4142,81,1.91806772437
5300,1500000US132971105061,132971105061,"Block Group 1, Census Tract 1105.06, Walton County, Georgia",1417,1320,97,6.84544812985
5301,1500000US132971105062,132971105062,"Block Group 2, Census Tract 1105.06, Walton County, Georgia",1459,1459,0,0.0
5302,1500000US132971105063,132971105063,"Block Group 3, Census Tract 1105.06, Walton County, Georgia",2267,2180,87,3.83767093075
5303,1500000US132971105071,132971105071,"Block Group 1, Census Tract 1105.07, Walton County, Georgia",1478,1467,11,0.744248985115
5304,1500000US132971105072,132971105072,"Block Group 2, Census Tract 1105.07, Walton County, Georgia",1155,1021,134,11.6017316017
5305,1500000US132971105073,132971105073,"Block Group 3, Census Tract 1105.07, Walton County, Georgia",4992,4571,421,8.43349358974
5306,1500000US132971105081,132971105081,"Block Group 1, Census Tract 1105.08, Walton County, Georgia",1978,1957,21,1.06167846309
5307,1500000US132971105082,132971105082,"Block Group 2, Census Tract 1105.08, Walton County, Georgia",1822,1709,113,6.20197585071
5308,1500000US132971105083,132971105083,"Block Group 3, Census Tract 1105.08, Walton County, Georgia",1310,1039,271,20.6870229008
5309,1500000US132971106011,132971106011,"Block Group 1, Census Tract 1106.01, Walton County, Georgia",2057,2021,36,1.75012153622
5310,1500000US132971106012,132971106012,"Block Group 2, Census Tract 1106.01, Walton County, Georgia",2587,2587,0,0.0
5311,1500000US132971106021,132971106021,"Block Group 1, Census Tract 1106.02, Walton County, Georgia",2745,2705,40,1.45719489982
5312,1500000US132971106022,132971106022,"Block Group 2, Census Tract 1106.02, Walton County, Georgia",2580,2527,53,2.05426356589
5313,1500000US132971106031,132971106031,"Block Group 1, Census Tract 1106.03, Walton County, Georgia",869,869,0,0.0
5314,1500000US132971106032,132971106032,"Block Group 2, Census Tract 1106.03, Walton County, Georgia",3683,3502,181,4.91447189791
5315,1500000US132971107001,132971107001,"Block Group 1, Census Tract 1107, Walton County, Georgia",1804,1804,0,0.0
5316,1500000US132971107002,132971107002,"Block Group 2, Census Tract 1107, Walton County, Georgia",2926,2829,97,3.31510594668
5317,1500000US132971107003,132971107003,"Block Group 3, Census Tract 1107, Walton County, Georgia",1503,1503,0,0.0
5318,1500000US132971107004,132971107004,"Block Group 4, Census Tract 1107, Walton County, Georgia",1311,1304,7,0.533943554539
5319,1500000US132971108001,132971108001,"Block Group 1, Census Tract 1108, Walton County, Georgia",1792,1637,155,8.64955357143
5320,1500000US132971108002,132971108002,"Block Group 2, Census Tract 1108, Walton County, Georgia",1616,1330,286,17.698019802
5321,1500000US132971108003,132971108003,"Block Group 3, Census Tract 1108, Walton County, Georgia",1753,1753,0,0.0
5322,1500000US132971108004,132971108004,"Block Group 4, Census Tract 1108, Walton County, Georgia",1785,1785,0,0.0
5323,1500000US132999501001,132999501001,"Block Group 1, Census Tract 9501, Ware County, Georgia",1616,1616,0,0.0
5324,1500000US132999502001,132999502001,"Block Group 1, Census Tract 9502, Ware County, Georgia",1303,1303,0,0.0
5325,1500000US132999502002,132999502002,"Block Group 2, Census Tract 9502, Ware County, Georgia",3392,3284,108,3.18396226415
5326,1500000US132999502003,132999502003,"Block Group 3, Census Tract 9502, Ware County, Georgia",2074,1703,371,17.8881388621
5327,1500000US132999502004,132999502004,"Block Group 4, Census Tract 9502, Ware County, Georgia",980,980,0,0.0
5328,1500000US132999503001,132999503001,"Block Group 1, Census Tract 9503, Ware County, Georgia",750,750,0,0.0
5329,1500000US132999503002,132999503002,"Block Group 2, Census Tract 9503, Ware County, Georgia",834,834,0,0.0
5330,1500000US132999503003,132999503003,"Block Group 3, Census Tract 9503, Ware County, Georgia",343,343,0,0.0
5331,1500000US132999504001,132999504001,"Block Group 1, Census Tract 9504, Ware County, Georgia",496,491,5,1.00806451613
5332,1500000US132999504002,132999504002,"Block Group 2, Census Tract 9504, Ware County, Georgia",545,522,23,4.22018348624
5333,1500000US132999504003,132999504003,"Block Group 3, Census Tract 9504, Ware County, Georgia",742,733,9,1.21293800539
5334,1500000US132999505001,132999505001,"Block Group 1, Census Tract 9505, Ware County, Georgia",1895,1895,0,0.0
5335,1500000US132999505002,132999505002,"Block Group 2, Census Tract 9505, Ware County, Georgia",919,919,0,0.0
5336,1500000US132999505003,132999505003,"Block Group 3, Census Tract 9505, Ware County, Georgia",974,952,22,2.25872689938
5337,1500000US132999505004,132999505004,"Block Group 4, Census Tract 9505, Ware County, Georgia",912,912,0,0.0
5338,1500000US132999505005,132999505005,"Block Group 5, Census Tract 9505, Ware County, Georgia",798,798,0,0.0
5339,1500000US132999506001,132999506001,"Block Group 1, Census Tract 9506, Ware County, Georgia",1657,1657,0,0.0
5340,1500000US132999506002,132999506002,"Block Group 2, Census Tract 9506, Ware County, Georgia",1630,1619,11,0.674846625767
5341,1500000US132999506003,132999506003,"Block Group 3, Census Tract 9506, Ware County, Georgia",1384,1384,0,0.0
5342,1500000US132999506004,132999506004,"Block Group 4, Census Tract 9506, Ware County, Georgia",659,659,0,0.0
5343,1500000US132999506005,132999506005,"Block Group 5, Census Tract 9506, Ware County, Georgia",748,748,0,0.0
5344,1500000US132999507001,132999507001,"Block Group 1, Census Tract 9507, Ware County, Georgia",421,381,40,9.50118764846
5345,1500000US132999507002,132999507002,"Block Group 2, Census Tract 9507, Ware County, Georgia",800,784,16,2.0
5346,1500000US132999508001,132999508001,"Block Group 1, Census Tract 9508, Ware County, Georgia",721,562,159,22.052704577
5347,1500000US132999508002,132999508002,"Block Group 2, Census Tract 9508, Ware County, Georgia",1252,1252,0,0.0
5348,1500000US132999508003,132999508003,"Block Group 3, Census Tract 9508, Ware County, Georgia",1234,1234,0,0.0
5349,1500000US132999508004,132999508004,"Block Group 4, Census Tract 9508, Ware County, Georgia",313,313,0,0.0
5350,1500000US132999508005,132999508005,"Block Group 5, Census Tract 9508, Ware County, Georgia",1418,1238,180,12.6939351199
5351,1500000US132999508006,132999508006,"Block Group 6, Census Tract 9508, Ware County, Georgia",683,617,66,9.66325036603
5352,1500000US132999509001,132999509001,"Block Group 1, Census Tract 9509, Ware County, Georgia",1008,1008,0,0.0
5353,1500000US132999509002,132999509002,"Block Group 2, Census Tract 9509, Ware County, Georgia",737,737,0,0.0
5354,1500000US132999509003,132999509003,"Block Group 3, Census Tract 9509, Ware County, Georgia",1379,1361,18,1.30529369108
5355,1500000US132999509004,132999509004,"Block Group 4, Census Tract 9509, Ware County, Georgia",1106,834,272,24.5931283906
5356,1500000US133019704001,133019704001,"Block Group 1, Census Tract 9704, Warren County, Georgia",965,965,0,0.0
5357,1500000US133019704002,133019704002,"Block Group 2, Census Tract 9704, Warren County, Georgia",1190,1190,0,0.0
5358,1500000US133019704003,133019704003,"Block Group 3, Census Tract 9704, Warren County, Georgia",675,675,0,0.0
5359,1500000US133019705001,133019705001,"Block Group 1, Census Tract 9705, Warren County, Georgia",1235,1192,43,3.48178137652
5360,1500000US133019705002,133019705002,"Block Group 2, Census Tract 9705, Warren County, Georgia",776,776,0,0.0
5361,1500000US133019705003,133019705003,"Block Group 3, Census Tract 9705, Warren County, Georgia",720,720,0,0.0
5362,1500000US133039501001,133039501001,"Block Group 1, Census Tract 9501, Washington County, Georgia",860,860,0,0.0
5363,1500000US133039501002,133039501002,"Block Group 2, Census Tract 9501, Washington County, Georgia",879,879,0,0.0
5364,1500000US133039503001,133039503001,"Block Group 1, Census Tract 9503, Washington County, Georgia",1855,1855,0,0.0
5365,1500000US133039503002,133039503002,"Block Group 2, Census Tract 9503, Washington County, Georgia",1372,1372,0,0.0
5366,1500000US133039503003,133039503003,"Block Group 3, Census Tract 9503, Washington County, Georgia",601,601,0,0.0
5367,1500000US133039503004,133039503004,"Block Group 4, Census Tract 9503, Washington County, Georgia",550,550,0,0.0
5368,1500000US133039504001,133039504001,"Block Group 1, Census Tract 9504, Washington County, Georgia",1808,1785,23,1.27212389381
5369,1500000US133039504002,133039504002,"Block Group 2, Census Tract 9504, Washington County, Georgia",973,961,12,1.23329907503
5370,1500000US133039504003,133039504003,"Block Group 3, Census Tract 9504, Washington County, Georgia",928,911,17,1.83189655172
5371,1500000US133039504004,133039504004,"Block Group 4, Census Tract 9504, Washington County, Georgia",1513,1513,0,0.0
5372,1500000US133039505001,133039505001,"Block Group 1, Census Tract 9505, Washington County, Georgia",2343,2283,60,2.56081946223
5373,1500000US133039505002,133039505002,"Block Group 2, Census Tract 9505, Washington County, Georgia",1378,1301,77,5.587808418
5374,1500000US133039505003,133039505003,"Block Group 3, Census Tract 9505, Washington County, Georgia",1573,1558,15,0.953591862683
5375,1500000US133039507001,133039507001,"Block Group 1, Census Tract 9507, Washington County, Georgia",1738,1515,223,12.830840046
5376,1500000US133039507002,133039507002,"Block Group 2, Census Tract 9507, Washington County, Georgia",953,930,23,2.41343126967
5377,1500000US133039507003,133039507003,"Block Group 3, Census Tract 9507, Washington County, Georgia",1461,1461,0,0.0
5378,1500000US133059701001,133059701001,"Block Group 1, Census Tract 9701, Wayne County, Georgia",1044,952,92,8.8122605364
5379,1500000US133059701002,133059701002,"Block Group 2, Census Tract 9701, Wayne County, Georgia",845,845,0,0.0
5380,1500000US133059701003,133059701003,"Block Group 3, Census Tract 9701, Wayne County, Georgia",1009,963,46,4.55896927651
5381,1500000US133059701004,133059701004,"Block Group 4, Census Tract 9701, Wayne County, Georgia",1134,1060,74,6.52557319224
5382,1500000US133059702001,133059702001,"Block Group 1, Census Tract 9702, Wayne County, Georgia",2671,2647,24,0.898539872707
5383,1500000US133059702002,133059702002,"Block Group 2, Census Tract 9702, Wayne County, Georgia",2847,2784,63,2.21285563751
5384,1500000US133059702003,133059702003,"Block Group 3, Census Tract 9702, Wayne County, Georgia",942,791,151,16.0297239915
5385,1500000US133059702004,133059702004,"Block Group 4, Census Tract 9702, Wayne County, Georgia",890,890,0,0.0
5386,1500000US133059702005,133059702005,"Block Group 5, Census Tract 9702, Wayne County, Georgia",401,401,0,0.0
5387,1500000US133059703001,133059703001,"Block Group 1, Census Tract 9703, Wayne County, Georgia",1376,1339,37,2.68895348837
5388,1500000US133059703002,133059703002,"Block Group 2, Census Tract 9703, Wayne County, Georgia",1494,1304,190,12.7175368139
5389,1500000US133059703003,133059703003,"Block Group 3, Census Tract 9703, Wayne County, Georgia",1535,1398,137,8.92508143322
5390,1500000US133059703004,133059703004,"Block Group 4, Census Tract 9703, Wayne County, Georgia",806,753,53,6.57568238213
5391,1500000US133059704001,133059704001,"Block Group 1, Census Tract 9704, Wayne County, Georgia",1840,1671,169,9.1847826087
5392,1500000US133059704002,133059704002,"Block Group 2, Census Tract 9704, Wayne County, Georgia",1128,998,130,11.524822695
5393,1500000US133059704003,133059704003,"Block Group 3, Census Tract 9704, Wayne County, Georgia",706,625,81,11.4730878187
5394,1500000US133059705001,133059705001,"Block Group 1, Census Tract 9705, Wayne County, Georgia",2778,2415,363,13.0669546436
5395,1500000US133059705002,133059705002,"Block Group 2, Census Tract 9705, Wayne County, Georgia",972,927,45,4.62962962963
5396,1500000US133059705003,133059705003,"Block Group 3, Census Tract 9705, Wayne County, Georgia",881,876,5,0.567536889898
5397,1500000US133059705004,133059705004,"Block Group 4, Census Tract 9705, Wayne County, Georgia",757,636,121,15.9841479524
5398,1500000US133059706001,133059706001,"Block Group 1, Census Tract 9706, Wayne County, Georgia",1975,1975,0,0.0
5399,1500000US133059706002,133059706002,"Block Group 2, Census Tract 9706, Wayne County, Georgia",909,843,66,7.26072607261
5400,1500000US133059706003,133059706003,"Block Group 3, Census Tract 9706, Wayne County, Georgia",1106,1106,0,0.0
5401,1500000US133079601001,133079601001,"Block Group 1, Census Tract 9601, Webster County, Georgia",1425,1399,26,1.82456140351
5402,1500000US133079602001,133079602001,"Block Group 1, Census Tract 9602, Webster County, Georgia",1295,1295,0,0.0
5403,1500000US133097801001,133097801001,"Block Group 1, Census Tract 7801, Wheeler County, Georgia",644,644,0,0.0
5404,1500000US133097801002,133097801002,"Block Group 2, Census Tract 7801, Wheeler County, Georgia",575,567,8,1.39130434783
5405,1500000US133097801003,133097801003,"Block Group 3, Census Tract 7801, Wheeler County, Georgia",916,916,0,0.0
5406,1500000US133097802001,133097802001,"Block Group 1, Census Tract 7802, Wheeler County, Georgia",4072,3907,165,4.05206286837
5407,1500000US133097802002,133097802002,"Block Group 2, Census Tract 7802, Wheeler County, Georgia",1207,1207,0,0.0
5408,1500000US133097802003,133097802003,"Block Group 3, Census Tract 7802, Wheeler County, Georgia",542,542,0,0.0
5409,1500000US133119501001,133119501001,"Block Group 1, Census Tract 9501, White County, Georgia",1482,1482,0,0.0
5410,1500000US133119501002,133119501002,"Block Group 2, Census Tract 9501, White County, Georgia",1272,1257,15,1.17924528302
5411,1500000US133119502011,133119502011,"Block Group 1, Census Tract 9502.01, White County, Georgia",2050,1890,160,7.80487804878
5412,1500000US133119502012,133119502012,"Block Group 2, Census Tract 9502.01, White County, Georgia",3201,3196,5,0.156201187129
5413,1500000US133119502013,133119502013,"Block Group 3, Census Tract 9502.01, White County, Georgia",3672,3521,151,4.11220043573
5414,1500000US133119502021,133119502021,"Block Group 1, Census Tract 9502.02, White County, Georgia",1343,1315,28,2.08488458675
5415,1500000US133119502022,133119502022,"Block Group 2, Census Tract 9502.02, White County, Georgia",1794,1794,0,0.0
5416,1500000US133119502031,133119502031,"Block Group 1, Census Tract 9502.03, White County, Georgia",2854,2854,0,0.0
5417,1500000US133119502032,133119502032,"Block Group 2, Census Tract 9502.03, White County, Georgia",2481,2481,0,0.0
5418,1500000US133119503001,133119503001,"Block Group 1, Census Tract 9503, White County, Georgia",796,796,0,0.0
5419,1500000US133119503002,133119503002,"Block Group 2, Census Tract 9503, White County, Georgia",4132,3989,143,3.46079380445
5420,1500000US133119503003,133119503003,"Block Group 3, Census Tract 9503, White County, Georgia",2714,2422,292,10.759027266
5421,1500000US133130001011,133130001011,"Block Group 1, Census Tract 1.01, Whitfield County, Georgia",1196,1038,158,13.2107023411
5422,1500000US133130001012,133130001012,"Block Group 2, Census Tract 1.01, Whitfield County, Georgia",1665,1665,0,0.0
5423,1500000US133130001013,133130001013,"Block Group 3, Census Tract 1.01, Whitfield County, Georgia",1133,1106,27,2.38305383936
5424,1500000US133130001021,133130001021,"Block Group 1, Census Tract 1.02, Whitfield County, Georgia",1102,882,220,19.9637023593
5425,1500000US133130001022,133130001022,"Block Group 2, Census Tract 1.02, Whitfield County, Georgia",3451,3206,245,7.09939148073
5426,1500000US133130001023,133130001023,"Block Group 3, Census Tract 1.02, Whitfield County, Georgia",1514,1457,57,3.76486129458
5427,1500000US133130001024,133130001024,"Block Group 4, Census Tract 1.02, Whitfield County, Georgia",2298,1198,1100,47.8677110531
5428,1500000US133130002001,133130002001,"Block Group 1, Census Tract 2, Whitfield County, Georgia",1916,1583,333,17.3799582463
5429,1500000US133130002002,133130002002,"Block Group 2, Census Tract 2, Whitfield County, Georgia",1001,992,9,0.899100899101
5430,1500000US133130002003,133130002003,"Block Group 3, Census Tract 2, Whitfield County, Georgia",1062,978,84,7.90960451977
5431,1500000US133130003011,133130003011,"Block Group 1, Census Tract 3.01, Whitfield County, Georgia",442,442,0,0.0
5432,1500000US133130003012,133130003012,"Block Group 2, Census Tract 3.01, Whitfield County, Georgia",1094,805,289,26.4168190128
5433,1500000US133130003013,133130003013,"Block Group 3, Census Tract 3.01, Whitfield County, Georgia",2751,1282,1469,53.3987640858
5434,1500000US133130003021,133130003021,"Block Group 1, Census Tract 3.02, Whitfield County, Georgia",1226,864,362,29.5269168026
5435,1500000US133130003022,133130003022,"Block Group 2, Census Tract 3.02, Whitfield County, Georgia",3603,2793,810,22.481265612
5436,1500000US133130003023,133130003023,"Block Group 3, Census Tract 3.02, Whitfield County, Georgia",1819,1445,374,20.5607476636
5437,1500000US133130003024,133130003024,"Block Group 4, Census Tract 3.02, Whitfield County, Georgia",2603,1792,811,31.1563580484
5438,1500000US133130004001,133130004001,"Block Group 1, Census Tract 4, Whitfield County, Georgia",905,649,256,28.2872928177
5439,1500000US133130004002,133130004002,"Block Group 2, Census Tract 4, Whitfield County, Georgia",1089,389,700,64.2791551882
5440,1500000US133130004003,133130004003,"Block Group 3, Census Tract 4, Whitfield County, Georgia",1194,467,727,60.8877721943
5441,1500000US133130004004,133130004004,"Block Group 4, Census Tract 4, Whitfield County, Georgia",2536,596,1940,76.4984227129
5442,1500000US133130004005,133130004005,"Block Group 5, Census Tract 4, Whitfield County, Georgia",1590,463,1127,70.8805031447
5443,1500000US133130004006,133130004006,"Block Group 6, Census Tract 4, Whitfield County, Georgia",547,264,283,51.7367458867
5444,1500000US133130005011,133130005011,"Block Group 1, Census Tract 5.01, Whitfield County, Georgia",965,599,366,37.9274611399
5445,1500000US133130005012,133130005012,"Block Group 2, Census Tract 5.01, Whitfield County, Georgia",2279,1817,462,20.2720491444
5446,1500000US133130005013,133130005013,"Block Group 3, Census Tract 5.01, Whitfield County, Georgia",974,811,163,16.7351129363
5447,1500000US133130005021,133130005021,"Block Group 1, Census Tract 5.02, Whitfield County, Georgia",1699,747,952,56.032960565
5448,1500000US133130005022,133130005022,"Block Group 2, Census Tract 5.02, Whitfield County, Georgia",630,332,298,47.3015873016
5449,1500000US133130005023,133130005023,"Block Group 3, Census Tract 5.02, Whitfield County, Georgia",2278,1510,768,33.7137840211
5450,1500000US133130005024,133130005024,"Block Group 4, Census Tract 5.02, Whitfield County, Georgia",2269,1540,729,32.1286910533
5451,1500000US133130006001,133130006001,"Block Group 1, Census Tract 6, Whitfield County, Georgia",2112,2065,47,2.22537878788
5452,1500000US133130006002,133130006002,"Block Group 2, Census Tract 6, Whitfield County, Georgia",1293,987,306,23.6658932715
5453,1500000US133130006003,133130006003,"Block Group 3, Census Tract 6, Whitfield County, Georgia",868,649,219,25.2304147465
5454,1500000US133130007001,133130007001,"Block Group 1, Census Tract 7, Whitfield County, Georgia",1148,1095,53,4.61672473868
5455,1500000US133130007002,133130007002,"Block Group 2, Census Tract 7, Whitfield County, Georgia",1418,1418,0,0.0
5456,1500000US133130007003,133130007003,"Block Group 3, Census Tract 7, Whitfield County, Georgia",1171,1142,29,2.47651579846
5457,1500000US133130007004,133130007004,"Block Group 4, Census Tract 7, Whitfield County, Georgia",1030,989,41,3.98058252427
5458,1500000US133130008001,133130008001,"Block Group 1, Census Tract 8, Whitfield County, Georgia",2899,2652,247,8.5201793722
5459,1500000US133130008002,133130008002,"Block Group 2, Census Tract 8, Whitfield County, Georgia",1435,1425,10,0.696864111498
5460,1500000US133130008003,133130008003,"Block Group 3, Census Tract 8, Whitfield County, Georgia",717,420,297,41.4225941423
5461,1500000US133130008004,133130008004,"Block Group 4, Census Tract 8, Whitfield County, Georgia",1151,1151,0,0.0
5462,1500000US133130008005,133130008005,"Block Group 5, Census Tract 8, Whitfield County, Georgia",1598,1328,270,16.8961201502
5463,1500000US133130009001,133130009001,"Block Group 1, Census Tract 9, Whitfield County, Georgia",486,424,62,12.7572016461
5464,1500000US133130009002,133130009002,"Block Group 2, Census Tract 9, Whitfield County, Georgia",1595,1053,542,33.9811912226
5465,1500000US133130009003,133130009003,"Block Group 3, Census Tract 9, Whitfield County, Georgia",1644,1375,269,16.3625304136
5466,1500000US133130010001,133130010001,"Block Group 1, Census Tract 10, Whitfield County, Georgia",1944,602,1342,69.0329218107
5467,1500000US133130010002,133130010002,"Block Group 2, Census Tract 10, Whitfield County, Georgia",1509,302,1207,79.9867461895
5468,1500000US133130010003,133130010003,"Block Group 3, Census Tract 10, Whitfield County, Georgia",1041,223,818,78.5782901057
5469,1500000US133130011001,133130011001,"Block Group 1, Census Tract 11, Whitfield County, Georgia",592,468,124,20.9459459459
5470,1500000US133130011002,133130011002,"Block Group 2, Census Tract 11, Whitfield County, Georgia",1494,1022,472,31.593038822
5471,1500000US133130011003,133130011003,"Block Group 3, Census Tract 11, Whitfield County, Georgia",1109,632,477,43.0117222723
5472,1500000US133130011004,133130011004,"Block Group 4, Census Tract 11, Whitfield County, Georgia",1838,401,1437,78.1828073993
5473,1500000US133130012001,133130012001,"Block Group 1, Census Tract 12, Whitfield County, Georgia",1517,987,530,34.9373764008
5474,1500000US133130012002,133130012002,"Block Group 2, Census Tract 12, Whitfield County, Georgia",1453,918,535,36.8203716449
5475,1500000US133130012003,133130012003,"Block Group 3, Census Tract 12, Whitfield County, Georgia",1637,728,909,55.52840562
5476,1500000US133130012004,133130012004,"Block Group 4, Census Tract 12, Whitfield County, Georgia",1387,663,724,52.1989906273
5477,1500000US133130012005,133130012005,"Block Group 5, Census Tract 12, Whitfield County, Georgia",1081,437,644,59.5744680851
5478,1500000US133130012006,133130012006,"Block Group 6, Census Tract 12, Whitfield County, Georgia",763,48,715,93.7090432503
5479,1500000US133130013001,133130013001,"Block Group 1, Census Tract 13, Whitfield County, Georgia",2213,498,1715,77.4966109354
5480,1500000US133130013002,133130013002,"Block Group 2, Census Tract 13, Whitfield County, Georgia",499,164,335,67.1342685371
5481,1500000US133130013003,133130013003,"Block Group 3, Census Tract 13, Whitfield County, Georgia",1679,538,1141,67.9571173317
5482,1500000US133130014001,133130014001,"Block Group 1, Census Tract 14, Whitfield County, Georgia",1231,1146,85,6.90495532088
5483,1500000US133130014002,133130014002,"Block Group 2, Census Tract 14, Whitfield County, Georgia",1979,1145,834,42.1424962102
5484,1500000US133130014003,133130014003,"Block Group 3, Census Tract 14, Whitfield County, Georgia",1394,547,847,60.7604017217
5485,1500000US133130014004,133130014004,"Block Group 4, Census Tract 14, Whitfield County, Georgia",534,454,80,14.9812734082
5486,1500000US133130014005,133130014005,"Block Group 5, Census Tract 14, Whitfield County, Georgia",1527,480,1047,68.5658153242
5487,1500000US133130015001,133130015001,"Block Group 1, Census Tract 15, Whitfield County, Georgia",1013,983,30,2.96150049358
5488,1500000US133130015002,133130015002,"Block Group 2, Census Tract 15, Whitfield County, Georgia",814,695,119,14.6191646192
5489,1500000US133130015003,133130015003,"Block Group 3, Census Tract 15, Whitfield County, Georgia",896,812,84,9.375
5490,1500000US133130015004,133130015004,"Block Group 4, Census Tract 15, Whitfield County, Georgia",1068,962,106,9.92509363296
5491,1500000US133130015005,133130015005,"Block Group 5, Census Tract 15, Whitfield County, Georgia",1848,1518,330,17.8571428571
5492,1500000US133159601001,133159601001,"Block Group 1, Census Tract 9601, Wilcox County, Georgia",3186,3097,89,2.79347143754
5493,1500000US133159601002,133159601002,"Block Group 2, Census Tract 9601, Wilcox County, Georgia",854,854,0,0.0
5494,1500000US133159602001,133159602001,"Block Group 1, Census Tract 9602, Wilcox County, Georgia",1410,1376,34,2.41134751773
5495,1500000US133159603001,133159603001,"Block Group 1, Census Tract 9603, Wilcox County, Georgia",1431,1391,40,2.79524807827
5496,1500000US133159604001,133159604001,"Block Group 1, Census Tract 9604, Wilcox County, Georgia",1413,1386,27,1.91082802548
5497,1500000US133159604002,133159604002,"Block Group 2, Census Tract 9604, Wilcox County, Georgia",678,678,0,0.0
5498,1500000US133170101011,133170101011,"Block Group 1, Census Tract 101.01, Wilkes County, Georgia",795,795,0,0.0
5499,1500000US133170101012,133170101012,"Block Group 2, Census Tract 101.01, Wilkes County, Georgia",778,778,0,0.0
5500,1500000US133170101021,133170101021,"Block Group 1, Census Tract 101.02, Wilkes County, Georgia",782,632,150,19.1815856777
5501,1500000US133170101022,133170101022,"Block Group 2, Census Tract 101.02, Wilkes County, Georgia",820,688,132,16.0975609756
5502,1500000US133170103011,133170103011,"Block Group 1, Census Tract 103.01, Wilkes County, Georgia",1228,1212,16,1.30293159609
5503,1500000US133170103012,133170103012,"Block Group 2, Census Tract 103.01, Wilkes County, Georgia",1065,1061,4,0.37558685446
5504,1500000US133170103021,133170103021,"Block Group 1, Census Tract 103.02, Wilkes County, Georgia",1533,1533,0,0.0
5505,1500000US133170103022,133170103022,"Block Group 2, Census Tract 103.02, Wilkes County, Georgia",791,777,14,1.76991150442
5506,1500000US133170103023,133170103023,"Block Group 3, Census Tract 103.02, Wilkes County, Georgia",627,551,76,12.1212121212
5507,1500000US133170103024,133170103024,"Block Group 4, Census Tract 103.02, Wilkes County, Georgia",791,790,1,0.126422250316
5508,1500000US133170103025,133170103025,"Block Group 5, Census Tract 103.02, Wilkes County, Georgia",781,781,0,0.0
5509,1500000US133199602001,133199602001,"Block Group 1, Census Tract 9602, Wilkinson County, Georgia",1392,1298,94,6.75287356322
5510,1500000US133199602002,133199602002,"Block Group 2, Census Tract 9602, Wilkinson County, Georgia",1055,966,89,8.43601895735
5511,1500000US133199602003,133199602003,"Block Group 3, Census Tract 9602, Wilkinson County, Georgia",749,746,3,0.400534045394
5512,1500000US133199603001,133199603001,"Block Group 1, Census Tract 9603, Wilkinson County, Georgia",662,652,10,1.51057401813
5513,1500000US133199603002,133199603002,"Block Group 2, Census Tract 9603, Wilkinson County, Georgia",1147,1147,0,0.0
5514,1500000US133199603003,133199603003,"Block Group 3, Census Tract 9603, Wilkinson County, Georgia",1386,1382,4,0.2886002886
5515,1500000US133199603004,133199603004,"Block Group 4, Census Tract 9603, Wilkinson County, Georgia",1326,1310,16,1.20663650075
5516,1500000US133199604001,133199604001,"Block Group 1, Census Tract 9604, Wilkinson County, Georgia",1065,1060,5,0.469483568075
5517,1500000US133199604002,133199604002,"Block Group 2, Census Tract 9604, Wilkinson County, Georgia",604,582,22,3.64238410596
5518,1500000US133219501001,133219501001,"Block Group 1, Census Tract 9501, Worth County, Georgia",822,822,0,0.0
5519,1500000US133219501002,133219501002,"Block Group 2, Census Tract 9501, Worth County, Georgia",2006,1957,49,2.44267198405
5520,1500000US133219502001,133219502001,"Block Group 1, Census Tract 9502, Worth County, Georgia",1715,1538,177,10.3206997085
5521,1500000US133219502002,133219502002,"Block Group 2, Census Tract 9502, Worth County, Georgia",2592,2494,98,3.78086419753
5522,1500000US133219502003,133219502003,"Block Group 3, Census Tract 9502, Worth County, Georgia",1304,1304,0,0.0
5523,1500000US133219502004,133219502004,"Block Group 4, Census Tract 9502, Worth County, Georgia",1580,1547,33,2.08860759494
5524,1500000US133219504001,133219504001,"Block Group 1, Census Tract 9504, Worth County, Georgia",1905,1904,1,0.0524934383202
5525,1500000US133219504002,133219504002,"Block Group 2, Census Tract 9504, Worth County, Georgia",651,644,7,1.0752688172
5526,1500000US133219504003,133219504003,"Block Group 3, Census Tract 9504, Worth County, Georgia",1012,989,23,2.27272727273
5527,1500000US133219504004,133219504004,"Block Group 4, Census Tract 9504, Worth County, Georgia",1253,1253,0,0.0
5528,1500000US133219505001,133219505001,"Block Group 1, Census Tract 9505, Worth County, Georgia",1601,1595,6,0.374765771393
5529,1500000US133219505002,133219505002,"Block Group 2, Census Tract 9505, Worth County, Georgia",1134,1121,13,1.14638447972
5530,1500000US133219505003,133219505003,"Block Group 3, Census Tract 9505, Worth County, Georgia",1426,1419,7,0.490883590463
5531,1500000US133219506001,133219506001,"Block Group 1, Census Tract 9506, Worth County, Georgia",1295,1295,0,0.0
5532,1500000US133219506002,133219506002,"Block Group 2, Census Tract 9506, Worth County, Georgia",860,831,29,3.37209302326
